Schluesselzahl der Tat;Straftat;Gemeindeschlüssel;Stadt;Sexus;Tatverdaechtige insgesamt - Anzahl;Kinder bis unter 6 Jahre - Anzahl;Kinder 6 bis unter 8 Jahre Anzahl;Kinder 8 bis unter 10 Jahre - Anzahl;Kinder 10 bis unter 12 Jahre - Anzahl;Kinder 12 bis unter 14 Jahre - Anzahl;Kinder bis unter 14 Jahre insgesamt (Anzahl Spalte 5 bis 9);Jugendliche 14 bis unter 16 Jahre - Anzahl;Jugendliche 16 bis unter 18 Jahre - Anzahl;Jugendliche 14 bis unter 18 Jahre insgesamt (Anzahl Spalte 11 und 12);Heranwachsende 18 bis unter 21 Jahre - Anzahl;Tatverdaechtige insgesamt unter 21 Jahre (Anzahl Spalte 10, 13 und 14);Erwachsene 21 bis unter 23 Jahre - Anzahl;Erwachsene 23 bis unter 25 Jahre - Anzahl;Erwachsene 21 bis unter 25 Jahre (Anzahl Spalte 16 und 17);Erwachsene 25 bis unter 30 Jahre;Erwachsene 30 bis unter 40 Jahre;Erwachsene 40 bis unter 50 Jahre;Erwachsene 50 bis unter 60 Jahre;Erwachsene 60 Jahre und aelter;Erwachsene ab 21 Jahre (Anzahl Spalten 18 bis 23)
------;Straftaten insgesamt;5334002;Aachen;M;9368;4;2;7;44;71;128;372;702;1074;1155;2357;684;726;1410;1541;1886;1156;651;367;7011
------;Straftaten insgesamt;5334002;Aachen;W;2540;0;0;3;9;36;48;140;192;332;266;646;174;164;338;341;429;406;222;158;1894
------;Straftaten insgesamt;5334002;Aachen;X;11908;4;2;10;53;107;176;512;894;1406;1421;3003;858;890;1748;1882;2315;1562;873;525;8905
------;Straftaten insgesamt;9761000;Augsburg;M;8427;0;8;30;50;99;187;279;429;708;859;1754;640;609;1249;1257;1778;1245;725;419;6673
------;Straftaten insgesamt;9761000;Augsburg;W;2784;1;3;4;15;79;102;147;173;320;266;688;163;180;343;341;514;389;293;216;2096
------;Straftaten insgesamt;9761000;Augsburg;X;11211;1;11;34;65;178;289;426;602;1028;1125;2442;803;789;1592;1598;2292;1634;1018;635;8769
------;Straftaten insgesamt;5378004;Bergisch Gladbach;M;1956;0;1;6;17;24;48;65;103;168;206;422;114;102;216;264;376;330;203;145;1534
------;Straftaten insgesamt;5378004;Bergisch Gladbach;W;659;0;0;0;0;9;9;38;47;85;48;142;32;34;66;76;115;132;83;45;517
------;Straftaten insgesamt;5378004;Bergisch Gladbach;X;2615;0;1;6;17;33;57;103;150;253;254;564;146;136;282;340;491;462;286;190;2051
------;Straftaten insgesamt;11000000;Berlin;M;104759;76;161;405;762;1426;2830;2505;3880;6385;7954;17169;5887;6618;12505;15920;24707;17464;10625;6369;87590
------;Straftaten insgesamt;11000000;Berlin;W;39357;57;52;110;249;796;1264;1608;1651;3259;3130;7653;2295;2559;4854;5822;8151;6037;3832;3008;31704
------;Straftaten insgesamt;11000000;Berlin;X;144116;133;213;515;1011;2222;4094;4113;5531;9644;11084;24822;8182;9177;17359;21742;32858;23501;14457;9377;119294
------;Straftaten insgesamt;5711000;Bielefeld;M;8433;6;1;14;36;80;137;219;472;691;798;1626;606;577;1183;1319;1892;1288;684;441;6807
------;Straftaten insgesamt;5711000;Bielefeld;W;2632;4;4;9;7;35;59;171;183;354;221;634;157;150;307;355;494;434;259;149;1998
------;Straftaten insgesamt;5711000;Bielefeld;X;11065;10;5;23;43;115;196;390;655;1045;1019;2260;763;727;1490;1674;2386;1722;943;590;8805
------;Straftaten insgesamt;5911000;Bochum;M;9383;1;13;25;60;132;231;200;439;639;908;1778;663;684;1347;1393;1967;1506;870;522;7605
------;Straftaten insgesamt;5911000;Bochum;W;3072;3;3;8;16;60;90;129;151;280;296;666;198;198;396;363;577;514;308;248;2406
------;Straftaten insgesamt;5911000;Bochum;X;12455;4;16;33;76;192;321;329;590;919;1204;2444;861;882;1743;1756;2544;2020;1178;770;10011
------;Straftaten insgesamt;5314000;Bonn;M;8255;0;11;19;63;125;218;276;449;725;810;1753;587;538;1125;1138;1722;1307;755;455;6502
------;Straftaten insgesamt;5314000;Bonn;W;2871;1;1;2;10;77;91;191;198;389;252;732;178;169;347;343;520;445;273;211;2139
------;Straftaten insgesamt;5314000;Bonn;X;11126;1;12;21;73;202;309;467;647;1114;1062;2485;765;707;1472;1481;2242;1752;1028;666;8641
------;Straftaten insgesamt;5512000;Bottrop;M;2450;0;2;8;12;36;58;84;96;180;204;442;165;180;345;348;540;425;195;155;2008
------;Straftaten insgesamt;5512000;Bottrop;W;864;0;1;2;3;26;32;46;35;81;83;196;49;62;111;94;191;126;77;69;668
------;Straftaten insgesamt;5512000;Bottrop;X;3314;0;3;10;15;62;90;130;131;261;287;638;214;242;456;442;731;551;272;224;2676
------;Straftaten insgesamt;3101000;Braunschweig;M;8070;10;4;11;33;72;130;210;406;616;936;1682;640;619;1259;1259;1707;1109;638;416;6388
------;Straftaten insgesamt;3101000;Braunschweig;W;2489;7;3;8;19;64;101;155;166;321;254;676;161;157;318;298;436;336;247;178;1813
------;Straftaten insgesamt;3101000;Braunschweig;X;10559;17;7;19;52;136;231;365;572;937;1190;2358;801;776;1577;1557;2143;1445;885;594;8201
------;Straftaten insgesamt;4011000;Bremen;M;15826;13;15;30;86;153;297;461;979;1440;1602;3339;1149;1160;2309;2346;3425;2366;1257;784;12487
------;Straftaten insgesamt;4011000;Bremen;W;4817;6;6;9;27;116;164;277;364;641;455;1260;318;320;638;604;917;686;417;295;3557
------;Straftaten insgesamt;4011000;Bremen;X;20643;19;21;39;113;269;461;738;1343;2081;2057;4599;1467;1480;2947;2950;4342;3052;1674;1079;16044
------;Straftaten insgesamt;4012000;Bremerhaven;M;3273;7;8;15;28;42;100;96;131;227;307;634;243;195;438;504;682;536;302;177;2639
------;Straftaten insgesamt;4012000;Bremerhaven;W;1052;0;1;4;7;24;36;57;35;92;96;224;82;59;141;139;173;174;128;73;828
------;Straftaten insgesamt;4012000;Bremerhaven;X;4325;7;9;19;35;66;136;153;166;319;403;858;325;254;579;643;855;710;430;250;3467
------;Straftaten insgesamt;14511000;Chemnitz;M;7548;72;39;51;60;104;326;203;259;462;660;1448;463;547;1010;1382;1812;969;556;371;6100
------;Straftaten insgesamt;14511000;Chemnitz;W;2714;81;19;23;31;70;224;106;123;229;196;649;131;173;304;411;603;323;234;190;2065
------;Straftaten insgesamt;14511000;Chemnitz;X;10262;153;58;74;91;174;550;309;382;691;856;2097;594;720;1314;1793;2415;1292;790;561;8165
------;Straftaten insgesamt;6411000;Darmstadt;M;3801;0;2;9;10;33;54;115;238;353;425;832;270;260;530;521;781;589;352;196;2969
------;Straftaten insgesamt;6411000;Darmstadt;W;1328;0;1;1;3;37;42;86;99;185;139;366;71;64;135;165;246;197;125;94;962
------;Straftaten insgesamt;6411000;Darmstadt;X;5129;0;3;10;13;70;96;201;337;538;564;1198;341;324;665;686;1027;786;477;290;3931
------;Straftaten insgesamt;5913000;Dortmund;M;21275;13;16;77;138;290;534;620;1255;1875;2391;4800;1590;1594;3184;3303;4526;3017;1553;892;16475
------;Straftaten insgesamt;5913000;Dortmund;W;6473;9;7;19;47;158;240;416;447;863;651;1754;455;410;865;877;1209;869;492;407;4719
------;Straftaten insgesamt;5913000;Dortmund;X;27748;22;23;96;185;448;774;1036;1702;2738;3042;6554;2045;2004;4049;4180;5735;3886;2045;1299;21194
------;Straftaten insgesamt;14612000;Dresden;M;13111;4;15;31;65;143;258;297;464;761;984;2003;755;924;1679;2365;3238;1913;1152;761;11108
------;Straftaten insgesamt;14612000;Dresden;W;5184;1;2;16;28;75;122;213;202;415;306;843;265;359;624;869;1119;710;534;485;4341
------;Straftaten insgesamt;14612000;Dresden;X;18295;5;17;47;93;218;380;510;666;1176;1290;2846;1020;1283;2303;3234;4357;2623;1686;1246;15449
------;Straftaten insgesamt;5112000;Duisburg;M;14208;7;35;72;116;248;478;449;580;1029;1342;2849;1007;966;1973;2102;3182;2248;1219;635;11359
------;Straftaten insgesamt;5112000;Duisburg;W;4991;4;7;27;47;111;196;213;269;482;504;1182;381;340;721;690;989;719;391;299;3809
------;Straftaten insgesamt;5112000;Duisburg;X;19199;11;42;99;163;359;674;662;849;1511;1846;4031;1388;1306;2694;2792;4171;2967;1610;934;15168
------;Straftaten insgesamt;5111000;Düsseldorf;M;20417;11;8;36;90;184;329;437;828;1265;1926;3520;1438;1454;2892;3165;4663;3252;1763;1162;16897
------;Straftaten insgesamt;5111000;Düsseldorf;W;6721;4;7;9;34;143;197;344;399;743;651;1591;417;400;817;863;1229;964;680;577;5130
------;Straftaten insgesamt;5111000;Düsseldorf;X;27138;15;15;45;124;327;526;781;1227;2008;2577;5111;1855;1854;3709;4028;5892;4216;2443;1739;22027
------;Straftaten insgesamt;16051000;Erfurt;M;6326;4;14;26;62;106;212;170;245;415;448;1075;356;465;821;1098;1518;870;526;418;5251
------;Straftaten insgesamt;16051000;Erfurt;W;2524;4;4;13;28;56;105;138;121;259;213;577;164;166;330;383;514;290;227;203;1947
------;Straftaten insgesamt;16051000;Erfurt;X;8850;8;18;39;90;162;317;308;366;674;661;1652;520;631;1151;1481;2032;1160;753;621;7198
------;Straftaten insgesamt;9562000;Erlangen;M;2442;1;4;9;15;24;53;83;126;209;301;563;188;189;377;362;463;361;201;115;1879
------;Straftaten insgesamt;9562000;Erlangen;W;750;1;1;1;4;24;31;56;52;108;63;202;46;37;83;100;115;117;73;60;548
------;Straftaten insgesamt;9562000;Erlangen;X;3192;2;5;10;19;48;84;139;178;317;364;765;234;226;460;462;578;478;274;175;2427
------;Straftaten insgesamt;5113000;Essen;M;15096;1;3;25;88;230;347;510;718;1228;1469;3044;1123;1063;2186;2244;3216;2394;1264;748;12052
------;Straftaten insgesamt;5113000;Essen;W;5668;3;2;9;26;146;186;379;365;744;567;1497;352;320;672;781;1104;768;489;357;4171
------;Straftaten insgesamt;5113000;Essen;X;20764;4;5;34;114;376;533;889;1083;1972;2036;4541;1475;1383;2858;3025;4320;3162;1753;1105;16223
------;Straftaten insgesamt;6412000;Frankfurt am Main;M;35626;97;34;63;89;204;487;704;1696;2400;3044;5931;2282;2508;4790;5835;8726;5663;2891;1790;29695
------;Straftaten insgesamt;6412000;Frankfurt am Main;W;13619;81;29;35;39;140;324;451;632;1083;1095;2502;838;827;1665;1953;2870;2000;1382;1247;11117
------;Straftaten insgesamt;6412000;Frankfurt am Main;X;49245;178;63;98;128;344;811;1155;2328;3483;4139;8433;3120;3335;6455;7788;11596;7663;4273;3037;40812
------;Straftaten insgesamt;8311000;Freiburg im Breisgau;M;7643;3;10;22;36;95;166;246;580;826;878;1870;595;577;1172;1124;1467;990;645;375;5773
------;Straftaten insgesamt;8311000;Freiburg im Breisgau;W;2433;2;3;8;24;71;108;181;197;378;279;765;155;144;299;295;399;309;209;157;1668
------;Straftaten insgesamt;8311000;Freiburg im Breisgau;X;10076;5;13;30;60;166;274;427;777;1204;1157;2635;750;721;1471;1419;1866;1299;854;532;7441
------;Straftaten insgesamt;9563000;Fürth;M;2522;0;1;14;25;55;95;81;115;196;265;556;148;157;305;383;533;412;202;131;1966
------;Straftaten insgesamt;9563000;Fürth;W;858;0;1;2;6;16;25;44;57;101;72;198;47;47;94;100;159;138;92;77;660
------;Straftaten insgesamt;9563000;Fürth;X;3380;0;2;16;31;71;120;125;172;297;337;754;195;204;399;483;692;550;294;208;2626
------;Straftaten insgesamt;5513000;Gelsenkirchen;M;7018;6;7;34;67;154;268;251;316;567;659;1494;477;437;914;967;1485;1220;609;329;5524
------;Straftaten insgesamt;5513000;Gelsenkirchen;W;2535;0;5;11;27;94;137;137;143;280;251;668;155;157;312;297;507;367;233;151;1867
------;Straftaten insgesamt;5513000;Gelsenkirchen;X;9553;6;12;45;94;248;405;388;459;847;910;2162;632;594;1226;1264;1992;1587;842;480;7391
------;Straftaten insgesamt;3152012;Göttingen;M;3646;1;6;12;21;52;92;113;163;276;373;741;266;290;556;551;711;523;310;254;2905
------;Straftaten insgesamt;3152012;Göttingen;W;1235;0;2;4;7;32;45;73;67;140;116;301;71;73;144;158;210;176;130;116;934
------;Straftaten insgesamt;3152012;Göttingen;X;4881;1;8;16;28;84;137;186;230;416;489;1042;337;363;700;709;921;699;440;370;3839
------;Straftaten insgesamt;5914000;Hagen;M;5378;1;12;24;49;104;190;150;258;408;593;1191;374;379;753;774;1116;820;457;267;4187
------;Straftaten insgesamt;5914000;Hagen;W;1590;1;3;1;16;38;59;113;119;232;159;450;106;101;207;184;266;238;133;112;1140
------;Straftaten insgesamt;5914000;Hagen;X;6968;2;15;25;65;142;249;263;377;640;752;1641;480;480;960;958;1382;1058;590;379;5327
------;Straftaten insgesamt;15002000;Halle (Saale);M;6361;2;11;36;69;127;245;160;201;361;382;988;359;405;764;1075;1574;989;554;417;5373
------;Straftaten insgesamt;15002000;Halle (Saale);W;2350;1;6;11;28;76;122;104;117;221;165;508;114;135;249;388;469;286;235;215;1842
------;Straftaten insgesamt;15002000;Halle (Saale);X;8711;3;17;47;97;203;367;264;318;582;547;1496;473;540;1013;1463;2043;1275;789;632;7215
------;Straftaten insgesamt;2000000;Hamburg;M;57825;19;113;285;475;908;1800;1842;3138;4980;5298;12078;3482;3541;7023;8430;12693;9372;5067;3162;45747
------;Straftaten insgesamt;2000000;Hamburg;W;17226;9;24;54;124;477;688;925;909;1834;1370;3892;995;1037;2032;2176;3494;2698;1705;1229;13334
------;Straftaten insgesamt;2000000;Hamburg;X;75051;28;137;339;599;1385;2488;2767;4047;6814;6668;15970;4477;4578;9055;10606;16187;12070;6772;4391;59081
------;Straftaten insgesamt;5915000;Hamm;M;4562;1;7;10;16;42;76;141;197;338;508;922;317;333;650;699;1048;701;341;201;3640
------;Straftaten insgesamt;5915000;Hamm;W;1351;0;0;1;8;41;50;72;88;160;137;347;89;82;171;174;265;202;115;77;1004
------;Straftaten insgesamt;5915000;Hamm;X;5913;1;7;11;24;83;126;213;285;498;645;1269;406;415;821;873;1313;903;456;278;4644
------;Straftaten insgesamt;3241001;Hannover;M;21755;22;18;54;101;235;430;545;974;1519;2207;4156;1649;1603;3252;3379;4877;3200;1835;1056;17599
------;Straftaten insgesamt;3241001;Hannover;W;7644;18;11;8;33;165;235;455;498;953;705;1893;492;497;989;993;1471;1059;699;540;5751
------;Straftaten insgesamt;3241001;Hannover;X;29399;40;29;62;134;400;665;1000;1472;2472;2912;6049;2141;2100;4241;4372;6348;4259;2534;1596;23350
------;Straftaten insgesamt;8221000;Heidelberg;M;4110;0;4;5;18;57;84;144;239;383;532;999;337;318;655;581;769;536;343;227;3111
------;Straftaten insgesamt;8221000;Heidelberg;W;1497;0;0;4;7;36;47;119;90;209;178;434;117;90;207;186;242;185;116;127;1063
------;Straftaten insgesamt;8221000;Heidelberg;X;5607;0;4;9;25;93;131;263;329;592;710;1433;454;408;862;767;1011;721;459;354;4174
------;Straftaten insgesamt;8121000;Heilbronn;M;3194;2;2;8;17;29;58;103;178;281;355;694;214;202;416;505;678;476;242;183;2500
------;Straftaten insgesamt;8121000;Heilbronn;W;1016;1;4;2;4;33;44;90;75;165;95;304;58;60;118;122;193;133;82;64;712
------;Straftaten insgesamt;8121000;Heilbronn;X;4210;3;6;10;21;62;102;193;253;446;450;998;272;262;534;627;871;609;324;247;3212
------;Straftaten insgesamt;5916000;Herne;M;3764;0;6;14;32;70;122;133;186;319;333;774;242;222;464;560;803;614;339;210;2990
------;Straftaten insgesamt;5916000;Herne;W;1208;1;1;2;10;32;46;49;65;114;95;255;83;65;148;133;227;228;125;92;953
------;Straftaten insgesamt;5916000;Herne;X;4972;1;7;16;42;102;168;182;251;433;428;1029;325;287;612;693;1030;842;464;302;3943
------;Straftaten insgesamt;9161000;Ingolstadt;M;3308;0;2;10;24;43;79;98;174;272;320;671;258;215;473;469;702;523;284;186;2637
------;Straftaten insgesamt;9161000;Ingolstadt;W;1085;0;0;1;2;20;23;72;62;134;95;252;57;74;131;138;196;174;108;86;833
------;Straftaten insgesamt;9161000;Ingolstadt;X;4393;0;2;11;26;63;102;170;236;406;415;923;315;289;604;607;898;697;392;272;3470
------;Straftaten insgesamt;16053000;Jena;M;2346;0;3;5;15;28;51;49;79;128;203;382;159;205;364;428;560;311;187;114;1964
------;Straftaten insgesamt;16053000;Jena;W;791;0;2;1;4;22;29;23;27;50;64;143;47;55;102;117;179;107;74;69;648
------;Straftaten insgesamt;16053000;Jena;X;3137;0;5;6;19;50;80;72;106;178;267;525;206;260;466;545;739;418;261;183;2612
------;Straftaten insgesamt;8212000;Karlsruhe;M;9878;7;6;24;35;100;172;271;532;803;1208;2183;881;807;1688;1560;2056;1239;721;431;7695
------;Straftaten insgesamt;8212000;Karlsruhe;W;2962;15;2;17;13;48;95;216;211;427;333;855;189;179;368;332;558;373;282;194;2107
------;Straftaten insgesamt;8212000;Karlsruhe;X;12840;22;8;41;48;148;267;487;743;1230;1541;3038;1070;986;2056;1892;2614;1612;1003;625;9802
------;Straftaten insgesamt;6611000;Kassel;M;6174;7;14;9;30;44;104;165;280;445;575;1124;445;449;894;968;1376;915;540;357;5050
------;Straftaten insgesamt;6611000;Kassel;W;2077;2;4;1;10;38;55;119;121;240;197;492;139;138;277;271;379;317;190;151;1585
------;Straftaten insgesamt;6611000;Kassel;X;8251;9;18;10;40;82;159;284;401;685;772;1616;584;587;1171;1239;1755;1232;730;508;6635
------;Straftaten insgesamt;1002000;Kiel;M;6044;4;12;24;42;67;149;198;282;480;591;1220;461;402;863;862;1156;1039;559;345;4824
------;Straftaten insgesamt;1002000;Kiel;W;2014;3;0;5;11;36;55;114;126;240;176;471;137;142;279;253;372;303;175;161;1543
------;Straftaten insgesamt;1002000;Kiel;X;8058;7;12;29;53;103;204;312;408;720;767;1691;598;544;1142;1115;1528;1342;734;506;6367
------;Straftaten insgesamt;7111000;Koblenz;M;3779;0;3;9;22;31;65;108;173;281;433;779;300;263;563;610;797;484;356;190;3000
------;Straftaten insgesamt;7111000;Koblenz;W;1280;0;0;2;14;33;49;86;76;162;127;338;94;64;158;161;220;214;108;81;942
------;Straftaten insgesamt;7111000;Koblenz;X;5059;0;3;11;36;64;114;194;249;443;560;1117;394;327;721;771;1017;698;464;271;3942
------;Straftaten insgesamt;5315000;Köln;M;37440;9;34;88;161;428;720;1046;1959;3005;3789;7514;2592;2492;5084;5432;8158;5937;3270;2045;29926
------;Straftaten insgesamt;5315000;Köln;W;12657;8;18;25;68;251;370;707;783;1490;1194;3054;740;763;1503;1727;2455;1886;1109;923;9603
------;Straftaten insgesamt;5315000;Köln;X;50097;17;52;113;229;679;1090;1753;2742;4495;4983;10568;3332;3255;6587;7159;10613;7823;4379;2968;39529
------;Straftaten insgesamt;5114000;Krefeld;M;7215;1;9;16;42;96;164;177;271;448;693;1305;510;552;1062;1118;1605;1168;607;350;5910
------;Straftaten insgesamt;5114000;Krefeld;W;2435;1;3;6;19;53;82;115;138;253;242;577;170;153;323;338;478;367;212;140;1858
------;Straftaten insgesamt;5114000;Krefeld;X;9650;2;12;22;61;149;246;292;409;701;935;1882;680;705;1385;1456;2083;1535;819;490;7768
------;Straftaten insgesamt;14713000;Leipzig;M;15053;10;15;39;103;233;400;351;485;836;1035;2271;933;1085;2018;2692;3653;2208;1318;893;12782
------;Straftaten insgesamt;14713000;Leipzig;W;5268;4;4;13;44;114;179;250;184;434;372;985;327;389;716;836;1075;668;509;479;4283
------;Straftaten insgesamt;14713000;Leipzig;X;20321;14;19;52;147;347;579;601;669;1270;1407;3256;1260;1474;2734;3528;4728;2876;1827;1372;17065
------;Straftaten insgesamt;5316000;Leverkusen;M;3981;1;8;11;27;62;109;102;202;304;397;810;274;246;520;516;862;623;373;277;3171
------;Straftaten insgesamt;5316000;Leverkusen;W;1341;1;2;3;17;21;44;57;69;126;138;308;77;76;153;160;274;212;133;101;1033
------;Straftaten insgesamt;5316000;Leverkusen;X;5322;2;10;14;44;83;153;159;271;430;535;1118;351;322;673;676;1136;835;506;378;4204
------;Straftaten insgesamt;1003000;Lübeck;M;6482;5;11;23;31;87;157;229;338;567;543;1267;410;393;803;904;1281;1089;638;500;5215
------;Straftaten insgesamt;1003000;Lübeck;W;2269;3;2;9;22;58;94;123;145;268;195;557;126;118;244;258;418;345;223;224;1712
------;Straftaten insgesamt;1003000;Lübeck;X;8751;8;13;32;53;145;251;352;483;835;738;1824;536;511;1047;1162;1699;1434;861;724;6927
------;Straftaten insgesamt;7314000;Ludwigshafen am Rhein;M;5936;2;17;25;58;107;209;172;257;429;535;1173;407;398;805;840;1268;993;552;305;4763
------;Straftaten insgesamt;7314000;Ludwigshafen am Rhein;W;2389;0;2;6;19;67;94;117;125;242;215;551;162;135;297;316;454;391;226;154;1838
------;Straftaten insgesamt;7314000;Ludwigshafen am Rhein;X;8325;2;19;31;77;174;303;289;382;671;750;1724;569;533;1102;1156;1722;1384;778;459;6601
------;Straftaten insgesamt;15003000;Magdeburg;M;7353;1;6;28;57;119;211;226;310;536;600;1347;432;443;875;1147;1599;1188;741;456;6006
------;Straftaten insgesamt;15003000;Magdeburg;W;2811;0;3;8;25;68;104;142;111;253;208;565;170;175;345;374;538;399;310;280;2246
------;Straftaten insgesamt;15003000;Magdeburg;X;10164;1;9;36;82;187;315;368;421;789;808;1912;602;618;1220;1521;2137;1587;1051;736;8252
------;Straftaten insgesamt;7315000;Mainz;M;6410;0;2;16;27;56;101;166;351;517;728;1346;489;493;982;1037;1311;875;515;344;5064
------;Straftaten insgesamt;7315000;Mainz;W;2055;0;0;1;12;49;62;120;122;242;216;520;147;132;279;242;391;305;176;142;1535
------;Straftaten insgesamt;7315000;Mainz;X;8465;0;2;17;39;105;163;286;473;759;944;1866;636;625;1261;1279;1702;1180;691;486;6599
------;Straftaten insgesamt;8222000;Mannheim;M;9800;1;9;15;37;101;163;225;471;696;1027;1886;803;811;1614;1575;2102;1393;757;473;7914
------;Straftaten insgesamt;8222000;Mannheim;W;3429;1;0;6;19;67;93;179;196;375;394;862;251;235;486;469;611;496;301;204;2567
------;Straftaten insgesamt;8222000;Mannheim;X;13229;2;9;21;56;168;256;404;667;1071;1421;2748;1054;1046;2100;2044;2713;1889;1058;677;10481
------;Straftaten insgesamt;5170024;Moers;M;2220;0;2;14;18;50;84;41;100;141;229;454;155;143;298;305;483;341;205;134;1766
------;Straftaten insgesamt;5170024;Moers;W;734;0;0;1;1;19;21;35;32;67;67;155;41;40;81;90;132;117;89;70;579
------;Straftaten insgesamt;5170024;Moers;X;2954;0;2;15;19;69;105;76;132;208;296;609;196;183;379;395;615;458;294;204;2345
------;Straftaten insgesamt;5116000;Mönchengladbach;M;6319;4;3;19;38;89;153;179;285;464;672;1289;449;465;914;997;1349;921;527;322;5030
------;Straftaten insgesamt;5116000;Mönchengladbach;W;2184;2;3;7;9;64;85;150;139;289;231;605;140;144;284;272;394;301;182;146;1579
------;Straftaten insgesamt;5116000;Mönchengladbach;X;8503;6;6;26;47;153;238;329;424;753;903;1894;589;609;1198;1269;1743;1222;709;468;6609
------;Straftaten insgesamt;5117000;Mülheim an der Ruhr;M;3770;1;2;5;21;58;87;123;185;308;322;717;255;273;528;527;790;603;354;251;3053
------;Straftaten insgesamt;5117000;Mülheim an der Ruhr;W;1371;0;0;2;6;28;36;52;72;124;127;287;84;95;179;180;274;209;135;107;1084
------;Straftaten insgesamt;5117000;Mülheim an der Ruhr;X;5141;1;2;7;27;86;123;175;257;432;449;1004;339;368;707;707;1064;812;489;358;4137
------;Straftaten insgesamt;9162000;München;M;43003;5;26;55;153;356;595;988;2501;3489;5560;9644;3395;3451;6846;6870;8818;5801;3046;1978;33359
------;Straftaten insgesamt;9162000;München;W;13246;8;4;12;35;258;317;543;751;1294;1377;2988;887;834;1721;1897;2617;1826;1154;1043;10258
------;Straftaten insgesamt;9162000;München;X;56249;13;30;67;188;614;912;1531;3252;4783;6937;12632;4282;4285;8567;8767;11435;7627;4200;3021;43617
------;Straftaten insgesamt;5515000;Münster;M;7404;1;4;11;46;139;201;297;403;700;830;1731;598;553;1151;1125;1433;1001;578;385;5673
------;Straftaten insgesamt;5515000;Münster;W;2235;0;1;5;22;79;107;157;156;313;220;640;123;122;245;258;438;299;209;146;1595
------;Straftaten insgesamt;5515000;Münster;X;9639;1;5;16;68;218;308;454;559;1013;1050;2371;721;675;1396;1383;1871;1300;787;531;7268
------;Straftaten insgesamt;5162024;Neuss;M;4202;0;1;11;24;40;76;110;198;308;486;870;249;329;578;667;948;603;349;187;3332
------;Straftaten insgesamt;5162024;Neuss;W;1417;0;0;0;5;28;33;84;97;181;134;348;83;82;165;206;247;209;146;96;1069
------;Straftaten insgesamt;5162024;Neuss;X;5619;0;1;11;29;68;109;194;295;489;620;1218;332;411;743;873;1195;812;495;283;4401
------;Straftaten insgesamt;9564000;Nürnberg;M;14817;4;10;26;84;180;304;366;709;1075;1541;2920;1068;1070;2138;2223;3205;2260;1261;810;11897
------;Straftaten insgesamt;9564000;Nürnberg;W;5148;0;3;16;34;119;172;282;309;591;515;1278;341;332;673;643;948;751;452;403;3870
------;Straftaten insgesamt;9564000;Nürnberg;X;19965;4;13;42;118;299;476;648;1018;1666;2056;4198;1409;1402;2811;2866;4153;3011;1713;1213;15767
------;Straftaten insgesamt;5119000;Oberhausen;M;5739;0;5;14;37;85;141;167;252;419;671;1231;484;472;956;832;1169;856;443;252;4508
------;Straftaten insgesamt;5119000;Oberhausen;W;2243;0;0;6;14;75;95;147;161;308;260;663;171;126;297;317;395;292;158;121;1580
------;Straftaten insgesamt;5119000;Oberhausen;X;7982;0;5;20;51;160;236;314;413;727;931;1894;655;598;1253;1149;1564;1148;601;373;6088
------;Straftaten insgesamt;6413000;Offenbach am Main;M;4931;2;2;9;17;54;84;129;230;359;549;992;369;353;722;853;1151;706;314;193;3939
------;Straftaten insgesamt;6413000;Offenbach am Main;W;1549;0;0;1;5;24;30;67;109;176;190;396;117;95;212;220;310;203;131;77;1153
------;Straftaten insgesamt;6413000;Offenbach am Main;X;6480;2;2;10;22;78;114;196;339;535;739;1388;486;448;934;1073;1461;909;445;270;5092
------;Straftaten insgesamt;3403000;Oldenburg (Oldenburg);M;4081;1;2;6;15;58;82;144;223;367;435;884;289;297;586;595;838;594;366;218;3197
------;Straftaten insgesamt;3403000;Oldenburg (Oldenburg);W;1385;2;2;2;5;29;40;67;90;157;136;333;93;89;182;170;249;222;135;94;1052
------;Straftaten insgesamt;3403000;Oldenburg (Oldenburg);X;5466;3;4;8;20;87;122;211;313;524;571;1217;382;386;768;765;1087;816;501;312;4249
------;Straftaten insgesamt;3404000;Osnabrück;M;5424;1;4;6;25;54;90;153;243;396;557;1043;384;422;806;866;1191;781;467;270;4381
------;Straftaten insgesamt;3404000;Osnabrück;W;1690;0;0;2;8;31;41;88;97;185;153;379;112;98;210;220;327;259;161;134;1311
------;Straftaten insgesamt;3404000;Osnabrück;X;7114;1;4;8;33;85;131;241;340;581;710;1422;496;520;1016;1086;1518;1040;628;404;5692
------;Straftaten insgesamt;5774032;Paderborn;M;3946;1;4;7;6;50;68;135;270;405;543;1016;308;275;583;613;812;477;289;156;2930
------;Straftaten insgesamt;5774032;Paderborn;W;1207;0;0;0;9;18;27;79;104;183;151;361;86;78;164;133;232;150;97;70;846
------;Straftaten insgesamt;5774032;Paderborn;X;5153;1;4;7;15;68;95;214;374;588;694;1377;394;353;747;746;1044;627;386;226;3776
------;Straftaten insgesamt;8231000;Pforzheim;M;3325;0;5;7;39;71;122;140;210;350;352;824;256;226;482;497;604;476;262;180;2501
------;Straftaten insgesamt;8231000;Pforzheim;W;1235;0;1;2;2;53;58;86;76;162;115;335;80;59;139;156;222;171;112;100;900
------;Straftaten insgesamt;8231000;Pforzheim;X;4560;0;6;9;41;124;180;226;286;512;467;1159;336;285;621;653;826;647;374;280;3401
------;Straftaten insgesamt;12054000;Potsdam;M;3730;1;5;9;25;60;100;157;162;319;249;668;177;257;434;504;841;606;427;250;3062
------;Straftaten insgesamt;12054000;Potsdam;W;1337;0;1;4;6;36;47;77;64;141;88;276;62;71;133;177;279;187;152;133;1061
------;Straftaten insgesamt;12054000;Potsdam;X;5067;1;6;13;31;96;147;234;226;460;337;944;239;328;567;681;1120;793;579;383;4123
------;Straftaten insgesamt;5562032;Recklinghausen;M;3257;0;3;19;38;64;124;128;155;283;341;748;222;203;425;425;675;515;302;167;2509
------;Straftaten insgesamt;5562032;Recklinghausen;W;1068;0;2;3;10;25;40;61;56;117;97;254;57;59;116;122;208;188;104;76;814
------;Straftaten insgesamt;5562032;Recklinghausen;X;4325;0;5;22;48;89;164;189;211;400;438;1002;279;262;541;547;883;703;406;243;3323
------;Straftaten insgesamt;9362000;Regensburg;M;4236;2;6;7;23;51;89;123;235;358;461;908;376;315;691;621;899;579;323;215;3328
------;Straftaten insgesamt;9362000;Regensburg;W;1432;3;0;1;9;33;46;90;97;187;173;406;96;63;159;169;261;198;115;124;1026
------;Straftaten insgesamt;9362000;Regensburg;X;5668;5;6;8;32;84;135;213;332;545;634;1314;472;378;850;790;1160;777;438;339;4354
------;Straftaten insgesamt;5120000;Remscheid;M;2264;0;5;9;18;42;74;75;103;178;223;475;127;141;268;283;487;328;265;158;1789
------;Straftaten insgesamt;5120000;Remscheid;W;788;0;0;0;7;19;26;40;47;87;57;170;36;50;86;85;152;148;83;64;618
------;Straftaten insgesamt;5120000;Remscheid;X;3052;0;5;9;25;61;100;115;150;265;280;645;163;191;354;368;639;476;348;222;2407
------;Straftaten insgesamt;8415061;Reutlingen;M;2282;0;4;5;18;55;82;98;150;248;275;605;190;136;326;301;424;333;183;110;1677
------;Straftaten insgesamt;8415061;Reutlingen;W;786;0;0;1;7;22;30;61;68;129;90;249;49;27;76;89;138;98;84;52;537
------;Straftaten insgesamt;8415061;Reutlingen;X;3068;0;4;6;25;77;112;159;218;377;365;854;239;163;402;390;562;431;267;162;2214
------;Straftaten insgesamt;13003000;Rostock;M;5912;15;20;39;49;83;206;145;228;373;438;1017;374;463;837;1058;1370;777;511;342;4895
------;Straftaten insgesamt;13003000;Rostock;W;2151;22;5;14;30;56;127;102;109;211;160;498;122;170;292;287;386;270;229;189;1653
------;Straftaten insgesamt;13003000;Rostock;X;8063;37;25;53;79;139;333;247;337;584;598;1515;496;633;1129;1345;1756;1047;740;531;6548
------;Straftaten insgesamt;10041100;Saarbrücken;M;8089;12;14;40;45;108;219;306;606;912;892;2023;586;672;1258;1272;1561;1017;614;344;6066
------;Straftaten insgesamt;10041100;Saarbrücken;W;2994;5;10;18;30;106;169;214;200;414;347;930;195;175;370;356;517;361;255;205;2064
------;Straftaten insgesamt;10041100;Saarbrücken;X;11083;17;24;58;75;214;388;520;806;1326;1239;2953;781;847;1628;1628;2078;1378;869;549;8130
------;Straftaten insgesamt;5122000;Solingen;M;3349;0;2;12;29;49;92;106;180;286;342;720;198;220;418;372;684;559;340;256;2629
------;Straftaten insgesamt;5122000;Solingen;W;1175;0;0;2;5;44;51;47;58;105;98;254;61;63;124;135;236;201;120;105;921
------;Straftaten insgesamt;5122000;Solingen;X;4524;0;2;14;34;93;143;153;238;391;440;974;259;283;542;507;920;760;460;361;3550
------;Straftaten insgesamt;8111000;Stuttgart;M;20946;9;41;48;95;217;410;492;1108;1600;2501;4511;1751;1704;3455;3256;4319;2810;1556;1039;16435
------;Straftaten insgesamt;8111000;Stuttgart;W;6364;8;9;15;38;116;186;416;443;859;741;1786;461;407;868;873;1104;802;512;419;4578
------;Straftaten insgesamt;8111000;Stuttgart;X;27310;17;50;63;133;333;596;908;1551;2459;3242;6297;2212;2111;4323;4129;5423;3612;2068;1458;21013
------;Straftaten insgesamt;7211000;Trier;M;7144;0;2;12;27;34;75;158;291;449;818;1342;566;613;1179;1334;1726;901;452;210;5802
------;Straftaten insgesamt;7211000;Trier;W;3125;0;0;0;5;23;28;114;129;243;289;560;210;220;430;539;794;389;254;159;2565
------;Straftaten insgesamt;7211000;Trier;X;10269;0;2;12;32;57;103;272;420;692;1107;1902;776;833;1609;1873;2520;1290;706;369;8367
------;Straftaten insgesamt;8421000;Ulm;M;3821;1;2;13;25;67;108;112;253;365;426;899;287;279;566;570;829;491;296;170;2922
------;Straftaten insgesamt;8421000;Ulm;W;1375;2;2;4;10;51;69;110;108;218;178;465;96;60;156;166;243;146;111;88;910
------;Straftaten insgesamt;8421000;Ulm;X;5196;3;4;17;35;118;177;222;361;583;604;1364;383;339;722;736;1072;637;407;258;3832
------;Straftaten insgesamt;6414000;Wiesbaden;M;7063;2;12;23;32;110;179;267;357;624;749;1552;488;428;916;945;1474;1106;632;438;5511
------;Straftaten insgesamt;6414000;Wiesbaden;W;2465;0;2;8;18;56;84;129;152;281;209;574;141;147;288;285;501;358;232;227;1891
------;Straftaten insgesamt;6414000;Wiesbaden;X;9528;2;14;31;50;166;263;396;509;905;958;2126;629;575;1204;1230;1975;1464;864;665;7402
------;Straftaten insgesamt;3103000;Wolfsburg;M;2788;2;4;5;17;53;81;85;153;238;269;588;190;206;396;440;579;376;240;169;2200
------;Straftaten insgesamt;3103000;Wolfsburg;W;832;0;1;0;6;34;41;61;33;94;66;201;43;51;94;112;167;101;83;74;631
------;Straftaten insgesamt;3103000;Wolfsburg;X;3620;2;5;5;23;87;122;146;186;332;335;789;233;257;490;552;746;477;323;243;2831
------;Straftaten insgesamt;5124000;Wuppertal;M;9901;1;15;36;83;143;278;351;499;850;979;2107;632;646;1278;1333;2091;1578;940;574;7794
------;Straftaten insgesamt;5124000;Wuppertal;W;3422;1;5;8;21;85;120;233;208;441;322;883;224;227;451;389;664;487;308;240;2539
------;Straftaten insgesamt;5124000;Wuppertal;X;13323;2;20;44;104;228;398;584;707;1291;1301;2990;856;873;1729;1722;2755;2065;1248;814;10333
------;Straftaten insgesamt;9663000;Würzburg;M;5131;5;1;12;18;46;82;132;293;425;633;1140;470;411;881;870;1056;618;324;242;3991
------;Straftaten insgesamt;9663000;Würzburg;W;1393;0;0;1;6;41;48;86;78;164;158;370;97;95;192;187;239;164;127;114;1023
------;Straftaten insgesamt;9663000;Würzburg;X;6524;5;1;13;24;87;130;218;371;589;791;1510;567;506;1073;1057;1295;782;451;356;5014
111000;Vergewaltigung und sexuelle Nötigung §§ 177 Abs. 2, 3 und 4, 178 StGB;5334002;Aachen;M;13;0;0;0;0;0;0;0;0;0;1;1;1;2;3;2;1;3;2;1;12
111000;Vergewaltigung und sexuelle Nötigung §§ 177 Abs. 2, 3 und 4, 178 StGB;5334002;Aachen;W;0;0;0;0;0;0;0;0;0;0;0;0;0;0;0;0;0;0;0;0;0
111000;Vergewaltigung und sexuelle Nötigung §§ 177 Abs. 2, 3 und 4, 178 StGB;5334002;Aachen;X;13;0;0;0;0;0;0;0;0;0;1;1;1;2;3;2;1;3;2;1;12
111000;Vergewaltigung und sexuelle Nötigung §§ 177 Abs. 2, 3 und 4, 178 StGB;9761000;Augsburg;M;23;0;0;0;0;0;0;4;2;6;1;7;2;2;4;3;5;3;0;1;16
111000;Vergewaltigung und sexuelle Nötigung §§ 177 Abs. 2, 3 und 4, 178 StGB;9761000;Augsburg;W;0;0;0;0;0;0;0;0;0;0;0;0;0;0;0;0;0;0;0;0;0
111000;Vergewaltigung und sexuelle Nötigung §§ 177 Abs. 2, 3 und 4, 178 StGB;9761000;Augsburg;X;23;0;0;0;0;0;0;4;2;6;1;7;2;2;4;3;5;3;0;1;16
111000;Vergewaltigung und sexuelle Nötigung §§ 177 Abs. 2, 3 und 4, 178 StGB;5378004;Bergisch Gladbach;M;7;0;0;0;0;0;0;1;0;1;0;1;0;2;2;0;3;0;1;0;6
111000;Vergewaltigung und sexuelle Nötigung §§ 177 Abs. 2, 3 und 4, 178 StGB;5378004;Bergisch Gladbach;W;0;0;0;0;0;0;0;0;0;0;0;0;0;0;0;0;0;0;0;0;0
111000;Vergewaltigung und sexuelle Nötigung §§ 177 Abs. 2, 3 und 4, 178 StGB;5378004;Bergisch Gladbach;X;7;0;0;0;0;0;0;1;0;1;0;1;0;2;2;0;3;0;1;0;6
111000;Vergewaltigung und sexuelle Nötigung §§ 177 Abs. 2, 3 und 4, 178 StGB;11000000;Berlin;M;428;0;0;0;1;4;5;10;32;42;34;81;22;34;56;76;95;70;39;11;347
111000;Vergewaltigung und sexuelle Nötigung §§ 177 Abs. 2, 3 und 4, 178 StGB;11000000;Berlin;W;5;0;0;0;0;0;0;0;0;0;0;0;1;0;1;0;3;1;0;0;5
111000;Vergewaltigung und sexuelle Nötigung §§ 177 Abs. 2, 3 und 4, 178 StGB;11000000;Berlin;X;433;0;0;0;1;4;5;10;32;42;34;81;23;34;57;76;98;71;39;11;352
111000;Vergewaltigung und sexuelle Nötigung §§ 177 Abs. 2, 3 und 4, 178 StGB;5711000;Bielefeld;M;24;0;0;0;0;0;0;0;1;1;2;3;4;1;5;1;4;8;2;1;21
111000;Vergewaltigung und sexuelle Nötigung §§ 177 Abs. 2, 3 und 4, 178 StGB;5711000;Bielefeld;W;1;0;0;0;0;0;0;0;0;0;1;1;0;0;0;0;0;0;0;0;0
111000;Vergewaltigung und sexuelle Nötigung §§ 177 Abs. 2, 3 und 4, 178 StGB;5711000;Bielefeld;X;25;0;0;0;0;0;0;0;1;1;3;4;4;1;5;1;4;8;2;1;21
111000;Vergewaltigung und sexuelle Nötigung §§ 177 Abs. 2, 3 und 4, 178 StGB;5911000;Bochum;M;37;0;0;0;0;0;0;1;2;3;4;7;1;1;2;4;7;12;5;0;30
111000;Vergewaltigung und sexuelle Nötigung §§ 177 Abs. 2, 3 und 4, 178 StGB;5911000;Bochum;W;1;0;0;0;0;0;0;0;0;0;0;0;0;1;1;0;0;0;0;0;1
111000;Vergewaltigung und sexuelle Nötigung §§ 177 Abs. 2, 3 und 4, 178 StGB;5911000;Bochum;X;38;0;0;0;0;0;0;1;2;3;4;7;1;2;3;4;7;12;5;0;31
111000;Vergewaltigung und sexuelle Nötigung §§ 177 Abs. 2, 3 und 4, 178 StGB;5314000;Bonn;M;50;0;0;0;0;1;1;2;4;6;9;16;2;3;5;8;10;8;2;1;34
111000;Vergewaltigung und sexuelle Nötigung §§ 177 Abs. 2, 3 und 4, 178 StGB;5314000;Bonn;W;0;0;0;0;0;0;0;0;0;0;0;0;0;0;0;0;0;0;0;0;0
111000;Vergewaltigung und sexuelle Nötigung §§ 177 Abs. 2, 3 und 4, 178 StGB;5314000;Bonn;X;50;0;0;0;0;1;1;2;4;6;9;16;2;3;5;8;10;8;2;1;34
111000;Vergewaltigung und sexuelle Nötigung §§ 177 Abs. 2, 3 und 4, 178 StGB;5512000;Bottrop;M;13;0;0;0;0;0;0;1;1;2;4;6;0;2;2;1;3;0;0;1;7
111000;Vergewaltigung und sexuelle Nötigung §§ 177 Abs. 2, 3 und 4, 178 StGB;5512000;Bottrop;W;0;0;0;0;0;0;0;0;0;0;0;0;0;0;0;0;0;0;0;0;0
111000;Vergewaltigung und sexuelle Nötigung §§ 177 Abs. 2, 3 und 4, 178 StGB;5512000;Bottrop;X;13;0;0;0;0;0;0;1;1;2;4;6;0;2;2;1;3;0;0;1;7
111000;Vergewaltigung und sexuelle Nötigung §§ 177 Abs. 2, 3 und 4, 178 StGB;3101000;Braunschweig;M;46;0;0;0;0;0;0;0;6;6;11;17;5;1;6;5;14;1;3;0;29
111000;Vergewaltigung und sexuelle Nötigung §§ 177 Abs. 2, 3 und 4, 178 StGB;3101000;Braunschweig;W;2;0;0;0;0;0;0;0;0;0;0;0;0;0;0;1;0;1;0;0;2
111000;Vergewaltigung und sexuelle Nötigung §§ 177 Abs. 2, 3 und 4, 178 StGB;3101000;Braunschweig;X;48;0;0;0;0;0;0;0;6;6;11;17;5;1;6;6;14;2;3;0;31
111000;Vergewaltigung und sexuelle Nötigung §§ 177 Abs. 2, 3 und 4, 178 StGB;4011000;Bremen;M;72;0;0;0;0;1;1;3;6;9;6;16;4;6;10;9;16;14;2;5;56
111000;Vergewaltigung und sexuelle Nötigung §§ 177 Abs. 2, 3 und 4, 178 StGB;4011000;Bremen;W;0;0;0;0;0;0;0;0;0;0;0;0;0;0;0;0;0;0;0;0;0
111000;Vergewaltigung und sexuelle Nötigung §§ 177 Abs. 2, 3 und 4, 178 StGB;4011000;Bremen;X;72;0;0;0;0;1;1;3;6;9;6;16;4;6;10;9;16;14;2;5;56
111000;Vergewaltigung und sexuelle Nötigung §§ 177 Abs. 2, 3 und 4, 178 StGB;4012000;Bremerhaven;M;13;0;0;0;0;0;0;2;1;3;0;3;1;0;1;2;3;3;1;0;10
111000;Vergewaltigung und sexuelle Nötigung §§ 177 Abs. 2, 3 und 4, 178 StGB;4012000;Bremerhaven;W;0;0;0;0;0;0;0;0;0;0;0;0;0;0;0;0;0;0;0;0;0
111000;Vergewaltigung und sexuelle Nötigung §§ 177 Abs. 2, 3 und 4, 178 StGB;4012000;Bremerhaven;X;13;0;0;0;0;0;0;2;1;3;0;3;1;0;1;2;3;3;1;0;10
111000;Vergewaltigung und sexuelle Nötigung §§ 177 Abs. 2, 3 und 4, 178 StGB;14511000;Chemnitz;M;8;0;0;0;0;0;0;0;0;0;4;4;1;0;1;2;1;0;0;0;4
111000;Vergewaltigung und sexuelle Nötigung §§ 177 Abs. 2, 3 und 4, 178 StGB;14511000;Chemnitz;W;0;0;0;0;0;0;0;0;0;0;0;0;0;0;0;0;0;0;0;0;0
111000;Vergewaltigung und sexuelle Nötigung §§ 177 Abs. 2, 3 und 4, 178 StGB;14511000;Chemnitz;X;8;0;0;0;0;0;0;0;0;0;4;4;1;0;1;2;1;0;0;0;4
111000;Vergewaltigung und sexuelle Nötigung §§ 177 Abs. 2, 3 und 4, 178 StGB;6411000;Darmstadt;M;9;0;0;0;0;3;3;1;0;1;2;6;1;0;1;1;1;0;0;0;3
111000;Vergewaltigung und sexuelle Nötigung §§ 177 Abs. 2, 3 und 4, 178 StGB;6411000;Darmstadt;W;0;0;0;0;0;0;0;0;0;0;0;0;0;0;0;0;0;0;0;0;0
111000;Vergewaltigung und sexuelle Nötigung §§ 177 Abs. 2, 3 und 4, 178 StGB;6411000;Darmstadt;X;9;0;0;0;0;3;3;1;0;1;2;6;1;0;1;1;1;0;0;0;3
111000;Vergewaltigung und sexuelle Nötigung §§ 177 Abs. 2, 3 und 4, 178 StGB;5913000;Dortmund;M;60;0;0;0;0;0;0;4;6;10;6;16;5;5;10;9;8;13;2;2;44
111000;Vergewaltigung und sexuelle Nötigung §§ 177 Abs. 2, 3 und 4, 178 StGB;5913000;Dortmund;W;0;0;0;0;0;0;0;0;0;0;0;0;0;0;0;0;0;0;0;0;0
111000;Vergewaltigung und sexuelle Nötigung §§ 177 Abs. 2, 3 und 4, 178 StGB;5913000;Dortmund;X;60;0;0;0;0;0;0;4;6;10;6;16;5;5;10;9;8;13;2;2;44
111000;Vergewaltigung und sexuelle Nötigung §§ 177 Abs. 2, 3 und 4, 178 StGB;14612000;Dresden;M;18;0;0;0;0;1;1;1;0;1;1;3;1;1;2;1;3;4;2;3;15
111000;Vergewaltigung und sexuelle Nötigung §§ 177 Abs. 2, 3 und 4, 178 StGB;14612000;Dresden;W;0;0;0;0;0;0;0;0;0;0;0;0;0;0;0;0;0;0;0;0;0
111000;Vergewaltigung und sexuelle Nötigung §§ 177 Abs. 2, 3 und 4, 178 StGB;14612000;Dresden;X;18;0;0;0;0;1;1;1;0;1;1;3;1;1;2;1;3;4;2;3;15
111000;Vergewaltigung und sexuelle Nötigung §§ 177 Abs. 2, 3 und 4, 178 StGB;5112000;Duisburg;M;47;0;0;0;0;1;1;3;1;4;6;11;3;5;8;2;13;5;6;2;36
111000;Vergewaltigung und sexuelle Nötigung §§ 177 Abs. 2, 3 und 4, 178 StGB;5112000;Duisburg;W;2;0;0;0;0;0;0;0;0;0;0;0;1;0;1;0;0;0;1;0;2
111000;Vergewaltigung und sexuelle Nötigung §§ 177 Abs. 2, 3 und 4, 178 StGB;5112000;Duisburg;X;49;0;0;0;0;1;1;3;1;4;6;11;4;5;9;2;13;5;7;2;38
111000;Vergewaltigung und sexuelle Nötigung §§ 177 Abs. 2, 3 und 4, 178 StGB;5111000;Düsseldorf;M;61;0;0;0;0;0;0;3;0;3;5;8;3;6;9;11;18;8;4;3;53
111000;Vergewaltigung und sexuelle Nötigung §§ 177 Abs. 2, 3 und 4, 178 StGB;5111000;Düsseldorf;W;1;0;0;0;0;0;0;0;0;0;0;0;0;0;0;0;0;1;0;0;1
111000;Vergewaltigung und sexuelle Nötigung §§ 177 Abs. 2, 3 und 4, 178 StGB;5111000;Düsseldorf;X;62;0;0;0;0;0;0;3;0;3;5;8;3;6;9;11;18;9;4;3;54
111000;Vergewaltigung und sexuelle Nötigung §§ 177 Abs. 2, 3 und 4, 178 StGB;16051000;Erfurt;M;20;0;0;0;0;0;0;3;0;3;2;5;3;1;4;3;3;2;2;1;15
111000;Vergewaltigung und sexuelle Nötigung §§ 177 Abs. 2, 3 und 4, 178 StGB;16051000;Erfurt;W;0;0;0;0;0;0;0;0;0;0;0;0;0;0;0;0;0;0;0;0;0
111000;Vergewaltigung und sexuelle Nötigung §§ 177 Abs. 2, 3 und 4, 178 StGB;16051000;Erfurt;X;20;0;0;0;0;0;0;3;0;3;2;5;3;1;4;3;3;2;2;1;15
111000;Vergewaltigung und sexuelle Nötigung §§ 177 Abs. 2, 3 und 4, 178 StGB;9562000;Erlangen;M;6;0;0;0;0;0;0;0;0;0;3;3;0;1;1;0;0;2;0;0;3
111000;Vergewaltigung und sexuelle Nötigung §§ 177 Abs. 2, 3 und 4, 178 StGB;9562000;Erlangen;W;0;0;0;0;0;0;0;0;0;0;0;0;0;0;0;0;0;0;0;0;0
111000;Vergewaltigung und sexuelle Nötigung §§ 177 Abs. 2, 3 und 4, 178 StGB;9562000;Erlangen;X;6;0;0;0;0;0;0;0;0;0;3;3;0;1;1;0;0;2;0;0;3
111000;Vergewaltigung und sexuelle Nötigung §§ 177 Abs. 2, 3 und 4, 178 StGB;5113000;Essen;M;62;0;0;0;0;0;0;1;10;11;8;19;2;5;7;7;11;7;5;6;43
111000;Vergewaltigung und sexuelle Nötigung §§ 177 Abs. 2, 3 und 4, 178 StGB;5113000;Essen;W;0;0;0;0;0;0;0;0;0;0;0;0;0;0;0;0;0;0;0;0;0
111000;Vergewaltigung und sexuelle Nötigung §§ 177 Abs. 2, 3 und 4, 178 StGB;5113000;Essen;X;62;0;0;0;0;0;0;1;10;11;8;19;2;5;7;7;11;7;5;6;43
111000;Vergewaltigung und sexuelle Nötigung §§ 177 Abs. 2, 3 und 4, 178 StGB;6412000;Frankfurt am Main;M;73;0;0;0;0;0;0;1;2;3;6;9;2;5;7;14;19;15;5;4;64
111000;Vergewaltigung und sexuelle Nötigung §§ 177 Abs. 2, 3 und 4, 178 StGB;6412000;Frankfurt am Main;W;0;0;0;0;0;0;0;0;0;0;0;0;0;0;0;0;0;0;0;0;0
111000;Vergewaltigung und sexuelle Nötigung §§ 177 Abs. 2, 3 und 4, 178 StGB;6412000;Frankfurt am Main;X;73;0;0;0;0;0;0;1;2;3;6;9;2;5;7;14;19;15;5;4;64
111000;Vergewaltigung und sexuelle Nötigung §§ 177 Abs. 2, 3 und 4, 178 StGB;8311000;Freiburg im Breisgau;M;22;0;0;0;0;0;0;1;3;4;4;8;2;2;4;4;3;3;0;0;14
111000;Vergewaltigung und sexuelle Nötigung §§ 177 Abs. 2, 3 und 4, 178 StGB;8311000;Freiburg im Breisgau;W;1;0;0;0;0;0;0;0;0;0;0;0;0;0;0;1;0;0;0;0;1
111000;Vergewaltigung und sexuelle Nötigung §§ 177 Abs. 2, 3 und 4, 178 StGB;8311000;Freiburg im Breisgau;X;23;0;0;0;0;0;0;1;3;4;4;8;2;2;4;5;3;3;0;0;15
111000;Vergewaltigung und sexuelle Nötigung §§ 177 Abs. 2, 3 und 4, 178 StGB;9563000;Fürth;M;4;0;0;0;0;0;0;0;0;0;0;0;0;1;1;1;1;1;0;0;4
111000;Vergewaltigung und sexuelle Nötigung §§ 177 Abs. 2, 3 und 4, 178 StGB;9563000;Fürth;W;0;0;0;0;0;0;0;0;0;0;0;0;0;0;0;0;0;0;0;0;0
111000;Vergewaltigung und sexuelle Nötigung §§ 177 Abs. 2, 3 und 4, 178 StGB;9563000;Fürth;X;4;0;0;0;0;0;0;0;0;0;0;0;0;1;1;1;1;1;0;0;4
111000;Vergewaltigung und sexuelle Nötigung §§ 177 Abs. 2, 3 und 4, 178 StGB;5513000;Gelsenkirchen;M;28;0;0;0;0;0;0;1;5;6;5;11;2;0;2;3;5;4;3;0;17
111000;Vergewaltigung und sexuelle Nötigung §§ 177 Abs. 2, 3 und 4, 178 StGB;5513000;Gelsenkirchen;W;3;0;0;0;0;0;0;0;1;1;0;1;0;0;0;1;1;0;0;0;2
111000;Vergewaltigung und sexuelle Nötigung §§ 177 Abs. 2, 3 und 4, 178 StGB;5513000;Gelsenkirchen;X;31;0;0;0;0;0;0;1;6;7;5;12;2;0;2;4;6;4;3;0;19
111000;Vergewaltigung und sexuelle Nötigung §§ 177 Abs. 2, 3 und 4, 178 StGB;3152012;Göttingen;M;11;0;0;0;0;0;0;0;1;1;1;2;1;1;2;0;4;1;2;0;9
111000;Vergewaltigung und sexuelle Nötigung §§ 177 Abs. 2, 3 und 4, 178 StGB;3152012;Göttingen;W;0;0;0;0;0;0;0;0;0;0;0;0;0;0;0;0;0;0;0;0;0
111000;Vergewaltigung und sexuelle Nötigung §§ 177 Abs. 2, 3 und 4, 178 StGB;3152012;Göttingen;X;11;0;0;0;0;0;0;0;1;1;1;2;1;1;2;0;4;1;2;0;9
111000;Vergewaltigung und sexuelle Nötigung §§ 177 Abs. 2, 3 und 4, 178 StGB;5914000;Hagen;M;26;0;0;0;0;0;0;6;1;7;6;13;1;0;1;3;4;1;3;1;13
111000;Vergewaltigung und sexuelle Nötigung §§ 177 Abs. 2, 3 und 4, 178 StGB;5914000;Hagen;W;0;0;0;0;0;0;0;0;0;0;0;0;0;0;0;0;0;0;0;0;0
111000;Vergewaltigung und sexuelle Nötigung §§ 177 Abs. 2, 3 und 4, 178 StGB;5914000;Hagen;X;26;0;0;0;0;0;0;6;1;7;6;13;1;0;1;3;4;1;3;1;13
111000;Vergewaltigung und sexuelle Nötigung §§ 177 Abs. 2, 3 und 4, 178 StGB;15002000;Halle (Saale);M;18;0;0;0;0;0;0;0;1;1;1;2;2;2;4;3;6;1;2;0;16
111000;Vergewaltigung und sexuelle Nötigung §§ 177 Abs. 2, 3 und 4, 178 StGB;15002000;Halle (Saale);W;0;0;0;0;0;0;0;0;0;0;0;0;0;0;0;0;0;0;0;0;0
111000;Vergewaltigung und sexuelle Nötigung §§ 177 Abs. 2, 3 und 4, 178 StGB;15002000;Halle (Saale);X;18;0;0;0;0;0;0;0;1;1;1;2;2;2;4;3;6;1;2;0;16
111000;Vergewaltigung und sexuelle Nötigung §§ 177 Abs. 2, 3 und 4, 178 StGB;2000000;Hamburg;M;111;0;0;0;0;1;1;5;16;21;10;32;11;5;16;16;28;15;4;0;79
111000;Vergewaltigung und sexuelle Nötigung §§ 177 Abs. 2, 3 und 4, 178 StGB;2000000;Hamburg;W;1;0;0;0;0;0;0;0;0;0;0;0;1;0;1;0;0;0;0;0;1
111000;Vergewaltigung und sexuelle Nötigung §§ 177 Abs. 2, 3 und 4, 178 StGB;2000000;Hamburg;X;112;0;0;0;0;1;1;5;16;21;10;32;12;5;17;16;28;15;4;0;80
111000;Vergewaltigung und sexuelle Nötigung §§ 177 Abs. 2, 3 und 4, 178 StGB;5915000;Hamm;M;21;0;0;0;0;0;0;1;1;2;4;6;1;2;3;2;3;4;1;2;15
111000;Vergewaltigung und sexuelle Nötigung §§ 177 Abs. 2, 3 und 4, 178 StGB;5915000;Hamm;W;1;0;0;0;0;0;0;0;0;0;1;1;0;0;0;0;0;0;0;0;0
111000;Vergewaltigung und sexuelle Nötigung §§ 177 Abs. 2, 3 und 4, 178 StGB;5915000;Hamm;X;22;0;0;0;0;0;0;1;1;2;5;7;1;2;3;2;3;4;1;2;15
111000;Vergewaltigung und sexuelle Nötigung §§ 177 Abs. 2, 3 und 4, 178 StGB;3241001;Hannover;M;72;0;0;0;0;0;0;1;3;4;5;9;13;3;16;9;19;12;6;1;63
111000;Vergewaltigung und sexuelle Nötigung §§ 177 Abs. 2, 3 und 4, 178 StGB;3241001;Hannover;W;1;0;0;0;0;0;0;0;1;1;0;1;0;0;0;0;0;0;0;0;0
111000;Vergewaltigung und sexuelle Nötigung §§ 177 Abs. 2, 3 und 4, 178 StGB;3241001;Hannover;X;73;0;0;0;0;0;0;1;4;5;5;10;13;3;16;9;19;12;6;1;63
111000;Vergewaltigung und sexuelle Nötigung §§ 177 Abs. 2, 3 und 4, 178 StGB;8221000;Heidelberg;M;7;0;0;0;0;0;0;0;0;0;3;3;0;0;0;0;1;2;1;0;4
111000;Vergewaltigung und sexuelle Nötigung §§ 177 Abs. 2, 3 und 4, 178 StGB;8221000;Heidelberg;W;0;0;0;0;0;0;0;0;0;0;0;0;0;0;0;0;0;0;0;0;0
111000;Vergewaltigung und sexuelle Nötigung §§ 177 Abs. 2, 3 und 4, 178 StGB;8221000;Heidelberg;X;7;0;0;0;0;0;0;0;0;0;3;3;0;0;0;0;1;2;1;0;4
111000;Vergewaltigung und sexuelle Nötigung §§ 177 Abs. 2, 3 und 4, 178 StGB;8121000;Heilbronn;M;10;0;0;0;0;0;0;2;3;5;1;6;1;0;1;0;0;1;1;1;4
111000;Vergewaltigung und sexuelle Nötigung §§ 177 Abs. 2, 3 und 4, 178 StGB;8121000;Heilbronn;W;0;0;0;0;0;0;0;0;0;0;0;0;0;0;0;0;0;0;0;0;0
111000;Vergewaltigung und sexuelle Nötigung §§ 177 Abs. 2, 3 und 4, 178 StGB;8121000;Heilbronn;X;10;0;0;0;0;0;0;2;3;5;1;6;1;0;1;0;0;1;1;1;4
111000;Vergewaltigung und sexuelle Nötigung §§ 177 Abs. 2, 3 und 4, 178 StGB;5916000;Herne;M;16;0;0;0;0;0;0;2;1;3;1;4;1;1;2;4;2;4;0;0;12
111000;Vergewaltigung und sexuelle Nötigung §§ 177 Abs. 2, 3 und 4, 178 StGB;5916000;Herne;W;0;0;0;0;0;0;0;0;0;0;0;0;0;0;0;0;0;0;0;0;0
111000;Vergewaltigung und sexuelle Nötigung §§ 177 Abs. 2, 3 und 4, 178 StGB;5916000;Herne;X;16;0;0;0;0;0;0;2;1;3;1;4;1;1;2;4;2;4;0;0;12
111000;Vergewaltigung und sexuelle Nötigung §§ 177 Abs. 2, 3 und 4, 178 StGB;9161000;Ingolstadt;M;9;0;0;0;0;0;0;0;0;0;1;1;0;3;3;1;2;1;1;0;8
111000;Vergewaltigung und sexuelle Nötigung §§ 177 Abs. 2, 3 und 4, 178 StGB;9161000;Ingolstadt;W;0;0;0;0;0;0;0;0;0;0;0;0;0;0;0;0;0;0;0;0;0
111000;Vergewaltigung und sexuelle Nötigung §§ 177 Abs. 2, 3 und 4, 178 StGB;9161000;Ingolstadt;X;9;0;0;0;0;0;0;0;0;0;1;1;0;3;3;1;2;1;1;0;8
111000;Vergewaltigung und sexuelle Nötigung §§ 177 Abs. 2, 3 und 4, 178 StGB;16053000;Jena;M;6;0;0;0;0;0;0;0;0;0;0;0;0;0;0;2;3;0;1;0;6
111000;Vergewaltigung und sexuelle Nötigung §§ 177 Abs. 2, 3 und 4, 178 StGB;16053000;Jena;W;0;0;0;0;0;0;0;0;0;0;0;0;0;0;0;0;0;0;0;0;0
111000;Vergewaltigung und sexuelle Nötigung §§ 177 Abs. 2, 3 und 4, 178 StGB;16053000;Jena;X;6;0;0;0;0;0;0;0;0;0;0;0;0;0;0;2;3;0;1;0;6
111000;Vergewaltigung und sexuelle Nötigung §§ 177 Abs. 2, 3 und 4, 178 StGB;8212000;Karlsruhe;M;24;0;0;0;0;0;0;0;1;1;3;4;0;2;2;0;10;6;2;0;20
111000;Vergewaltigung und sexuelle Nötigung §§ 177 Abs. 2, 3 und 4, 178 StGB;8212000;Karlsruhe;W;0;0;0;0;0;0;0;0;0;0;0;0;0;0;0;0;0;0;0;0;0
111000;Vergewaltigung und sexuelle Nötigung §§ 177 Abs. 2, 3 und 4, 178 StGB;8212000;Karlsruhe;X;24;0;0;0;0;0;0;0;1;1;3;4;0;2;2;0;10;6;2;0;20
111000;Vergewaltigung und sexuelle Nötigung §§ 177 Abs. 2, 3 und 4, 178 StGB;6611000;Kassel;M;19;0;0;0;0;0;0;0;0;0;0;0;2;4;6;5;0;6;2;0;19
111000;Vergewaltigung und sexuelle Nötigung §§ 177 Abs. 2, 3 und 4, 178 StGB;6611000;Kassel;W;0;0;0;0;0;0;0;0;0;0;0;0;0;0;0;0;0;0;0;0;0
111000;Vergewaltigung und sexuelle Nötigung §§ 177 Abs. 2, 3 und 4, 178 StGB;6611000;Kassel;X;19;0;0;0;0;0;0;0;0;0;0;0;2;4;6;5;0;6;2;0;19
111000;Vergewaltigung und sexuelle Nötigung §§ 177 Abs. 2, 3 und 4, 178 StGB;1002000;Kiel;M;26;0;0;0;0;0;0;1;1;2;1;3;6;1;7;4;3;9;0;0;23
111000;Vergewaltigung und sexuelle Nötigung §§ 177 Abs. 2, 3 und 4, 178 StGB;1002000;Kiel;W;0;0;0;0;0;0;0;0;0;0;0;0;0;0;0;0;0;0;0;0;0
111000;Vergewaltigung und sexuelle Nötigung §§ 177 Abs. 2, 3 und 4, 178 StGB;1002000;Kiel;X;26;0;0;0;0;0;0;1;1;2;1;3;6;1;7;4;3;9;0;0;23
111000;Vergewaltigung und sexuelle Nötigung §§ 177 Abs. 2, 3 und 4, 178 StGB;7111000;Koblenz;M;7;0;0;0;0;0;0;0;1;1;0;1;0;2;2;1;3;0;0;0;6
111000;Vergewaltigung und sexuelle Nötigung §§ 177 Abs. 2, 3 und 4, 178 StGB;7111000;Koblenz;W;0;0;0;0;0;0;0;0;0;0;0;0;0;0;0;0;0;0;0;0;0
111000;Vergewaltigung und sexuelle Nötigung §§ 177 Abs. 2, 3 und 4, 178 StGB;7111000;Koblenz;X;7;0;0;0;0;0;0;0;1;1;0;1;0;2;2;1;3;0;0;0;6
111000;Vergewaltigung und sexuelle Nötigung §§ 177 Abs. 2, 3 und 4, 178 StGB;5315000;Köln;M;134;0;0;0;1;0;1;2;8;10;14;25;10;8;18;28;28;20;12;3;109
111000;Vergewaltigung und sexuelle Nötigung §§ 177 Abs. 2, 3 und 4, 178 StGB;5315000;Köln;W;6;0;0;0;0;0;0;0;1;1;0;1;1;0;1;0;1;1;1;1;5
111000;Vergewaltigung und sexuelle Nötigung §§ 177 Abs. 2, 3 und 4, 178 StGB;5315000;Köln;X;140;0;0;0;1;0;1;2;9;11;14;26;11;8;19;28;29;21;13;4;114
111000;Vergewaltigung und sexuelle Nötigung §§ 177 Abs. 2, 3 und 4, 178 StGB;5114000;Krefeld;M;24;0;0;0;0;0;0;1;3;4;1;5;2;1;3;7;5;2;2;0;19
111000;Vergewaltigung und sexuelle Nötigung §§ 177 Abs. 2, 3 und 4, 178 StGB;5114000;Krefeld;W;0;0;0;0;0;0;0;0;0;0;0;0;0;0;0;0;0;0;0;0;0
111000;Vergewaltigung und sexuelle Nötigung §§ 177 Abs. 2, 3 und 4, 178 StGB;5114000;Krefeld;X;24;0;0;0;0;0;0;1;3;4;1;5;2;1;3;7;5;2;2;0;19
111000;Vergewaltigung und sexuelle Nötigung §§ 177 Abs. 2, 3 und 4, 178 StGB;14713000;Leipzig;M;14;0;0;0;1;0;1;0;0;0;0;1;4;1;5;3;2;3;0;0;13
111000;Vergewaltigung und sexuelle Nötigung §§ 177 Abs. 2, 3 und 4, 178 StGB;14713000;Leipzig;W;0;0;0;0;0;0;0;0;0;0;0;0;0;0;0;0;0;0;0;0;0
111000;Vergewaltigung und sexuelle Nötigung §§ 177 Abs. 2, 3 und 4, 178 StGB;14713000;Leipzig;X;14;0;0;0;1;0;1;0;0;0;0;1;4;1;5;3;2;3;0;0;13
111000;Vergewaltigung und sexuelle Nötigung §§ 177 Abs. 2, 3 und 4, 178 StGB;5316000;Leverkusen;M;28;0;0;0;0;0;0;0;3;3;3;6;5;0;5;4;7;5;0;1;22
111000;Vergewaltigung und sexuelle Nötigung §§ 177 Abs. 2, 3 und 4, 178 StGB;5316000;Leverkusen;W;0;0;0;0;0;0;0;0;0;0;0;0;0;0;0;0;0;0;0;0;0
111000;Vergewaltigung und sexuelle Nötigung §§ 177 Abs. 2, 3 und 4, 178 StGB;5316000;Leverkusen;X;28;0;0;0;0;0;0;0;3;3;3;6;5;0;5;4;7;5;0;1;22
111000;Vergewaltigung und sexuelle Nötigung §§ 177 Abs. 2, 3 und 4, 178 StGB;1003000;Lübeck;M;23;0;0;0;0;1;1;0;2;2;2;5;0;3;3;5;9;1;0;0;18
111000;Vergewaltigung und sexuelle Nötigung §§ 177 Abs. 2, 3 und 4, 178 StGB;1003000;Lübeck;W;0;0;0;0;0;0;0;0;0;0;0;0;0;0;0;0;0;0;0;0;0
111000;Vergewaltigung und sexuelle Nötigung §§ 177 Abs. 2, 3 und 4, 178 StGB;1003000;Lübeck;X;23;0;0;0;0;1;1;0;2;2;2;5;0;3;3;5;9;1;0;0;18
111000;Vergewaltigung und sexuelle Nötigung §§ 177 Abs. 2, 3 und 4, 178 StGB;7314000;Ludwigshafen am Rhein;M;31;0;0;0;0;0;0;1;2;3;4;7;2;2;4;3;8;3;5;1;24
111000;Vergewaltigung und sexuelle Nötigung §§ 177 Abs. 2, 3 und 4, 178 StGB;7314000;Ludwigshafen am Rhein;W;1;0;0;0;0;0;0;0;0;0;0;0;0;0;0;1;0;0;0;0;1
111000;Vergewaltigung und sexuelle Nötigung §§ 177 Abs. 2, 3 und 4, 178 StGB;7314000;Ludwigshafen am Rhein;X;32;0;0;0;0;0;0;1;2;3;4;7;2;2;4;4;8;3;5;1;25
111000;Vergewaltigung und sexuelle Nötigung §§ 177 Abs. 2, 3 und 4, 178 StGB;15003000;Magdeburg;M;37;0;0;0;0;0;0;0;0;0;1;1;3;6;9;3;13;7;4;0;36
111000;Vergewaltigung und sexuelle Nötigung §§ 177 Abs. 2, 3 und 4, 178 StGB;15003000;Magdeburg;W;0;0;0;0;0;0;0;0;0;0;0;0;0;0;0;0;0;0;0;0;0
111000;Vergewaltigung und sexuelle Nötigung §§ 177 Abs. 2, 3 und 4, 178 StGB;15003000;Magdeburg;X;37;0;0;0;0;0;0;0;0;0;1;1;3;6;9;3;13;7;4;0;36
111000;Vergewaltigung und sexuelle Nötigung §§ 177 Abs. 2, 3 und 4, 178 StGB;7315000;Mainz;M;25;0;0;0;0;0;0;0;4;4;2;6;1;1;2;4;7;4;2;0;19
111000;Vergewaltigung und sexuelle Nötigung §§ 177 Abs. 2, 3 und 4, 178 StGB;7315000;Mainz;W;0;0;0;0;0;0;0;0;0;0;0;0;0;0;0;0;0;0;0;0;0
111000;Vergewaltigung und sexuelle Nötigung §§ 177 Abs. 2, 3 und 4, 178 StGB;7315000;Mainz;X;25;0;0;0;0;0;0;0;4;4;2;6;1;1;2;4;7;4;2;0;19
111000;Vergewaltigung und sexuelle Nötigung §§ 177 Abs. 2, 3 und 4, 178 StGB;8222000;Mannheim;M;30;0;0;0;0;0;0;0;0;0;0;0;3;2;5;4;11;5;5;0;30
111000;Vergewaltigung und sexuelle Nötigung §§ 177 Abs. 2, 3 und 4, 178 StGB;8222000;Mannheim;W;0;0;0;0;0;0;0;0;0;0;0;0;0;0;0;0;0;0;0;0;0
111000;Vergewaltigung und sexuelle Nötigung §§ 177 Abs. 2, 3 und 4, 178 StGB;8222000;Mannheim;X;30;0;0;0;0;0;0;0;0;0;0;0;3;2;5;4;11;5;5;0;30
111000;Vergewaltigung und sexuelle Nötigung §§ 177 Abs. 2, 3 und 4, 178 StGB;5170024;Moers;M;4;0;0;0;0;0;0;0;1;1;0;1;0;0;0;0;2;0;1;0;3
111000;Vergewaltigung und sexuelle Nötigung §§ 177 Abs. 2, 3 und 4, 178 StGB;5170024;Moers;W;0;0;0;0;0;0;0;0;0;0;0;0;0;0;0;0;0;0;0;0;0
111000;Vergewaltigung und sexuelle Nötigung §§ 177 Abs. 2, 3 und 4, 178 StGB;5170024;Moers;X;4;0;0;0;0;0;0;0;1;1;0;1;0;0;0;0;2;0;1;0;3
111000;Vergewaltigung und sexuelle Nötigung §§ 177 Abs. 2, 3 und 4, 178 StGB;5116000;Mönchengladbach;M;36;0;0;0;0;0;0;5;3;8;8;16;7;1;8;3;3;4;1;1;20
111000;Vergewaltigung und sexuelle Nötigung §§ 177 Abs. 2, 3 und 4, 178 StGB;5116000;Mönchengladbach;W;1;0;0;0;0;0;0;1;0;1;0;1;0;0;0;0;0;0;0;0;0
111000;Vergewaltigung und sexuelle Nötigung §§ 177 Abs. 2, 3 und 4, 178 StGB;5116000;Mönchengladbach;X;37;0;0;0;0;0;0;6;3;9;8;17;7;1;8;3;3;4;1;1;20
111000;Vergewaltigung und sexuelle Nötigung §§ 177 Abs. 2, 3 und 4, 178 StGB;5117000;Mülheim an der Ruhr;M;14;0;0;0;0;0;0;0;0;0;2;2;1;0;1;2;2;3;3;1;12
111000;Vergewaltigung und sexuelle Nötigung §§ 177 Abs. 2, 3 und 4, 178 StGB;5117000;Mülheim an der Ruhr;W;0;0;0;0;0;0;0;0;0;0;0;0;0;0;0;0;0;0;0;0;0
111000;Vergewaltigung und sexuelle Nötigung §§ 177 Abs. 2, 3 und 4, 178 StGB;5117000;Mülheim an der Ruhr;X;14;0;0;0;0;0;0;0;0;0;2;2;1;0;1;2;2;3;3;1;12
111000;Vergewaltigung und sexuelle Nötigung §§ 177 Abs. 2, 3 und 4, 178 StGB;9162000;München;M;121;0;0;0;0;0;0;2;7;9;10;19;8;7;15;18;36;19;12;2;102
111000;Vergewaltigung und sexuelle Nötigung §§ 177 Abs. 2, 3 und 4, 178 StGB;9162000;München;W;0;0;0;0;0;0;0;0;0;0;0;0;0;0;0;0;0;0;0;0;0
111000;Vergewaltigung und sexuelle Nötigung §§ 177 Abs. 2, 3 und 4, 178 StGB;9162000;München;X;121;0;0;0;0;0;0;2;7;9;10;19;8;7;15;18;36;19;12;2;102
111000;Vergewaltigung und sexuelle Nötigung §§ 177 Abs. 2, 3 und 4, 178 StGB;5515000;Münster;M;20;0;0;0;0;1;1;4;2;6;1;8;1;3;4;1;1;4;2;0;12
111000;Vergewaltigung und sexuelle Nötigung §§ 177 Abs. 2, 3 und 4, 178 StGB;5515000;Münster;W;0;0;0;0;0;0;0;0;0;0;0;0;0;0;0;0;0;0;0;0;0
111000;Vergewaltigung und sexuelle Nötigung §§ 177 Abs. 2, 3 und 4, 178 StGB;5515000;Münster;X;20;0;0;0;0;1;1;4;2;6;1;8;1;3;4;1;1;4;2;0;12
111000;Vergewaltigung und sexuelle Nötigung §§ 177 Abs. 2, 3 und 4, 178 StGB;5162024;Neuss;M;11;0;0;0;0;0;0;0;2;2;0;2;2;0;2;2;2;3;0;0;9
111000;Vergewaltigung und sexuelle Nötigung §§ 177 Abs. 2, 3 und 4, 178 StGB;5162024;Neuss;W;0;0;0;0;0;0;0;0;0;0;0;0;0;0;0;0;0;0;0;0;0
111000;Vergewaltigung und sexuelle Nötigung §§ 177 Abs. 2, 3 und 4, 178 StGB;5162024;Neuss;X;11;0;0;0;0;0;0;0;2;2;0;2;2;0;2;2;2;3;0;0;9
111000;Vergewaltigung und sexuelle Nötigung §§ 177 Abs. 2, 3 und 4, 178 StGB;9564000;Nürnberg;M;56;0;0;0;0;0;0;2;2;4;9;13;6;4;10;8;12;8;4;1;43
111000;Vergewaltigung und sexuelle Nötigung §§ 177 Abs. 2, 3 und 4, 178 StGB;9564000;Nürnberg;W;0;0;0;0;0;0;0;0;0;0;0;0;0;0;0;0;0;0;0;0;0
111000;Vergewaltigung und sexuelle Nötigung §§ 177 Abs. 2, 3 und 4, 178 StGB;9564000;Nürnberg;X;56;0;0;0;0;0;0;2;2;4;9;13;6;4;10;8;12;8;4;1;43
111000;Vergewaltigung und sexuelle Nötigung §§ 177 Abs. 2, 3 und 4, 178 StGB;5119000;Oberhausen;M;22;0;0;0;0;0;0;0;2;2;2;4;1;4;5;5;2;5;1;0;18
111000;Vergewaltigung und sexuelle Nötigung §§ 177 Abs. 2, 3 und 4, 178 StGB;5119000;Oberhausen;W;1;0;0;0;0;0;0;0;0;0;0;0;0;0;0;0;1;0;0;0;1
111000;Vergewaltigung und sexuelle Nötigung §§ 177 Abs. 2, 3 und 4, 178 StGB;5119000;Oberhausen;X;23;0;0;0;0;0;0;0;2;2;2;4;1;4;5;5;3;5;1;0;19
111000;Vergewaltigung und sexuelle Nötigung §§ 177 Abs. 2, 3 und 4, 178 StGB;6413000;Offenbach am Main;M;22;0;0;0;0;0;0;0;0;0;3;3;0;1;1;6;6;5;0;1;19
111000;Vergewaltigung und sexuelle Nötigung §§ 177 Abs. 2, 3 und 4, 178 StGB;6413000;Offenbach am Main;W;0;0;0;0;0;0;0;0;0;0;0;0;0;0;0;0;0;0;0;0;0
111000;Vergewaltigung und sexuelle Nötigung §§ 177 Abs. 2, 3 und 4, 178 StGB;6413000;Offenbach am Main;X;22;0;0;0;0;0;0;0;0;0;3;3;0;1;1;6;6;5;0;1;19
111000;Vergewaltigung und sexuelle Nötigung §§ 177 Abs. 2, 3 und 4, 178 StGB;3403000;Oldenburg (Oldenburg);M;20;0;0;0;0;0;0;0;1;1;1;2;1;4;5;4;5;2;0;2;18
111000;Vergewaltigung und sexuelle Nötigung §§ 177 Abs. 2, 3 und 4, 178 StGB;3403000;Oldenburg (Oldenburg);W;0;0;0;0;0;0;0;0;0;0;0;0;0;0;0;0;0;0;0;0;0
111000;Vergewaltigung und sexuelle Nötigung §§ 177 Abs. 2, 3 und 4, 178 StGB;3403000;Oldenburg (Oldenburg);X;20;0;0;0;0;0;0;0;1;1;1;2;1;4;5;4;5;2;0;2;18
111000;Vergewaltigung und sexuelle Nötigung §§ 177 Abs. 2, 3 und 4, 178 StGB;3404000;Osnabrück;M;30;0;0;0;0;1;1;1;3;4;3;8;4;1;5;4;6;4;1;2;22
111000;Vergewaltigung und sexuelle Nötigung §§ 177 Abs. 2, 3 und 4, 178 StGB;3404000;Osnabrück;W;0;0;0;0;0;0;0;0;0;0;0;0;0;0;0;0;0;0;0;0;0
111000;Vergewaltigung und sexuelle Nötigung §§ 177 Abs. 2, 3 und 4, 178 StGB;3404000;Osnabrück;X;30;0;0;0;0;1;1;1;3;4;3;8;4;1;5;4;6;4;1;2;22
111000;Vergewaltigung und sexuelle Nötigung §§ 177 Abs. 2, 3 und 4, 178 StGB;5774032;Paderborn;M;9;0;0;0;0;0;0;0;0;0;2;2;0;0;0;1;5;0;1;0;7
111000;Vergewaltigung und sexuelle Nötigung §§ 177 Abs. 2, 3 und 4, 178 StGB;5774032;Paderborn;W;0;0;0;0;0;0;0;0;0;0;0;0;0;0;0;0;0;0;0;0;0
111000;Vergewaltigung und sexuelle Nötigung §§ 177 Abs. 2, 3 und 4, 178 StGB;5774032;Paderborn;X;9;0;0;0;0;0;0;0;0;0;2;2;0;0;0;1;5;0;1;0;7
111000;Vergewaltigung und sexuelle Nötigung §§ 177 Abs. 2, 3 und 4, 178 StGB;8231000;Pforzheim;M;14;0;0;0;0;0;0;0;0;0;2;2;0;1;1;1;5;2;2;1;12
111000;Vergewaltigung und sexuelle Nötigung §§ 177 Abs. 2, 3 und 4, 178 StGB;8231000;Pforzheim;W;0;0;0;0;0;0;0;0;0;0;0;0;0;0;0;0;0;0;0;0;0
111000;Vergewaltigung und sexuelle Nötigung §§ 177 Abs. 2, 3 und 4, 178 StGB;8231000;Pforzheim;X;14;0;0;0;0;0;0;0;0;0;2;2;0;1;1;1;5;2;2;1;12
111000;Vergewaltigung und sexuelle Nötigung §§ 177 Abs. 2, 3 und 4, 178 StGB;12054000;Potsdam;M;12;0;0;0;0;0;0;0;0;0;0;0;0;2;2;1;2;5;1;1;12
111000;Vergewaltigung und sexuelle Nötigung §§ 177 Abs. 2, 3 und 4, 178 StGB;12054000;Potsdam;W;0;0;0;0;0;0;0;0;0;0;0;0;0;0;0;0;0;0;0;0;0
111000;Vergewaltigung und sexuelle Nötigung §§ 177 Abs. 2, 3 und 4, 178 StGB;12054000;Potsdam;X;12;0;0;0;0;0;0;0;0;0;0;0;0;2;2;1;2;5;1;1;12
111000;Vergewaltigung und sexuelle Nötigung §§ 177 Abs. 2, 3 und 4, 178 StGB;5562032;Recklinghausen;M;10;0;0;0;0;0;0;0;0;0;4;4;1;0;1;0;3;1;1;0;6
111000;Vergewaltigung und sexuelle Nötigung §§ 177 Abs. 2, 3 und 4, 178 StGB;5562032;Recklinghausen;W;0;0;0;0;0;0;0;0;0;0;0;0;0;0;0;0;0;0;0;0;0
111000;Vergewaltigung und sexuelle Nötigung §§ 177 Abs. 2, 3 und 4, 178 StGB;5562032;Recklinghausen;X;10;0;0;0;0;0;0;0;0;0;4;4;1;0;1;0;3;1;1;0;6
111000;Vergewaltigung und sexuelle Nötigung §§ 177 Abs. 2, 3 und 4, 178 StGB;9362000;Regensburg;M;12;0;0;0;0;0;0;0;0;0;3;3;2;0;2;1;3;1;1;1;9
111000;Vergewaltigung und sexuelle Nötigung §§ 177 Abs. 2, 3 und 4, 178 StGB;9362000;Regensburg;W;0;0;0;0;0;0;0;0;0;0;0;0;0;0;0;0;0;0;0;0;0
111000;Vergewaltigung und sexuelle Nötigung §§ 177 Abs. 2, 3 und 4, 178 StGB;9362000;Regensburg;X;12;0;0;0;0;0;0;0;0;0;3;3;2;0;2;1;3;1;1;1;9
111000;Vergewaltigung und sexuelle Nötigung §§ 177 Abs. 2, 3 und 4, 178 StGB;5120000;Remscheid;M;6;0;0;0;0;0;0;0;0;0;1;1;0;1;1;2;2;0;0;0;5
111000;Vergewaltigung und sexuelle Nötigung §§ 177 Abs. 2, 3 und 4, 178 StGB;5120000;Remscheid;W;0;0;0;0;0;0;0;0;0;0;0;0;0;0;0;0;0;0;0;0;0
111000;Vergewaltigung und sexuelle Nötigung §§ 177 Abs. 2, 3 und 4, 178 StGB;5120000;Remscheid;X;6;0;0;0;0;0;0;0;0;0;1;1;0;1;1;2;2;0;0;0;5
111000;Vergewaltigung und sexuelle Nötigung §§ 177 Abs. 2, 3 und 4, 178 StGB;8415061;Reutlingen;M;7;0;0;0;0;0;0;0;0;0;0;0;0;0;0;2;1;3;1;0;7
111000;Vergewaltigung und sexuelle Nötigung §§ 177 Abs. 2, 3 und 4, 178 StGB;8415061;Reutlingen;W;0;0;0;0;0;0;0;0;0;0;0;0;0;0;0;0;0;0;0;0;0
111000;Vergewaltigung und sexuelle Nötigung §§ 177 Abs. 2, 3 und 4, 178 StGB;8415061;Reutlingen;X;7;0;0;0;0;0;0;0;0;0;0;0;0;0;0;2;1;3;1;0;7
111000;Vergewaltigung und sexuelle Nötigung §§ 177 Abs. 2, 3 und 4, 178 StGB;13003000;Rostock;M;8;0;0;0;0;0;0;0;0;0;0;0;0;0;0;1;3;1;2;1;8
111000;Vergewaltigung und sexuelle Nötigung §§ 177 Abs. 2, 3 und 4, 178 StGB;13003000;Rostock;W;0;0;0;0;0;0;0;0;0;0;0;0;0;0;0;0;0;0;0;0;0
111000;Vergewaltigung und sexuelle Nötigung §§ 177 Abs. 2, 3 und 4, 178 StGB;13003000;Rostock;X;8;0;0;0;0;0;0;0;0;0;0;0;0;0;0;1;3;1;2;1;8
111000;Vergewaltigung und sexuelle Nötigung §§ 177 Abs. 2, 3 und 4, 178 StGB;10041100;Saarbrücken;M;20;0;0;0;0;0;0;2;1;3;3;6;2;2;4;5;4;1;0;0;14
111000;Vergewaltigung und sexuelle Nötigung §§ 177 Abs. 2, 3 und 4, 178 StGB;10041100;Saarbrücken;W;0;0;0;0;0;0;0;0;0;0;0;0;0;0;0;0;0;0;0;0;0
111000;Vergewaltigung und sexuelle Nötigung §§ 177 Abs. 2, 3 und 4, 178 StGB;10041100;Saarbrücken;X;20;0;0;0;0;0;0;2;1;3;3;6;2;2;4;5;4;1;0;0;14
111000;Vergewaltigung und sexuelle Nötigung §§ 177 Abs. 2, 3 und 4, 178 StGB;5122000;Solingen;M;14;0;0;0;0;0;0;0;1;1;2;3;0;3;3;0;4;3;0;1;11
111000;Vergewaltigung und sexuelle Nötigung §§ 177 Abs. 2, 3 und 4, 178 StGB;5122000;Solingen;W;0;0;0;0;0;0;0;0;0;0;0;0;0;0;0;0;0;0;0;0;0
111000;Vergewaltigung und sexuelle Nötigung §§ 177 Abs. 2, 3 und 4, 178 StGB;5122000;Solingen;X;14;0;0;0;0;0;0;0;1;1;2;3;0;3;3;0;4;3;0;1;11
111000;Vergewaltigung und sexuelle Nötigung §§ 177 Abs. 2, 3 und 4, 178 StGB;8111000;Stuttgart;M;66;0;0;0;0;0;0;2;3;5;4;9;5;5;10;10;17;12;4;4;57
111000;Vergewaltigung und sexuelle Nötigung §§ 177 Abs. 2, 3 und 4, 178 StGB;8111000;Stuttgart;W;0;0;0;0;0;0;0;0;0;0;0;0;0;0;0;0;0;0;0;0;0
111000;Vergewaltigung und sexuelle Nötigung §§ 177 Abs. 2, 3 und 4, 178 StGB;8111000;Stuttgart;X;66;0;0;0;0;0;0;2;3;5;4;9;5;5;10;10;17;12;4;4;57
111000;Vergewaltigung und sexuelle Nötigung §§ 177 Abs. 2, 3 und 4, 178 StGB;7211000;Trier;M;9;0;0;0;0;0;0;2;1;3;1;4;0;2;2;0;1;0;1;1;5
111000;Vergewaltigung und sexuelle Nötigung §§ 177 Abs. 2, 3 und 4, 178 StGB;7211000;Trier;W;0;0;0;0;0;0;0;0;0;0;0;0;0;0;0;0;0;0;0;0;0
111000;Vergewaltigung und sexuelle Nötigung §§ 177 Abs. 2, 3 und 4, 178 StGB;7211000;Trier;X;9;0;0;0;0;0;0;2;1;3;1;4;0;2;2;0;1;0;1;1;5
111000;Vergewaltigung und sexuelle Nötigung §§ 177 Abs. 2, 3 und 4, 178 StGB;8421000;Ulm;M;18;0;0;0;0;0;0;2;3;5;6;11;2;0;2;1;1;1;1;1;7
111000;Vergewaltigung und sexuelle Nötigung §§ 177 Abs. 2, 3 und 4, 178 StGB;8421000;Ulm;W;0;0;0;0;0;0;0;0;0;0;0;0;0;0;0;0;0;0;0;0;0
111000;Vergewaltigung und sexuelle Nötigung §§ 177 Abs. 2, 3 und 4, 178 StGB;8421000;Ulm;X;18;0;0;0;0;0;0;2;3;5;6;11;2;0;2;1;1;1;1;1;7
111000;Vergewaltigung und sexuelle Nötigung §§ 177 Abs. 2, 3 und 4, 178 StGB;6414000;Wiesbaden;M;31;0;0;0;0;0;0;1;0;1;5;6;0;2;2;5;8;5;5;0;25
111000;Vergewaltigung und sexuelle Nötigung §§ 177 Abs. 2, 3 und 4, 178 StGB;6414000;Wiesbaden;W;1;0;0;0;0;0;0;1;0;1;0;1;0;0;0;0;0;0;0;0;0
111000;Vergewaltigung und sexuelle Nötigung §§ 177 Abs. 2, 3 und 4, 178 StGB;6414000;Wiesbaden;X;32;0;0;0;0;0;0;2;0;2;5;7;0;2;2;5;8;5;5;0;25
111000;Vergewaltigung und sexuelle Nötigung §§ 177 Abs. 2, 3 und 4, 178 StGB;3103000;Wolfsburg;M;5;0;0;0;0;0;0;0;1;1;1;2;0;0;0;0;2;0;0;1;3
111000;Vergewaltigung und sexuelle Nötigung §§ 177 Abs. 2, 3 und 4, 178 StGB;3103000;Wolfsburg;W;0;0;0;0;0;0;0;0;0;0;0;0;0;0;0;0;0;0;0;0;0
111000;Vergewaltigung und sexuelle Nötigung §§ 177 Abs. 2, 3 und 4, 178 StGB;3103000;Wolfsburg;X;5;0;0;0;0;0;0;0;1;1;1;2;0;0;0;0;2;0;0;1;3
111000;Vergewaltigung und sexuelle Nötigung §§ 177 Abs. 2, 3 und 4, 178 StGB;5124000;Wuppertal;M;41;0;0;0;0;1;1;1;5;6;4;11;2;1;3;7;11;3;5;1;30
111000;Vergewaltigung und sexuelle Nötigung §§ 177 Abs. 2, 3 und 4, 178 StGB;5124000;Wuppertal;W;1;0;0;0;0;0;0;0;0;0;0;0;0;0;0;0;1;0;0;0;1
111000;Vergewaltigung und sexuelle Nötigung §§ 177 Abs. 2, 3 und 4, 178 StGB;5124000;Wuppertal;X;42;0;0;0;0;1;1;1;5;6;4;11;2;1;3;7;12;3;5;1;31
111000;Vergewaltigung und sexuelle Nötigung §§ 177 Abs. 2, 3 und 4, 178 StGB;9663000;Würzburg;M;15;0;0;0;0;0;0;0;1;1;2;3;1;3;4;2;3;1;1;1;12
111000;Vergewaltigung und sexuelle Nötigung §§ 177 Abs. 2, 3 und 4, 178 StGB;9663000;Würzburg;W;0;0;0;0;0;0;0;0;0;0;0;0;0;0;0;0;0;0;0;0;0
111000;Vergewaltigung und sexuelle Nötigung §§ 177 Abs. 2, 3 und 4, 178 StGB;9663000;Würzburg;X;15;0;0;0;0;0;0;0;1;1;2;3;1;3;4;2;3;1;1;1;12
210000;Raub, räuberische Erpressung und räuberischer Angriff auf Kraftfahrer §§ 249-252, 255, 316a StGB;5334002;Aachen;M;198;0;0;0;1;4;5;27;40;67;27;99;10;18;28;19;27;16;7;2;99
210000;Raub, räuberische Erpressung und räuberischer Angriff auf Kraftfahrer §§ 249-252, 255, 316a StGB;5334002;Aachen;W;9;0;0;0;0;0;0;0;2;2;2;4;1;0;1;0;3;1;0;0;5
210000;Raub, räuberische Erpressung und räuberischer Angriff auf Kraftfahrer §§ 249-252, 255, 316a StGB;5334002;Aachen;X;207;0;0;0;1;4;5;27;42;69;29;103;11;18;29;19;30;17;7;2;104
210000;Raub, räuberische Erpressung und räuberischer Angriff auf Kraftfahrer §§ 249-252, 255, 316a StGB;9761000;Augsburg;M;93;0;0;1;3;0;4;3;5;8;7;19;7;7;14;18;19;11;10;2;74
210000;Raub, räuberische Erpressung und räuberischer Angriff auf Kraftfahrer §§ 249-252, 255, 316a StGB;9761000;Augsburg;W;10;0;0;0;0;0;0;0;0;0;2;2;2;1;3;1;1;2;0;1;8
210000;Raub, räuberische Erpressung und räuberischer Angriff auf Kraftfahrer §§ 249-252, 255, 316a StGB;9761000;Augsburg;X;103;0;0;1;3;0;4;3;5;8;9;21;9;8;17;19;20;13;10;3;82
210000;Raub, räuberische Erpressung und räuberischer Angriff auf Kraftfahrer §§ 249-252, 255, 316a StGB;5378004;Bergisch Gladbach;M;49;0;0;0;1;0;1;5;9;14;12;27;2;0;2;6;11;2;1;0;22
210000;Raub, räuberische Erpressung und räuberischer Angriff auf Kraftfahrer §§ 249-252, 255, 316a StGB;5378004;Bergisch Gladbach;W;4;0;0;0;0;0;0;0;1;1;0;1;0;0;0;1;1;1;0;0;3
210000;Raub, räuberische Erpressung und räuberischer Angriff auf Kraftfahrer §§ 249-252, 255, 316a StGB;5378004;Bergisch Gladbach;X;53;0;0;0;1;0;1;5;10;15;12;28;2;0;2;7;12;3;1;0;25
210000;Raub, räuberische Erpressung und räuberischer Angriff auf Kraftfahrer §§ 249-252, 255, 316a StGB;11000000;Berlin;M;2123;0;0;3;20;79;102;217;346;563;407;1072;161;137;298;237;323;135;49;9;1051
210000;Raub, räuberische Erpressung und räuberischer Angriff auf Kraftfahrer §§ 249-252, 255, 316a StGB;11000000;Berlin;W;179;0;0;2;0;14;16;35;20;55;17;88;9;12;21;20;21;19;8;2;91
210000;Raub, räuberische Erpressung und räuberischer Angriff auf Kraftfahrer §§ 249-252, 255, 316a StGB;11000000;Berlin;X;2302;0;0;5;20;93;118;252;366;618;424;1160;170;149;319;257;344;154;57;11;1142
210000;Raub, räuberische Erpressung und räuberischer Angriff auf Kraftfahrer §§ 249-252, 255, 316a StGB;5711000;Bielefeld;M;150;0;0;0;0;1;1;11;19;30;30;61;9;16;25;20;31;8;5;0;89
210000;Raub, räuberische Erpressung und räuberischer Angriff auf Kraftfahrer §§ 249-252, 255, 316a StGB;5711000;Bielefeld;W;21;0;0;0;0;0;0;5;3;8;2;10;2;1;3;1;5;2;0;0;11
210000;Raub, räuberische Erpressung und räuberischer Angriff auf Kraftfahrer §§ 249-252, 255, 316a StGB;5711000;Bielefeld;X;171;0;0;0;0;1;1;16;22;38;32;71;11;17;28;21;36;10;5;0;100
210000;Raub, räuberische Erpressung und räuberischer Angriff auf Kraftfahrer §§ 249-252, 255, 316a StGB;5911000;Bochum;M;183;0;0;0;1;6;7;16;34;50;37;94;15;13;28;22;22;12;5;0;89
210000;Raub, räuberische Erpressung und räuberischer Angriff auf Kraftfahrer §§ 249-252, 255, 316a StGB;5911000;Bochum;W;29;0;0;0;0;5;5;3;4;7;4;16;0;1;1;3;5;2;2;0;13
210000;Raub, räuberische Erpressung und räuberischer Angriff auf Kraftfahrer §§ 249-252, 255, 316a StGB;5911000;Bochum;X;212;0;0;0;1;11;12;19;38;57;41;110;15;14;29;25;27;14;7;0;102
210000;Raub, räuberische Erpressung und räuberischer Angriff auf Kraftfahrer §§ 249-252, 255, 316a StGB;5314000;Bonn;M;200;0;0;0;2;6;8;19;25;44;39;91;14;12;26;22;36;18;6;1;109
210000;Raub, räuberische Erpressung und räuberischer Angriff auf Kraftfahrer §§ 249-252, 255, 316a StGB;5314000;Bonn;W;21;0;0;0;0;3;3;3;0;3;2;8;2;1;3;2;5;3;0;0;13
210000;Raub, räuberische Erpressung und räuberischer Angriff auf Kraftfahrer §§ 249-252, 255, 316a StGB;5314000;Bonn;X;221;0;0;0;2;9;11;22;25;47;41;99;16;13;29;24;41;21;6;1;122
210000;Raub, räuberische Erpressung und räuberischer Angriff auf Kraftfahrer §§ 249-252, 255, 316a StGB;5512000;Bottrop;M;29;0;0;0;1;0;1;2;1;3;6;10;6;1;7;6;3;3;0;0;19
210000;Raub, räuberische Erpressung und räuberischer Angriff auf Kraftfahrer §§ 249-252, 255, 316a StGB;5512000;Bottrop;W;7;0;0;0;0;4;4;1;0;1;0;5;0;1;1;1;0;0;0;0;2
210000;Raub, räuberische Erpressung und räuberischer Angriff auf Kraftfahrer §§ 249-252, 255, 316a StGB;5512000;Bottrop;X;36;0;0;0;1;4;5;3;1;4;6;15;6;2;8;7;3;3;0;0;21
210000;Raub, räuberische Erpressung und räuberischer Angriff auf Kraftfahrer §§ 249-252, 255, 316a StGB;3101000;Braunschweig;M;146;0;0;0;0;0;0;4;11;15;33;48;17;7;24;28;27;8;10;1;98
210000;Raub, räuberische Erpressung und räuberischer Angriff auf Kraftfahrer §§ 249-252, 255, 316a StGB;3101000;Braunschweig;W;12;0;0;0;0;1;1;1;0;1;4;6;0;0;0;2;2;2;0;0;6
210000;Raub, räuberische Erpressung und räuberischer Angriff auf Kraftfahrer §§ 249-252, 255, 316a StGB;3101000;Braunschweig;X;158;0;0;0;0;1;1;5;11;16;37;54;17;7;24;30;29;10;10;1;104
210000;Raub, räuberische Erpressung und räuberischer Angriff auf Kraftfahrer §§ 249-252, 255, 316a StGB;4011000;Bremen;M;460;0;0;0;5;7;12;48;71;119;73;204;45;33;78;58;75;31;9;5;256
210000;Raub, räuberische Erpressung und räuberischer Angriff auf Kraftfahrer §§ 249-252, 255, 316a StGB;4011000;Bremen;W;30;0;0;0;0;0;0;2;4;6;1;7;1;2;3;8;6;3;2;1;23
210000;Raub, räuberische Erpressung und räuberischer Angriff auf Kraftfahrer §§ 249-252, 255, 316a StGB;4011000;Bremen;X;490;0;0;0;5;7;12;50;75;125;74;211;46;35;81;66;81;34;11;6;279
210000;Raub, räuberische Erpressung und räuberischer Angriff auf Kraftfahrer §§ 249-252, 255, 316a StGB;4012000;Bremerhaven;M;109;0;0;0;0;0;0;1;10;11;25;36;7;13;20;17;24;7;4;1;73
210000;Raub, räuberische Erpressung und räuberischer Angriff auf Kraftfahrer §§ 249-252, 255, 316a StGB;4012000;Bremerhaven;W;9;0;0;0;0;1;1;0;1;1;3;5;0;0;0;1;2;0;1;0;4
210000;Raub, räuberische Erpressung und räuberischer Angriff auf Kraftfahrer §§ 249-252, 255, 316a StGB;4012000;Bremerhaven;X;118;0;0;0;0;1;1;1;11;12;28;41;7;13;20;18;26;7;5;1;77
210000;Raub, räuberische Erpressung und räuberischer Angriff auf Kraftfahrer §§ 249-252, 255, 316a StGB;14511000;Chemnitz;M;140;0;0;0;0;0;0;3;6;9;16;25;9;21;30;33;39;9;3;1;115
210000;Raub, räuberische Erpressung und räuberischer Angriff auf Kraftfahrer §§ 249-252, 255, 316a StGB;14511000;Chemnitz;W;20;0;0;0;0;1;1;5;2;7;4;12;0;0;0;2;4;2;0;0;8
210000;Raub, räuberische Erpressung und räuberischer Angriff auf Kraftfahrer §§ 249-252, 255, 316a StGB;14511000;Chemnitz;X;160;0;0;0;0;1;1;8;8;16;20;37;9;21;30;35;43;11;3;1;123
210000;Raub, räuberische Erpressung und räuberischer Angriff auf Kraftfahrer §§ 249-252, 255, 316a StGB;6411000;Darmstadt;M;77;0;0;0;0;2;2;9;13;22;13;37;7;5;12;8;13;6;1;0;40
210000;Raub, räuberische Erpressung und räuberischer Angriff auf Kraftfahrer §§ 249-252, 255, 316a StGB;6411000;Darmstadt;W;5;0;0;0;0;0;0;0;1;1;1;2;0;0;0;2;0;1;0;0;3
210000;Raub, räuberische Erpressung und räuberischer Angriff auf Kraftfahrer §§ 249-252, 255, 316a StGB;6411000;Darmstadt;X;82;0;0;0;0;2;2;9;14;23;14;39;7;5;12;10;13;7;1;0;43
210000;Raub, räuberische Erpressung und räuberischer Angriff auf Kraftfahrer §§ 249-252, 255, 316a StGB;5913000;Dortmund;M;483;0;1;2;10;12;25;31;72;103;88;216;40;32;72;66;85;34;8;2;267
210000;Raub, räuberische Erpressung und räuberischer Angriff auf Kraftfahrer §§ 249-252, 255, 316a StGB;5913000;Dortmund;W;52;0;0;2;0;8;10;4;8;12;9;31;1;2;3;3;8;2;5;0;21
210000;Raub, räuberische Erpressung und räuberischer Angriff auf Kraftfahrer §§ 249-252, 255, 316a StGB;5913000;Dortmund;X;535;0;1;4;10;20;35;35;80;115;97;247;41;34;75;69;93;36;13;2;288
210000;Raub, räuberische Erpressung und räuberischer Angriff auf Kraftfahrer §§ 249-252, 255, 316a StGB;14612000;Dresden;M;231;0;0;0;0;4;4;9;13;22;23;49;22;19;41;49;62;22;6;2;182
210000;Raub, räuberische Erpressung und räuberischer Angriff auf Kraftfahrer §§ 249-252, 255, 316a StGB;14612000;Dresden;W;18;0;0;0;0;0;0;0;0;0;4;4;0;1;1;7;5;1;0;0;14
210000;Raub, räuberische Erpressung und räuberischer Angriff auf Kraftfahrer §§ 249-252, 255, 316a StGB;14612000;Dresden;X;249;0;0;0;0;4;4;9;13;22;27;53;22;20;42;56;67;23;6;2;196
210000;Raub, räuberische Erpressung und räuberischer Angriff auf Kraftfahrer §§ 249-252, 255, 316a StGB;5112000;Duisburg;M;290;0;0;0;3;20;23;39;35;74;48;145;23;9;32;35;47;17;10;4;145
210000;Raub, räuberische Erpressung und räuberischer Angriff auf Kraftfahrer §§ 249-252, 255, 316a StGB;5112000;Duisburg;W;28;0;0;0;0;3;3;2;2;4;2;9;5;1;6;1;6;4;0;2;19
210000;Raub, räuberische Erpressung und räuberischer Angriff auf Kraftfahrer §§ 249-252, 255, 316a StGB;5112000;Duisburg;X;318;0;0;0;3;23;26;41;37;78;50;154;28;10;38;36;53;21;10;6;164
210000;Raub, räuberische Erpressung und räuberischer Angriff auf Kraftfahrer §§ 249-252, 255, 316a StGB;5111000;Düsseldorf;M;371;0;0;0;3;7;10;27;45;72;65;147;36;32;68;42;73;33;6;2;224
210000;Raub, räuberische Erpressung und räuberischer Angriff auf Kraftfahrer §§ 249-252, 255, 316a StGB;5111000;Düsseldorf;W;43;0;0;0;0;5;5;2;6;8;3;16;2;4;6;4;8;7;2;0;27
210000;Raub, räuberische Erpressung und räuberischer Angriff auf Kraftfahrer §§ 249-252, 255, 316a StGB;5111000;Düsseldorf;X;414;0;0;0;3;12;15;29;51;80;68;163;38;36;74;46;81;40;8;2;251
210000;Raub, räuberische Erpressung und räuberischer Angriff auf Kraftfahrer §§ 249-252, 255, 316a StGB;16051000;Erfurt;M;119;0;0;0;0;4;4;2;14;16;18;38;9;13;22;19;29;8;3;0;81
210000;Raub, räuberische Erpressung und räuberischer Angriff auf Kraftfahrer §§ 249-252, 255, 316a StGB;16051000;Erfurt;W;15;0;0;0;0;0;0;0;1;1;0;1;1;1;2;3;4;0;3;2;14
210000;Raub, räuberische Erpressung und räuberischer Angriff auf Kraftfahrer §§ 249-252, 255, 316a StGB;16051000;Erfurt;X;134;0;0;0;0;4;4;2;15;17;18;39;10;14;24;22;33;8;6;2;95
210000;Raub, räuberische Erpressung und räuberischer Angriff auf Kraftfahrer §§ 249-252, 255, 316a StGB;9562000;Erlangen;M;25;0;0;0;0;0;0;2;3;5;2;7;1;1;2;5;6;4;1;0;18
210000;Raub, räuberische Erpressung und räuberischer Angriff auf Kraftfahrer §§ 249-252, 255, 316a StGB;9562000;Erlangen;W;0;0;0;0;0;0;0;0;0;0;0;0;0;0;0;0;0;0;0;0;0
210000;Raub, räuberische Erpressung und räuberischer Angriff auf Kraftfahrer §§ 249-252, 255, 316a StGB;9562000;Erlangen;X;25;0;0;0;0;0;0;2;3;5;2;7;1;1;2;5;6;4;1;0;18
210000;Raub, räuberische Erpressung und räuberischer Angriff auf Kraftfahrer §§ 249-252, 255, 316a StGB;5113000;Essen;M;321;0;0;1;2;17;20;36;48;84;51;155;25;18;43;35;43;34;8;3;166
210000;Raub, räuberische Erpressung und räuberischer Angriff auf Kraftfahrer §§ 249-252, 255, 316a StGB;5113000;Essen;W;44;0;0;0;0;3;3;3;9;12;7;22;2;2;4;3;9;2;3;1;22
210000;Raub, räuberische Erpressung und räuberischer Angriff auf Kraftfahrer §§ 249-252, 255, 316a StGB;5113000;Essen;X;365;0;0;1;2;20;23;39;57;96;58;177;27;20;47;38;52;36;11;4;188
210000;Raub, räuberische Erpressung und räuberischer Angriff auf Kraftfahrer §§ 249-252, 255, 316a StGB;6412000;Frankfurt am Main;M;506;0;0;1;1;8;10;24;71;95;89;194;37;23;60;77;103;54;13;5;312
210000;Raub, räuberische Erpressung und räuberischer Angriff auf Kraftfahrer §§ 249-252, 255, 316a StGB;6412000;Frankfurt am Main;W;47;0;0;0;0;1;1;5;3;8;6;15;2;1;3;7;11;8;2;1;32
210000;Raub, räuberische Erpressung und räuberischer Angriff auf Kraftfahrer §§ 249-252, 255, 316a StGB;6412000;Frankfurt am Main;X;553;0;0;1;1;9;11;29;74;103;95;209;39;24;63;84;114;62;15;6;344
210000;Raub, räuberische Erpressung und räuberischer Angriff auf Kraftfahrer §§ 249-252, 255, 316a StGB;8311000;Freiburg im Breisgau;M;115;0;0;0;0;1;1;10;20;30;18;49;12;8;20;10;19;11;5;1;66
210000;Raub, räuberische Erpressung und räuberischer Angriff auf Kraftfahrer §§ 249-252, 255, 316a StGB;8311000;Freiburg im Breisgau;W;7;0;0;0;0;0;0;0;0;0;1;1;1;1;2;2;2;0;0;0;6
210000;Raub, räuberische Erpressung und räuberischer Angriff auf Kraftfahrer §§ 249-252, 255, 316a StGB;8311000;Freiburg im Breisgau;X;122;0;0;0;0;1;1;10;20;30;19;50;13;9;22;12;21;11;5;1;72
210000;Raub, räuberische Erpressung und räuberischer Angriff auf Kraftfahrer §§ 249-252, 255, 316a StGB;9563000;Fürth;M;39;0;0;0;0;1;1;2;2;4;5;10;2;1;3;6;10;6;3;1;29
210000;Raub, räuberische Erpressung und räuberischer Angriff auf Kraftfahrer §§ 249-252, 255, 316a StGB;9563000;Fürth;W;9;0;0;0;0;2;2;1;0;1;2;5;2;0;2;1;1;0;0;0;4
210000;Raub, räuberische Erpressung und räuberischer Angriff auf Kraftfahrer §§ 249-252, 255, 316a StGB;9563000;Fürth;X;48;0;0;0;0;3;3;3;2;5;7;15;4;1;5;7;11;6;3;1;33
210000;Raub, räuberische Erpressung und räuberischer Angriff auf Kraftfahrer §§ 249-252, 255, 316a StGB;5513000;Gelsenkirchen;M;170;0;0;1;2;10;13;26;22;48;28;89;10;12;22;22;28;7;2;0;81
210000;Raub, räuberische Erpressung und räuberischer Angriff auf Kraftfahrer §§ 249-252, 255, 316a StGB;5513000;Gelsenkirchen;W;31;0;0;0;0;2;2;2;1;3;8;13;1;3;4;5;4;3;2;0;18
210000;Raub, räuberische Erpressung und räuberischer Angriff auf Kraftfahrer §§ 249-252, 255, 316a StGB;5513000;Gelsenkirchen;X;201;0;0;1;2;12;15;28;23;51;36;102;11;15;26;27;32;10;4;0;99
210000;Raub, räuberische Erpressung und räuberischer Angriff auf Kraftfahrer §§ 249-252, 255, 316a StGB;3152012;Göttingen;M;70;0;0;0;0;0;0;4;5;9;16;25;5;6;11;12;11;7;4;0;45
210000;Raub, räuberische Erpressung und räuberischer Angriff auf Kraftfahrer §§ 249-252, 255, 316a StGB;3152012;Göttingen;W;13;0;0;0;0;0;0;0;0;0;2;2;0;0;0;2;8;0;1;0;11
210000;Raub, räuberische Erpressung und räuberischer Angriff auf Kraftfahrer §§ 249-252, 255, 316a StGB;3152012;Göttingen;X;83;0;0;0;0;0;0;4;5;9;18;27;5;6;11;14;19;7;5;0;56
210000;Raub, räuberische Erpressung und räuberischer Angriff auf Kraftfahrer §§ 249-252, 255, 316a StGB;5914000;Hagen;M;114;0;0;0;0;1;1;5;26;31;23;55;11;9;20;11;18;8;1;1;59
210000;Raub, räuberische Erpressung und räuberischer Angriff auf Kraftfahrer §§ 249-252, 255, 316a StGB;5914000;Hagen;W;11;0;0;0;0;2;2;1;0;1;0;3;3;1;4;0;3;1;0;0;8
210000;Raub, räuberische Erpressung und räuberischer Angriff auf Kraftfahrer §§ 249-252, 255, 316a StGB;5914000;Hagen;X;125;0;0;0;0;3;3;6;26;32;23;58;14;10;24;11;21;9;1;1;67
210000;Raub, räuberische Erpressung und räuberischer Angriff auf Kraftfahrer §§ 249-252, 255, 316a StGB;15002000;Halle (Saale);M;199;0;0;3;1;2;6;9;22;31;42;79;18;17;35;34;34;13;4;0;120
210000;Raub, räuberische Erpressung und räuberischer Angriff auf Kraftfahrer §§ 249-252, 255, 316a StGB;15002000;Halle (Saale);W;14;0;0;0;0;0;0;0;0;0;4;4;2;2;4;2;2;2;0;0;10
210000;Raub, räuberische Erpressung und räuberischer Angriff auf Kraftfahrer §§ 249-252, 255, 316a StGB;15002000;Halle (Saale);X;213;0;0;3;1;2;6;9;22;31;46;83;20;19;39;36;36;15;4;0;130
210000;Raub, räuberische Erpressung und räuberischer Angriff auf Kraftfahrer §§ 249-252, 255, 316a StGB;2000000;Hamburg;M;1300;0;0;5;7;32;44;107;207;314;247;605;86;83;169;148;227;98;47;6;695
210000;Raub, räuberische Erpressung und räuberischer Angriff auf Kraftfahrer §§ 249-252, 255, 316a StGB;2000000;Hamburg;W;142;0;0;0;3;5;8;9;9;18;13;39;8;5;13;22;36;18;12;2;103
210000;Raub, räuberische Erpressung und räuberischer Angriff auf Kraftfahrer §§ 249-252, 255, 316a StGB;2000000;Hamburg;X;1442;0;0;5;10;37;52;116;216;332;260;644;94;88;182;170;263;116;59;8;798
210000;Raub, räuberische Erpressung und räuberischer Angriff auf Kraftfahrer §§ 249-252, 255, 316a StGB;5915000;Hamm;M;92;0;0;0;3;2;5;4;13;17;24;46;7;9;16;6;18;5;1;0;46
210000;Raub, räuberische Erpressung und räuberischer Angriff auf Kraftfahrer §§ 249-252, 255, 316a StGB;5915000;Hamm;W;9;0;0;0;0;0;0;0;4;4;2;6;0;1;1;1;0;1;0;0;3
210000;Raub, räuberische Erpressung und räuberischer Angriff auf Kraftfahrer §§ 249-252, 255, 316a StGB;5915000;Hamm;X;101;0;0;0;3;2;5;4;17;21;26;52;7;10;17;7;18;6;1;0;49
210000;Raub, räuberische Erpressung und räuberischer Angriff auf Kraftfahrer §§ 249-252, 255, 316a StGB;3241001;Hannover;M;381;0;0;1;1;8;10;23;40;63;64;137;26;33;59;50;87;34;9;5;244
210000;Raub, räuberische Erpressung und räuberischer Angriff auf Kraftfahrer §§ 249-252, 255, 316a StGB;3241001;Hannover;W;34;0;0;0;0;2;2;2;2;4;5;11;1;7;8;2;4;6;1;2;23
210000;Raub, räuberische Erpressung und räuberischer Angriff auf Kraftfahrer §§ 249-252, 255, 316a StGB;3241001;Hannover;X;415;0;0;1;1;10;12;25;42;67;69;148;27;40;67;52;91;40;10;7;267
210000;Raub, räuberische Erpressung und räuberischer Angriff auf Kraftfahrer §§ 249-252, 255, 316a StGB;8221000;Heidelberg;M;55;0;0;0;0;0;0;4;2;6;10;16;6;3;9;2;15;7;5;1;39
210000;Raub, räuberische Erpressung und räuberischer Angriff auf Kraftfahrer §§ 249-252, 255, 316a StGB;8221000;Heidelberg;W;3;0;0;0;0;0;0;0;0;0;1;1;0;0;0;2;0;0;0;0;2
210000;Raub, räuberische Erpressung und räuberischer Angriff auf Kraftfahrer §§ 249-252, 255, 316a StGB;8221000;Heidelberg;X;58;0;0;0;0;0;0;4;2;6;11;17;6;3;9;4;15;7;5;1;41
210000;Raub, räuberische Erpressung und räuberischer Angriff auf Kraftfahrer §§ 249-252, 255, 316a StGB;8121000;Heilbronn;M;52;0;0;0;0;0;0;2;9;11;6;17;6;4;10;7;13;4;0;1;35
210000;Raub, räuberische Erpressung und räuberischer Angriff auf Kraftfahrer §§ 249-252, 255, 316a StGB;8121000;Heilbronn;W;6;0;0;0;0;0;0;0;2;2;1;3;0;1;1;1;1;0;0;0;3
210000;Raub, räuberische Erpressung und räuberischer Angriff auf Kraftfahrer §§ 249-252, 255, 316a StGB;8121000;Heilbronn;X;58;0;0;0;0;0;0;2;11;13;7;20;6;5;11;8;14;4;0;1;38
210000;Raub, räuberische Erpressung und räuberischer Angriff auf Kraftfahrer §§ 249-252, 255, 316a StGB;5916000;Herne;M;76;0;0;0;1;2;3;12;7;19;14;36;1;3;4;10;10;11;3;2;40
210000;Raub, räuberische Erpressung und räuberischer Angriff auf Kraftfahrer §§ 249-252, 255, 316a StGB;5916000;Herne;W;5;0;0;0;0;0;0;0;2;2;1;3;0;0;0;1;1;0;0;0;2
210000;Raub, räuberische Erpressung und räuberischer Angriff auf Kraftfahrer §§ 249-252, 255, 316a StGB;5916000;Herne;X;81;0;0;0;1;2;3;12;9;21;15;39;1;3;4;11;11;11;3;2;42
210000;Raub, räuberische Erpressung und räuberischer Angriff auf Kraftfahrer §§ 249-252, 255, 316a StGB;9161000;Ingolstadt;M;40;0;0;0;0;3;3;2;4;6;7;16;4;2;6;4;8;4;1;1;24
210000;Raub, räuberische Erpressung und räuberischer Angriff auf Kraftfahrer §§ 249-252, 255, 316a StGB;9161000;Ingolstadt;W;4;0;0;0;0;0;0;0;0;0;0;0;0;0;0;1;1;2;0;0;4
210000;Raub, räuberische Erpressung und räuberischer Angriff auf Kraftfahrer §§ 249-252, 255, 316a StGB;9161000;Ingolstadt;X;44;0;0;0;0;3;3;2;4;6;7;16;4;2;6;5;9;6;1;1;28
210000;Raub, räuberische Erpressung und räuberischer Angriff auf Kraftfahrer §§ 249-252, 255, 316a StGB;16053000;Jena;M;19;0;0;0;0;2;2;3;1;4;1;7;0;1;1;3;4;3;1;0;12
210000;Raub, räuberische Erpressung und räuberischer Angriff auf Kraftfahrer §§ 249-252, 255, 316a StGB;16053000;Jena;W;2;0;0;0;0;0;0;0;0;0;0;0;2;0;2;0;0;0;0;0;2
210000;Raub, räuberische Erpressung und räuberischer Angriff auf Kraftfahrer §§ 249-252, 255, 316a StGB;16053000;Jena;X;21;0;0;0;0;2;2;3;1;4;1;7;2;1;3;3;4;3;1;0;14
210000;Raub, räuberische Erpressung und räuberischer Angriff auf Kraftfahrer §§ 249-252, 255, 316a StGB;8212000;Karlsruhe;M;127;0;0;0;1;1;2;2;24;26;23;51;9;4;13;19;27;11;6;0;76
210000;Raub, räuberische Erpressung und räuberischer Angriff auf Kraftfahrer §§ 249-252, 255, 316a StGB;8212000;Karlsruhe;W;15;0;0;0;0;0;0;5;4;9;1;10;1;0;1;0;3;1;0;0;5
210000;Raub, räuberische Erpressung und räuberischer Angriff auf Kraftfahrer §§ 249-252, 255, 316a StGB;8212000;Karlsruhe;X;142;0;0;0;1;1;2;7;28;35;24;61;10;4;14;19;30;12;6;0;81
210000;Raub, räuberische Erpressung und räuberischer Angriff auf Kraftfahrer §§ 249-252, 255, 316a StGB;6611000;Kassel;M;140;0;0;0;0;1;1;7;21;28;25;54;11;10;21;18;21;19;6;1;86
210000;Raub, räuberische Erpressung und räuberischer Angriff auf Kraftfahrer §§ 249-252, 255, 316a StGB;6611000;Kassel;W;23;0;0;0;0;4;4;1;2;3;6;13;0;1;1;3;4;2;0;0;10
210000;Raub, räuberische Erpressung und räuberischer Angriff auf Kraftfahrer §§ 249-252, 255, 316a StGB;6611000;Kassel;X;163;0;0;0;0;5;5;8;23;31;31;67;11;11;22;21;25;21;6;1;96
210000;Raub, räuberische Erpressung und räuberischer Angriff auf Kraftfahrer §§ 249-252, 255, 316a StGB;1002000;Kiel;M;155;0;0;0;0;0;0;7;15;22;39;61;16;13;29;25;27;10;1;2;94
210000;Raub, räuberische Erpressung und räuberischer Angriff auf Kraftfahrer §§ 249-252, 255, 316a StGB;1002000;Kiel;W;20;0;0;0;0;0;0;0;1;1;2;3;3;1;4;4;5;3;0;1;17
210000;Raub, räuberische Erpressung und räuberischer Angriff auf Kraftfahrer §§ 249-252, 255, 316a StGB;1002000;Kiel;X;175;0;0;0;0;0;0;7;16;23;41;64;19;14;33;29;32;13;1;3;111
210000;Raub, räuberische Erpressung und räuberischer Angriff auf Kraftfahrer §§ 249-252, 255, 316a StGB;7111000;Koblenz;M;42;0;0;0;0;1;1;7;2;9;4;14;3;4;7;4;11;3;2;1;28
210000;Raub, räuberische Erpressung und räuberischer Angriff auf Kraftfahrer §§ 249-252, 255, 316a StGB;7111000;Koblenz;W;4;0;0;0;0;0;0;0;0;0;1;1;1;0;1;0;2;0;0;0;3
210000;Raub, räuberische Erpressung und räuberischer Angriff auf Kraftfahrer §§ 249-252, 255, 316a StGB;7111000;Koblenz;X;46;0;0;0;0;1;1;7;2;9;5;15;4;4;8;4;13;3;2;1;31
210000;Raub, räuberische Erpressung und räuberischer Angriff auf Kraftfahrer §§ 249-252, 255, 316a StGB;5315000;Köln;M;746;0;0;0;3;20;23;42;126;168;123;314;58;54;112;87;156;56;18;3;432
210000;Raub, räuberische Erpressung und räuberischer Angriff auf Kraftfahrer §§ 249-252, 255, 316a StGB;5315000;Köln;W;78;0;1;0;1;2;4;11;10;21;4;29;3;4;7;13;20;4;3;2;49
210000;Raub, räuberische Erpressung und räuberischer Angriff auf Kraftfahrer §§ 249-252, 255, 316a StGB;5315000;Köln;X;824;0;1;0;4;22;27;53;136;189;127;343;61;58;119;100;176;60;21;5;481
210000;Raub, räuberische Erpressung und räuberischer Angriff auf Kraftfahrer §§ 249-252, 255, 316a StGB;5114000;Krefeld;M;137;0;0;0;0;1;1;5;15;20;24;45;15;8;23;15;27;16;7;4;92
210000;Raub, räuberische Erpressung und räuberischer Angriff auf Kraftfahrer §§ 249-252, 255, 316a StGB;5114000;Krefeld;W;19;0;0;0;0;0;0;1;2;3;2;5;1;2;3;3;4;2;1;1;14
210000;Raub, räuberische Erpressung und räuberischer Angriff auf Kraftfahrer §§ 249-252, 255, 316a StGB;5114000;Krefeld;X;156;0;0;0;0;1;1;6;17;23;26;50;16;10;26;18;31;18;8;5;106
210000;Raub, räuberische Erpressung und räuberischer Angriff auf Kraftfahrer §§ 249-252, 255, 316a StGB;14713000;Leipzig;M;360;0;0;0;2;8;10;21;33;54;47;111;31;37;68;71;80;23;3;4;249
210000;Raub, räuberische Erpressung und räuberischer Angriff auf Kraftfahrer §§ 249-252, 255, 316a StGB;14713000;Leipzig;W;36;0;0;0;0;2;2;6;4;10;2;14;1;4;5;9;5;2;1;0;22
210000;Raub, räuberische Erpressung und räuberischer Angriff auf Kraftfahrer §§ 249-252, 255, 316a StGB;14713000;Leipzig;X;396;0;0;0;2;10;12;27;37;64;49;125;32;41;73;80;85;25;4;4;271
210000;Raub, räuberische Erpressung und räuberischer Angriff auf Kraftfahrer §§ 249-252, 255, 316a StGB;5316000;Leverkusen;M;80;0;0;0;0;0;0;2;9;11;15;26;13;5;18;11;15;5;5;0;54
210000;Raub, räuberische Erpressung und räuberischer Angriff auf Kraftfahrer §§ 249-252, 255, 316a StGB;5316000;Leverkusen;W;11;0;0;0;0;0;0;1;2;3;3;6;1;0;1;0;1;2;1;0;5
210000;Raub, räuberische Erpressung und räuberischer Angriff auf Kraftfahrer §§ 249-252, 255, 316a StGB;5316000;Leverkusen;X;91;0;0;0;0;0;0;3;11;14;18;32;14;5;19;11;16;7;6;0;59
210000;Raub, räuberische Erpressung und räuberischer Angriff auf Kraftfahrer §§ 249-252, 255, 316a StGB;1003000;Lübeck;M;105;0;0;0;0;2;2;3;9;12;20;34;7;12;19;12;25;10;4;1;71
210000;Raub, räuberische Erpressung und räuberischer Angriff auf Kraftfahrer §§ 249-252, 255, 316a StGB;1003000;Lübeck;W;10;0;0;0;0;1;1;1;2;3;0;4;1;0;1;2;0;3;0;0;6
210000;Raub, räuberische Erpressung und räuberischer Angriff auf Kraftfahrer §§ 249-252, 255, 316a StGB;1003000;Lübeck;X;115;0;0;0;0;3;3;4;11;15;20;38;8;12;20;14;25;13;4;1;77
210000;Raub, räuberische Erpressung und räuberischer Angriff auf Kraftfahrer §§ 249-252, 255, 316a StGB;7314000;Ludwigshafen am Rhein;M;102;0;0;2;0;4;6;8;15;23;23;52;8;4;12;16;11;5;4;2;50
210000;Raub, räuberische Erpressung und räuberischer Angriff auf Kraftfahrer §§ 249-252, 255, 316a StGB;7314000;Ludwigshafen am Rhein;W;15;0;0;0;0;1;1;1;1;2;1;4;2;0;2;2;3;2;1;1;11
210000;Raub, räuberische Erpressung und räuberischer Angriff auf Kraftfahrer §§ 249-252, 255, 316a StGB;7314000;Ludwigshafen am Rhein;X;117;0;0;2;0;5;7;9;16;25;24;56;10;4;14;18;14;7;5;3;61
210000;Raub, räuberische Erpressung und räuberischer Angriff auf Kraftfahrer §§ 249-252, 255, 316a StGB;15003000;Magdeburg;M;174;0;0;0;0;5;5;20;20;40;38;83;14;13;27;23;22;15;4;0;91
210000;Raub, räuberische Erpressung und räuberischer Angriff auf Kraftfahrer §§ 249-252, 255, 316a StGB;15003000;Magdeburg;W;22;0;0;0;0;2;2;3;4;7;2;11;2;1;3;3;3;1;1;0;11
210000;Raub, räuberische Erpressung und räuberischer Angriff auf Kraftfahrer §§ 249-252, 255, 316a StGB;15003000;Magdeburg;X;196;0;0;0;0;7;7;23;24;47;40;94;16;14;30;26;25;16;5;0;102
210000;Raub, räuberische Erpressung und räuberischer Angriff auf Kraftfahrer §§ 249-252, 255, 316a StGB;7315000;Mainz;M;107;0;0;0;1;2;3;12;14;26;30;59;7;2;9;9;12;13;4;1;48
210000;Raub, räuberische Erpressung und räuberischer Angriff auf Kraftfahrer §§ 249-252, 255, 316a StGB;7315000;Mainz;W;11;0;0;0;0;0;0;3;0;3;1;4;1;2;3;3;0;1;0;0;7
210000;Raub, räuberische Erpressung und räuberischer Angriff auf Kraftfahrer §§ 249-252, 255, 316a StGB;7315000;Mainz;X;118;0;0;0;1;2;3;15;14;29;31;63;8;4;12;12;12;14;4;1;55
210000;Raub, räuberische Erpressung und räuberischer Angriff auf Kraftfahrer §§ 249-252, 255, 316a StGB;8222000;Mannheim;M;148;0;0;0;1;2;3;14;27;41;22;66;9;7;16;25;20;16;4;1;82
210000;Raub, räuberische Erpressung und räuberischer Angriff auf Kraftfahrer §§ 249-252, 255, 316a StGB;8222000;Mannheim;W;17;0;0;0;0;1;1;2;1;3;0;4;0;3;3;1;5;3;1;0;13
210000;Raub, räuberische Erpressung und räuberischer Angriff auf Kraftfahrer §§ 249-252, 255, 316a StGB;8222000;Mannheim;X;165;0;0;0;1;3;4;16;28;44;22;70;9;10;19;26;25;19;5;1;95
210000;Raub, räuberische Erpressung und räuberischer Angriff auf Kraftfahrer §§ 249-252, 255, 316a StGB;5170024;Moers;M;43;0;0;0;1;0;1;0;12;12;6;19;2;2;4;7;6;6;1;0;24
210000;Raub, räuberische Erpressung und räuberischer Angriff auf Kraftfahrer §§ 249-252, 255, 316a StGB;5170024;Moers;W;1;0;0;0;0;0;0;0;0;0;0;0;0;0;0;1;0;0;0;0;1
210000;Raub, räuberische Erpressung und räuberischer Angriff auf Kraftfahrer §§ 249-252, 255, 316a StGB;5170024;Moers;X;44;0;0;0;1;0;1;0;12;12;6;19;2;2;4;8;6;6;1;0;25
210000;Raub, räuberische Erpressung und räuberischer Angriff auf Kraftfahrer §§ 249-252, 255, 316a StGB;5116000;Mönchengladbach;M;160;0;0;0;1;2;3;7;22;29;34;66;13;20;33;25;23;11;2;0;94
210000;Raub, räuberische Erpressung und räuberischer Angriff auf Kraftfahrer §§ 249-252, 255, 316a StGB;5116000;Mönchengladbach;W;19;0;0;0;0;3;3;3;1;4;2;9;2;1;3;4;2;0;1;0;10
210000;Raub, räuberische Erpressung und räuberischer Angriff auf Kraftfahrer §§ 249-252, 255, 316a StGB;5116000;Mönchengladbach;X;179;0;0;0;1;5;6;10;23;33;36;75;15;21;36;29;25;11;3;0;104
210000;Raub, räuberische Erpressung und räuberischer Angriff auf Kraftfahrer §§ 249-252, 255, 316a StGB;5117000;Mülheim an der Ruhr;M;70;0;0;0;0;2;2;7;15;22;13;37;6;5;11;6;10;4;1;1;33
210000;Raub, räuberische Erpressung und räuberischer Angriff auf Kraftfahrer §§ 249-252, 255, 316a StGB;5117000;Mülheim an der Ruhr;W;7;0;0;0;0;0;0;1;1;2;0;2;1;2;3;1;0;0;1;0;5
210000;Raub, räuberische Erpressung und räuberischer Angriff auf Kraftfahrer §§ 249-252, 255, 316a StGB;5117000;Mülheim an der Ruhr;X;77;0;0;0;0;2;2;8;16;24;13;39;7;7;14;7;10;4;2;1;38
210000;Raub, räuberische Erpressung und räuberischer Angriff auf Kraftfahrer §§ 249-252, 255, 316a StGB;9162000;München;M;402;0;0;0;1;12;13;25;69;94;72;179;38;32;70;45;57;28;17;6;223
210000;Raub, räuberische Erpressung und räuberischer Angriff auf Kraftfahrer §§ 249-252, 255, 316a StGB;9162000;München;W;51;0;0;0;0;2;2;4;4;8;9;19;1;5;6;2;13;8;2;1;32
210000;Raub, räuberische Erpressung und räuberischer Angriff auf Kraftfahrer §§ 249-252, 255, 316a StGB;9162000;München;X;453;0;0;0;1;14;15;29;73;102;81;198;39;37;76;47;70;36;19;7;255
210000;Raub, räuberische Erpressung und räuberischer Angriff auf Kraftfahrer §§ 249-252, 255, 316a StGB;5515000;Münster;M;137;0;0;0;2;9;11;11;19;30;24;65;14;8;22;19;13;15;3;0;72
210000;Raub, räuberische Erpressung und räuberischer Angriff auf Kraftfahrer §§ 249-252, 255, 316a StGB;5515000;Münster;W;5;0;0;0;0;0;0;1;0;1;1;2;0;0;0;2;0;1;0;0;3
210000;Raub, räuberische Erpressung und räuberischer Angriff auf Kraftfahrer §§ 249-252, 255, 316a StGB;5515000;Münster;X;142;0;0;0;2;9;11;12;19;31;25;67;14;8;22;21;13;16;3;0;75
210000;Raub, räuberische Erpressung und räuberischer Angriff auf Kraftfahrer §§ 249-252, 255, 316a StGB;5162024;Neuss;M;57;0;0;0;0;0;0;3;11;14;14;28;0;5;5;6;12;6;0;0;29
210000;Raub, räuberische Erpressung und räuberischer Angriff auf Kraftfahrer §§ 249-252, 255, 316a StGB;5162024;Neuss;W;6;0;0;0;0;0;0;1;0;1;1;2;0;0;0;1;2;0;0;1;4
210000;Raub, räuberische Erpressung und räuberischer Angriff auf Kraftfahrer §§ 249-252, 255, 316a StGB;5162024;Neuss;X;63;0;0;0;0;0;0;4;11;15;15;30;0;5;5;7;14;6;0;1;33
210000;Raub, räuberische Erpressung und räuberischer Angriff auf Kraftfahrer §§ 249-252, 255, 316a StGB;9564000;Nürnberg;M;230;0;0;0;0;1;1;9;16;25;43;69;23;24;47;41;49;14;5;5;161
210000;Raub, räuberische Erpressung und räuberischer Angriff auf Kraftfahrer §§ 249-252, 255, 316a StGB;9564000;Nürnberg;W;29;0;0;0;0;1;1;4;3;7;5;13;2;0;2;4;7;2;0;1;16
210000;Raub, räuberische Erpressung und räuberischer Angriff auf Kraftfahrer §§ 249-252, 255, 316a StGB;9564000;Nürnberg;X;259;0;0;0;0;2;2;13;19;32;48;82;25;24;49;45;56;16;5;6;177
210000;Raub, räuberische Erpressung und räuberischer Angriff auf Kraftfahrer §§ 249-252, 255, 316a StGB;5119000;Oberhausen;M;114;0;0;0;0;3;3;9;15;24;29;56;7;9;16;12;17;8;5;0;58
210000;Raub, räuberische Erpressung und räuberischer Angriff auf Kraftfahrer §§ 249-252, 255, 316a StGB;5119000;Oberhausen;W;10;0;0;0;0;1;1;2;1;3;1;5;0;1;1;2;2;0;0;0;5
210000;Raub, räuberische Erpressung und räuberischer Angriff auf Kraftfahrer §§ 249-252, 255, 316a StGB;5119000;Oberhausen;X;124;0;0;0;0;4;4;11;16;27;30;61;7;10;17;14;19;8;5;0;63
210000;Raub, räuberische Erpressung und räuberischer Angriff auf Kraftfahrer §§ 249-252, 255, 316a StGB;6413000;Offenbach am Main;M;112;0;0;0;0;6;6;13;24;37;22;65;9;5;14;8;14;7;3;1;47
210000;Raub, räuberische Erpressung und räuberischer Angriff auf Kraftfahrer §§ 249-252, 255, 316a StGB;6413000;Offenbach am Main;W;6;0;0;0;0;0;0;0;1;1;0;1;0;0;0;1;3;1;0;0;5
210000;Raub, räuberische Erpressung und räuberischer Angriff auf Kraftfahrer §§ 249-252, 255, 316a StGB;6413000;Offenbach am Main;X;118;0;0;0;0;6;6;13;25;38;22;66;9;5;14;9;17;8;3;1;52
210000;Raub, räuberische Erpressung und räuberischer Angriff auf Kraftfahrer §§ 249-252, 255, 316a StGB;3403000;Oldenburg (Oldenburg);M;80;0;0;0;0;3;3;2;11;13;18;34;6;7;13;14;9;4;6;0;46
210000;Raub, räuberische Erpressung und räuberischer Angriff auf Kraftfahrer §§ 249-252, 255, 316a StGB;3403000;Oldenburg (Oldenburg);W;6;0;0;0;0;0;0;0;0;0;1;1;0;1;1;0;3;1;0;0;5
210000;Raub, räuberische Erpressung und räuberischer Angriff auf Kraftfahrer §§ 249-252, 255, 316a StGB;3403000;Oldenburg (Oldenburg);X;86;0;0;0;0;3;3;2;11;13;19;35;6;8;14;14;12;5;6;0;51
210000;Raub, räuberische Erpressung und räuberischer Angriff auf Kraftfahrer §§ 249-252, 255, 316a StGB;3404000;Osnabrück;M;130;0;0;0;0;0;0;9;10;19;28;47;12;8;20;22;20;8;11;2;83
210000;Raub, räuberische Erpressung und räuberischer Angriff auf Kraftfahrer §§ 249-252, 255, 316a StGB;3404000;Osnabrück;W;21;0;0;0;0;1;1;3;4;7;1;9;0;0;0;2;5;5;0;0;12
210000;Raub, räuberische Erpressung und räuberischer Angriff auf Kraftfahrer §§ 249-252, 255, 316a StGB;3404000;Osnabrück;X;151;0;0;0;0;1;1;12;14;26;29;56;12;8;20;24;25;13;11;2;95
210000;Raub, räuberische Erpressung und räuberischer Angriff auf Kraftfahrer §§ 249-252, 255, 316a StGB;5774032;Paderborn;M;79;0;0;0;0;3;3;2;13;15;13;31;10;4;14;16;11;3;4;0;48
210000;Raub, räuberische Erpressung und räuberischer Angriff auf Kraftfahrer §§ 249-252, 255, 316a StGB;5774032;Paderborn;W;2;0;0;0;0;0;0;0;1;1;0;1;0;0;0;1;0;0;0;0;1
210000;Raub, räuberische Erpressung und räuberischer Angriff auf Kraftfahrer §§ 249-252, 255, 316a StGB;5774032;Paderborn;X;81;0;0;0;0;3;3;2;14;16;13;32;10;4;14;17;11;3;4;0;49
210000;Raub, räuberische Erpressung und räuberischer Angriff auf Kraftfahrer §§ 249-252, 255, 316a StGB;8231000;Pforzheim;M;51;0;0;0;0;1;1;4;8;12;10;23;5;2;7;4;13;2;1;1;28
210000;Raub, räuberische Erpressung und räuberischer Angriff auf Kraftfahrer §§ 249-252, 255, 316a StGB;8231000;Pforzheim;W;5;0;0;0;0;0;0;0;2;2;0;2;1;0;1;1;0;1;0;0;3
210000;Raub, räuberische Erpressung und räuberischer Angriff auf Kraftfahrer §§ 249-252, 255, 316a StGB;8231000;Pforzheim;X;56;0;0;0;0;1;1;4;10;14;10;25;6;2;8;5;13;3;1;1;31
210000;Raub, räuberische Erpressung und räuberischer Angriff auf Kraftfahrer §§ 249-252, 255, 316a StGB;12054000;Potsdam;M;59;0;0;0;0;3;3;12;10;22;13;38;4;5;9;2;6;3;1;0;21
210000;Raub, räuberische Erpressung und räuberischer Angriff auf Kraftfahrer §§ 249-252, 255, 316a StGB;12054000;Potsdam;W;5;0;0;0;0;0;0;1;1;2;0;2;0;2;2;0;1;0;0;0;3
210000;Raub, räuberische Erpressung und räuberischer Angriff auf Kraftfahrer §§ 249-252, 255, 316a StGB;12054000;Potsdam;X;64;0;0;0;0;3;3;13;11;24;13;40;4;7;11;2;7;3;1;0;24
210000;Raub, räuberische Erpressung und räuberischer Angriff auf Kraftfahrer §§ 249-252, 255, 316a StGB;5562032;Recklinghausen;M;90;0;0;0;0;1;1;14;18;32;27;60;5;7;12;5;6;6;1;0;30
210000;Raub, räuberische Erpressung und räuberischer Angriff auf Kraftfahrer §§ 249-252, 255, 316a StGB;5562032;Recklinghausen;W;7;0;0;0;1;0;1;1;3;4;0;5;0;1;1;0;0;1;0;0;2
210000;Raub, räuberische Erpressung und räuberischer Angriff auf Kraftfahrer §§ 249-252, 255, 316a StGB;5562032;Recklinghausen;X;97;0;0;0;1;1;2;15;21;36;27;65;5;8;13;5;6;7;1;0;32
210000;Raub, räuberische Erpressung und räuberischer Angriff auf Kraftfahrer §§ 249-252, 255, 316a StGB;9362000;Regensburg;M;49;0;0;0;0;1;1;1;4;5;2;8;6;4;10;7;16;7;1;0;41
210000;Raub, räuberische Erpressung und räuberischer Angriff auf Kraftfahrer §§ 249-252, 255, 316a StGB;9362000;Regensburg;W;8;0;0;0;0;0;0;0;1;1;1;2;1;0;1;1;3;0;1;0;6
210000;Raub, räuberische Erpressung und räuberischer Angriff auf Kraftfahrer §§ 249-252, 255, 316a StGB;9362000;Regensburg;X;57;0;0;0;0;1;1;1;5;6;3;10;7;4;11;8;19;7;2;0;47
210000;Raub, räuberische Erpressung und räuberischer Angriff auf Kraftfahrer §§ 249-252, 255, 316a StGB;5120000;Remscheid;M;34;0;0;0;0;0;0;1;6;7;2;9;2;4;6;6;4;3;4;2;25
210000;Raub, räuberische Erpressung und räuberischer Angriff auf Kraftfahrer §§ 249-252, 255, 316a StGB;5120000;Remscheid;W;4;0;0;0;0;0;0;0;1;1;1;2;0;0;0;0;1;1;0;0;2
210000;Raub, räuberische Erpressung und räuberischer Angriff auf Kraftfahrer §§ 249-252, 255, 316a StGB;5120000;Remscheid;X;38;0;0;0;0;0;0;1;7;8;3;11;2;4;6;6;5;4;4;2;27
210000;Raub, räuberische Erpressung und räuberischer Angriff auf Kraftfahrer §§ 249-252, 255, 316a StGB;8415061;Reutlingen;M;32;0;0;0;0;0;0;0;5;5;6;11;7;2;9;4;5;2;0;1;21
210000;Raub, räuberische Erpressung und räuberischer Angriff auf Kraftfahrer §§ 249-252, 255, 316a StGB;8415061;Reutlingen;W;2;0;0;0;0;0;0;0;1;1;1;2;0;0;0;0;0;0;0;0;0
210000;Raub, räuberische Erpressung und räuberischer Angriff auf Kraftfahrer §§ 249-252, 255, 316a StGB;8415061;Reutlingen;X;34;0;0;0;0;0;0;0;6;6;7;13;7;2;9;4;5;2;0;1;21
210000;Raub, räuberische Erpressung und räuberischer Angriff auf Kraftfahrer §§ 249-252, 255, 316a StGB;13003000;Rostock;M;127;0;0;1;4;2;7;6;13;19;8;34;5;14;19;22;48;3;0;1;93
210000;Raub, räuberische Erpressung und räuberischer Angriff auf Kraftfahrer §§ 249-252, 255, 316a StGB;13003000;Rostock;W;16;0;0;0;0;2;2;2;2;4;1;7;0;1;1;3;4;0;0;1;9
210000;Raub, räuberische Erpressung und räuberischer Angriff auf Kraftfahrer §§ 249-252, 255, 316a StGB;13003000;Rostock;X;143;0;0;1;4;4;9;8;15;23;9;41;5;15;20;25;52;3;0;2;102
210000;Raub, räuberische Erpressung und räuberischer Angriff auf Kraftfahrer §§ 249-252, 255, 316a StGB;10041100;Saarbrücken;M;164;0;0;0;0;2;2;16;32;48;24;74;10;11;21;28;27;10;3;1;90
210000;Raub, räuberische Erpressung und räuberischer Angriff auf Kraftfahrer §§ 249-252, 255, 316a StGB;10041100;Saarbrücken;W;34;0;0;0;0;1;1;1;1;2;3;6;4;8;12;3;8;2;2;1;28
210000;Raub, räuberische Erpressung und räuberischer Angriff auf Kraftfahrer §§ 249-252, 255, 316a StGB;10041100;Saarbrücken;X;198;0;0;0;0;3;3;17;33;50;27;80;14;19;33;31;35;12;5;2;118
210000;Raub, räuberische Erpressung und räuberischer Angriff auf Kraftfahrer §§ 249-252, 255, 316a StGB;5122000;Solingen;M;68;0;0;0;0;1;1;7;16;23;6;30;10;4;14;9;8;3;3;1;38
210000;Raub, räuberische Erpressung und räuberischer Angriff auf Kraftfahrer §§ 249-252, 255, 316a StGB;5122000;Solingen;W;10;0;0;0;0;0;0;0;2;2;1;3;0;2;2;0;4;1;0;0;7
210000;Raub, räuberische Erpressung und räuberischer Angriff auf Kraftfahrer §§ 249-252, 255, 316a StGB;5122000;Solingen;X;78;0;0;0;0;1;1;7;18;25;7;33;10;6;16;9;12;4;3;1;45
210000;Raub, räuberische Erpressung und räuberischer Angriff auf Kraftfahrer §§ 249-252, 255, 316a StGB;8111000;Stuttgart;M;286;0;0;0;1;4;5;6;42;48;44;97;22;21;43;44;58;27;12;5;189
210000;Raub, räuberische Erpressung und räuberischer Angriff auf Kraftfahrer §§ 249-252, 255, 316a StGB;8111000;Stuttgart;W;44;0;0;0;1;0;1;7;8;15;3;19;2;0;2;5;9;7;1;1;25
210000;Raub, räuberische Erpressung und räuberischer Angriff auf Kraftfahrer §§ 249-252, 255, 316a StGB;8111000;Stuttgart;X;330;0;0;0;2;4;6;13;50;63;47;116;24;21;45;49;67;34;13;6;214
210000;Raub, räuberische Erpressung und räuberischer Angriff auf Kraftfahrer §§ 249-252, 255, 316a StGB;7211000;Trier;M;58;0;0;0;0;0;0;3;12;15;12;27;6;2;8;10;5;5;3;0;31
210000;Raub, räuberische Erpressung und räuberischer Angriff auf Kraftfahrer §§ 249-252, 255, 316a StGB;7211000;Trier;W;10;0;0;0;0;1;1;3;1;4;0;5;0;1;1;1;1;0;2;0;5
210000;Raub, räuberische Erpressung und räuberischer Angriff auf Kraftfahrer §§ 249-252, 255, 316a StGB;7211000;Trier;X;68;0;0;0;0;1;1;6;13;19;12;32;6;3;9;11;6;5;5;0;36
210000;Raub, räuberische Erpressung und räuberischer Angriff auf Kraftfahrer §§ 249-252, 255, 316a StGB;8421000;Ulm;M;76;0;0;0;2;1;3;3;14;17;12;32;10;6;16;11;13;1;3;0;44
210000;Raub, räuberische Erpressung und räuberischer Angriff auf Kraftfahrer §§ 249-252, 255, 316a StGB;8421000;Ulm;W;19;0;0;0;0;2;2;2;2;4;4;10;1;1;2;1;4;0;2;0;9
210000;Raub, räuberische Erpressung und räuberischer Angriff auf Kraftfahrer §§ 249-252, 255, 316a StGB;8421000;Ulm;X;95;0;0;0;2;3;5;5;16;21;16;42;11;7;18;12;17;1;5;0;53
210000;Raub, räuberische Erpressung und räuberischer Angriff auf Kraftfahrer §§ 249-252, 255, 316a StGB;6414000;Wiesbaden;M;169;0;0;0;0;2;2;20;26;46;42;90;9;7;16;23;24;11;4;1;79
210000;Raub, räuberische Erpressung und räuberischer Angriff auf Kraftfahrer §§ 249-252, 255, 316a StGB;6414000;Wiesbaden;W;11;0;0;0;1;0;1;0;3;3;3;7;1;1;2;1;0;0;1;0;4
210000;Raub, räuberische Erpressung und räuberischer Angriff auf Kraftfahrer §§ 249-252, 255, 316a StGB;6414000;Wiesbaden;X;180;0;0;0;1;2;3;20;29;49;45;97;10;8;18;24;24;11;5;1;83
210000;Raub, räuberische Erpressung und räuberischer Angriff auf Kraftfahrer §§ 249-252, 255, 316a StGB;3103000;Wolfsburg;M;69;0;0;0;0;0;0;6;11;17;9;26;3;5;8;8;17;7;3;0;43
210000;Raub, räuberische Erpressung und räuberischer Angriff auf Kraftfahrer §§ 249-252, 255, 316a StGB;3103000;Wolfsburg;W;3;0;0;0;0;0;0;0;1;1;0;1;0;1;1;0;1;0;0;0;2
210000;Raub, räuberische Erpressung und räuberischer Angriff auf Kraftfahrer §§ 249-252, 255, 316a StGB;3103000;Wolfsburg;X;72;0;0;0;0;0;0;6;12;18;9;27;3;6;9;8;18;7;3;0;45
210000;Raub, räuberische Erpressung und räuberischer Angriff auf Kraftfahrer §§ 249-252, 255, 316a StGB;5124000;Wuppertal;M;168;0;1;2;2;1;6;13;20;33;27;66;10;14;24;15;43;14;6;0;102
210000;Raub, räuberische Erpressung und räuberischer Angriff auf Kraftfahrer §§ 249-252, 255, 316a StGB;5124000;Wuppertal;W;26;0;0;0;0;1;1;3;4;7;2;10;1;1;2;2;8;4;0;0;16
210000;Raub, räuberische Erpressung und räuberischer Angriff auf Kraftfahrer §§ 249-252, 255, 316a StGB;5124000;Wuppertal;X;194;0;1;2;2;2;7;16;24;40;29;76;11;15;26;17;51;18;6;0;118
210000;Raub, räuberische Erpressung und räuberischer Angriff auf Kraftfahrer §§ 249-252, 255, 316a StGB;9663000;Würzburg;M;36;0;0;0;0;0;0;0;4;4;7;11;2;2;4;8;5;2;5;1;25
210000;Raub, räuberische Erpressung und räuberischer Angriff auf Kraftfahrer §§ 249-252, 255, 316a StGB;9663000;Würzburg;W;2;0;0;0;0;0;0;0;1;1;0;1;0;0;0;1;0;0;0;0;1
210000;Raub, räuberische Erpressung und räuberischer Angriff auf Kraftfahrer §§ 249-252, 255, 316a StGB;9663000;Würzburg;X;38;0;0;0;0;0;0;0;5;5;7;12;2;2;4;9;5;2;5;1;26
211000;Raub, räuberische Erpressung auf/gegen Geldinstitute, Postfilialen und -agenturen;5334002;Aachen;M;0;0;0;0;0;0;0;0;0;0;0;0;0;0;0;0;0;0;0;0;0
211000;Raub, räuberische Erpressung auf/gegen Geldinstitute, Postfilialen und -agenturen;5334002;Aachen;W;0;0;0;0;0;0;0;0;0;0;0;0;0;0;0;0;0;0;0;0;0
211000;Raub, räuberische Erpressung auf/gegen Geldinstitute, Postfilialen und -agenturen;5334002;Aachen;X;0;0;0;0;0;0;0;0;0;0;0;0;0;0;0;0;0;0;0;0;0
211000;Raub, räuberische Erpressung auf/gegen Geldinstitute, Postfilialen und -agenturen;9761000;Augsburg;M;0;0;0;0;0;0;0;0;0;0;0;0;0;0;0;0;0;0;0;0;0
211000;Raub, räuberische Erpressung auf/gegen Geldinstitute, Postfilialen und -agenturen;9761000;Augsburg;W;0;0;0;0;0;0;0;0;0;0;0;0;0;0;0;0;0;0;0;0;0
211000;Raub, räuberische Erpressung auf/gegen Geldinstitute, Postfilialen und -agenturen;9761000;Augsburg;X;0;0;0;0;0;0;0;0;0;0;0;0;0;0;0;0;0;0;0;0;0
211000;Raub, räuberische Erpressung auf/gegen Geldinstitute, Postfilialen und -agenturen;5378004;Bergisch Gladbach;M;0;0;0;0;0;0;0;0;0;0;0;0;0;0;0;0;0;0;0;0;0
211000;Raub, räuberische Erpressung auf/gegen Geldinstitute, Postfilialen und -agenturen;5378004;Bergisch Gladbach;W;0;0;0;0;0;0;0;0;0;0;0;0;0;0;0;0;0;0;0;0;0
211000;Raub, räuberische Erpressung auf/gegen Geldinstitute, Postfilialen und -agenturen;5378004;Bergisch Gladbach;X;0;0;0;0;0;0;0;0;0;0;0;0;0;0;0;0;0;0;0;0;0
211000;Raub, räuberische Erpressung auf/gegen Geldinstitute, Postfilialen und -agenturen;11000000;Berlin;M;4;0;0;0;0;0;0;0;0;0;0;0;0;0;0;0;1;2;1;0;4
211000;Raub, räuberische Erpressung auf/gegen Geldinstitute, Postfilialen und -agenturen;11000000;Berlin;W;0;0;0;0;0;0;0;0;0;0;0;0;0;0;0;0;0;0;0;0;0
211000;Raub, räuberische Erpressung auf/gegen Geldinstitute, Postfilialen und -agenturen;11000000;Berlin;X;4;0;0;0;0;0;0;0;0;0;0;0;0;0;0;0;1;2;1;0;4
211000;Raub, räuberische Erpressung auf/gegen Geldinstitute, Postfilialen und -agenturen;5711000;Bielefeld;M;1;0;0;0;0;0;0;0;0;0;0;0;0;0;0;1;0;0;0;0;1
211000;Raub, räuberische Erpressung auf/gegen Geldinstitute, Postfilialen und -agenturen;5711000;Bielefeld;W;0;0;0;0;0;0;0;0;0;0;0;0;0;0;0;0;0;0;0;0;0
211000;Raub, räuberische Erpressung auf/gegen Geldinstitute, Postfilialen und -agenturen;5711000;Bielefeld;X;1;0;0;0;0;0;0;0;0;0;0;0;0;0;0;1;0;0;0;0;1
211000;Raub, räuberische Erpressung auf/gegen Geldinstitute, Postfilialen und -agenturen;5911000;Bochum;M;1;0;0;0;0;0;0;0;0;0;0;0;0;0;0;0;0;1;0;0;1
211000;Raub, räuberische Erpressung auf/gegen Geldinstitute, Postfilialen und -agenturen;5911000;Bochum;W;0;0;0;0;0;0;0;0;0;0;0;0;0;0;0;0;0;0;0;0;0
211000;Raub, räuberische Erpressung auf/gegen Geldinstitute, Postfilialen und -agenturen;5911000;Bochum;X;1;0;0;0;0;0;0;0;0;0;0;0;0;0;0;0;0;1;0;0;1
211000;Raub, räuberische Erpressung auf/gegen Geldinstitute, Postfilialen und -agenturen;5314000;Bonn;M;2;0;0;0;0;0;0;0;0;0;1;1;1;0;1;0;0;0;0;0;1
211000;Raub, räuberische Erpressung auf/gegen Geldinstitute, Postfilialen und -agenturen;5314000;Bonn;W;0;0;0;0;0;0;0;0;0;0;0;0;0;0;0;0;0;0;0;0;0
211000;Raub, räuberische Erpressung auf/gegen Geldinstitute, Postfilialen und -agenturen;5314000;Bonn;X;2;0;0;0;0;0;0;0;0;0;1;1;1;0;1;0;0;0;0;0;1
211000;Raub, räuberische Erpressung auf/gegen Geldinstitute, Postfilialen und -agenturen;5512000;Bottrop;M;1;0;0;0;0;0;0;0;0;0;0;0;0;0;0;1;0;0;0;0;1
211000;Raub, räuberische Erpressung auf/gegen Geldinstitute, Postfilialen und -agenturen;5512000;Bottrop;W;0;0;0;0;0;0;0;0;0;0;0;0;0;0;0;0;0;0;0;0;0
211000;Raub, räuberische Erpressung auf/gegen Geldinstitute, Postfilialen und -agenturen;5512000;Bottrop;X;1;0;0;0;0;0;0;0;0;0;0;0;0;0;0;1;0;0;0;0;1
211000;Raub, räuberische Erpressung auf/gegen Geldinstitute, Postfilialen und -agenturen;3101000;Braunschweig;M;2;0;0;0;0;0;0;0;0;0;0;0;0;0;0;1;0;0;1;0;2
211000;Raub, räuberische Erpressung auf/gegen Geldinstitute, Postfilialen und -agenturen;3101000;Braunschweig;W;0;0;0;0;0;0;0;0;0;0;0;0;0;0;0;0;0;0;0;0;0
211000;Raub, räuberische Erpressung auf/gegen Geldinstitute, Postfilialen und -agenturen;3101000;Braunschweig;X;2;0;0;0;0;0;0;0;0;0;0;0;0;0;0;1;0;0;1;0;2
211000;Raub, räuberische Erpressung auf/gegen Geldinstitute, Postfilialen und -agenturen;4011000;Bremen;M;3;0;0;0;0;0;0;0;0;0;0;0;0;0;0;0;2;1;0;0;3
211000;Raub, räuberische Erpressung auf/gegen Geldinstitute, Postfilialen und -agenturen;4011000;Bremen;W;0;0;0;0;0;0;0;0;0;0;0;0;0;0;0;0;0;0;0;0;0
211000;Raub, räuberische Erpressung auf/gegen Geldinstitute, Postfilialen und -agenturen;4011000;Bremen;X;3;0;0;0;0;0;0;0;0;0;0;0;0;0;0;0;2;1;0;0;3
211000;Raub, räuberische Erpressung auf/gegen Geldinstitute, Postfilialen und -agenturen;4012000;Bremerhaven;M;0;0;0;0;0;0;0;0;0;0;0;0;0;0;0;0;0;0;0;0;0
211000;Raub, räuberische Erpressung auf/gegen Geldinstitute, Postfilialen und -agenturen;4012000;Bremerhaven;W;0;0;0;0;0;0;0;0;0;0;0;0;0;0;0;0;0;0;0;0;0
211000;Raub, räuberische Erpressung auf/gegen Geldinstitute, Postfilialen und -agenturen;4012000;Bremerhaven;X;0;0;0;0;0;0;0;0;0;0;0;0;0;0;0;0;0;0;0;0;0
211000;Raub, räuberische Erpressung auf/gegen Geldinstitute, Postfilialen und -agenturen;14511000;Chemnitz;M;0;0;0;0;0;0;0;0;0;0;0;0;0;0;0;0;0;0;0;0;0
211000;Raub, räuberische Erpressung auf/gegen Geldinstitute, Postfilialen und -agenturen;14511000;Chemnitz;W;0;0;0;0;0;0;0;0;0;0;0;0;0;0;0;0;0;0;0;0;0
211000;Raub, räuberische Erpressung auf/gegen Geldinstitute, Postfilialen und -agenturen;14511000;Chemnitz;X;0;0;0;0;0;0;0;0;0;0;0;0;0;0;0;0;0;0;0;0;0
211000;Raub, räuberische Erpressung auf/gegen Geldinstitute, Postfilialen und -agenturen;6411000;Darmstadt;M;0;0;0;0;0;0;0;0;0;0;0;0;0;0;0;0;0;0;0;0;0
211000;Raub, räuberische Erpressung auf/gegen Geldinstitute, Postfilialen und -agenturen;6411000;Darmstadt;W;0;0;0;0;0;0;0;0;0;0;0;0;0;0;0;0;0;0;0;0;0
211000;Raub, räuberische Erpressung auf/gegen Geldinstitute, Postfilialen und -agenturen;6411000;Darmstadt;X;0;0;0;0;0;0;0;0;0;0;0;0;0;0;0;0;0;0;0;0;0
211000;Raub, räuberische Erpressung auf/gegen Geldinstitute, Postfilialen und -agenturen;5913000;Dortmund;M;1;0;0;0;0;0;0;0;0;0;0;0;0;0;0;0;0;1;0;0;1
211000;Raub, räuberische Erpressung auf/gegen Geldinstitute, Postfilialen und -agenturen;5913000;Dortmund;W;0;0;0;0;0;0;0;0;0;0;0;0;0;0;0;0;0;0;0;0;0
211000;Raub, räuberische Erpressung auf/gegen Geldinstitute, Postfilialen und -agenturen;5913000;Dortmund;X;1;0;0;0;0;0;0;0;0;0;0;0;0;0;0;0;0;1;0;0;1
211000;Raub, räuberische Erpressung auf/gegen Geldinstitute, Postfilialen und -agenturen;14612000;Dresden;M;0;0;0;0;0;0;0;0;0;0;0;0;0;0;0;0;0;0;0;0;0
211000;Raub, räuberische Erpressung auf/gegen Geldinstitute, Postfilialen und -agenturen;14612000;Dresden;W;0;0;0;0;0;0;0;0;0;0;0;0;0;0;0;0;0;0;0;0;0
211000;Raub, räuberische Erpressung auf/gegen Geldinstitute, Postfilialen und -agenturen;14612000;Dresden;X;0;0;0;0;0;0;0;0;0;0;0;0;0;0;0;0;0;0;0;0;0
211000;Raub, räuberische Erpressung auf/gegen Geldinstitute, Postfilialen und -agenturen;5112000;Duisburg;M;1;0;0;0;0;0;0;0;0;0;0;0;0;0;0;0;0;0;1;0;1
211000;Raub, räuberische Erpressung auf/gegen Geldinstitute, Postfilialen und -agenturen;5112000;Duisburg;W;0;0;0;0;0;0;0;0;0;0;0;0;0;0;0;0;0;0;0;0;0
211000;Raub, räuberische Erpressung auf/gegen Geldinstitute, Postfilialen und -agenturen;5112000;Duisburg;X;1;0;0;0;0;0;0;0;0;0;0;0;0;0;0;0;0;0;1;0;1
211000;Raub, räuberische Erpressung auf/gegen Geldinstitute, Postfilialen und -agenturen;5111000;Düsseldorf;M;2;0;0;0;0;0;0;0;0;0;0;0;0;0;0;0;1;1;0;0;2
211000;Raub, räuberische Erpressung auf/gegen Geldinstitute, Postfilialen und -agenturen;5111000;Düsseldorf;W;0;0;0;0;0;0;0;0;0;0;0;0;0;0;0;0;0;0;0;0;0
211000;Raub, räuberische Erpressung auf/gegen Geldinstitute, Postfilialen und -agenturen;5111000;Düsseldorf;X;2;0;0;0;0;0;0;0;0;0;0;0;0;0;0;0;1;1;0;0;2
211000;Raub, räuberische Erpressung auf/gegen Geldinstitute, Postfilialen und -agenturen;16051000;Erfurt;M;0;0;0;0;0;0;0;0;0;0;0;0;0;0;0;0;0;0;0;0;0
211000;Raub, räuberische Erpressung auf/gegen Geldinstitute, Postfilialen und -agenturen;16051000;Erfurt;W;0;0;0;0;0;0;0;0;0;0;0;0;0;0;0;0;0;0;0;0;0
211000;Raub, räuberische Erpressung auf/gegen Geldinstitute, Postfilialen und -agenturen;16051000;Erfurt;X;0;0;0;0;0;0;0;0;0;0;0;0;0;0;0;0;0;0;0;0;0
211000;Raub, räuberische Erpressung auf/gegen Geldinstitute, Postfilialen und -agenturen;9562000;Erlangen;M;0;0;0;0;0;0;0;0;0;0;0;0;0;0;0;0;0;0;0;0;0
211000;Raub, räuberische Erpressung auf/gegen Geldinstitute, Postfilialen und -agenturen;9562000;Erlangen;W;0;0;0;0;0;0;0;0;0;0;0;0;0;0;0;0;0;0;0;0;0
211000;Raub, räuberische Erpressung auf/gegen Geldinstitute, Postfilialen und -agenturen;9562000;Erlangen;X;0;0;0;0;0;0;0;0;0;0;0;0;0;0;0;0;0;0;0;0;0
211000;Raub, räuberische Erpressung auf/gegen Geldinstitute, Postfilialen und -agenturen;5113000;Essen;M;0;0;0;0;0;0;0;0;0;0;0;0;0;0;0;0;0;0;0;0;0
211000;Raub, räuberische Erpressung auf/gegen Geldinstitute, Postfilialen und -agenturen;5113000;Essen;W;0;0;0;0;0;0;0;0;0;0;0;0;0;0;0;0;0;0;0;0;0
211000;Raub, räuberische Erpressung auf/gegen Geldinstitute, Postfilialen und -agenturen;5113000;Essen;X;0;0;0;0;0;0;0;0;0;0;0;0;0;0;0;0;0;0;0;0;0
211000;Raub, räuberische Erpressung auf/gegen Geldinstitute, Postfilialen und -agenturen;6412000;Frankfurt am Main;M;4;0;0;0;0;0;0;0;0;0;0;0;0;0;0;1;1;1;0;1;4
211000;Raub, räuberische Erpressung auf/gegen Geldinstitute, Postfilialen und -agenturen;6412000;Frankfurt am Main;W;0;0;0;0;0;0;0;0;0;0;0;0;0;0;0;0;0;0;0;0;0
211000;Raub, räuberische Erpressung auf/gegen Geldinstitute, Postfilialen und -agenturen;6412000;Frankfurt am Main;X;4;0;0;0;0;0;0;0;0;0;0;0;0;0;0;1;1;1;0;1;4
211000;Raub, räuberische Erpressung auf/gegen Geldinstitute, Postfilialen und -agenturen;8311000;Freiburg im Breisgau;M;1;0;0;0;0;0;0;0;0;0;0;0;0;0;0;0;0;1;0;0;1
211000;Raub, räuberische Erpressung auf/gegen Geldinstitute, Postfilialen und -agenturen;8311000;Freiburg im Breisgau;W;0;0;0;0;0;0;0;0;0;0;0;0;0;0;0;0;0;0;0;0;0
211000;Raub, räuberische Erpressung auf/gegen Geldinstitute, Postfilialen und -agenturen;8311000;Freiburg im Breisgau;X;1;0;0;0;0;0;0;0;0;0;0;0;0;0;0;0;0;1;0;0;1
211000;Raub, räuberische Erpressung auf/gegen Geldinstitute, Postfilialen und -agenturen;9563000;Fürth;M;0;0;0;0;0;0;0;0;0;0;0;0;0;0;0;0;0;0;0;0;0
211000;Raub, räuberische Erpressung auf/gegen Geldinstitute, Postfilialen und -agenturen;9563000;Fürth;W;0;0;0;0;0;0;0;0;0;0;0;0;0;0;0;0;0;0;0;0;0
211000;Raub, räuberische Erpressung auf/gegen Geldinstitute, Postfilialen und -agenturen;9563000;Fürth;X;0;0;0;0;0;0;0;0;0;0;0;0;0;0;0;0;0;0;0;0;0
211000;Raub, räuberische Erpressung auf/gegen Geldinstitute, Postfilialen und -agenturen;5513000;Gelsenkirchen;M;0;0;0;0;0;0;0;0;0;0;0;0;0;0;0;0;0;0;0;0;0
211000;Raub, räuberische Erpressung auf/gegen Geldinstitute, Postfilialen und -agenturen;5513000;Gelsenkirchen;W;0;0;0;0;0;0;0;0;0;0;0;0;0;0;0;0;0;0;0;0;0
211000;Raub, räuberische Erpressung auf/gegen Geldinstitute, Postfilialen und -agenturen;5513000;Gelsenkirchen;X;0;0;0;0;0;0;0;0;0;0;0;0;0;0;0;0;0;0;0;0;0
211000;Raub, räuberische Erpressung auf/gegen Geldinstitute, Postfilialen und -agenturen;3152012;Göttingen;M;0;0;0;0;0;0;0;0;0;0;0;0;0;0;0;0;0;0;0;0;0
211000;Raub, räuberische Erpressung auf/gegen Geldinstitute, Postfilialen und -agenturen;3152012;Göttingen;W;0;0;0;0;0;0;0;0;0;0;0;0;0;0;0;0;0;0;0;0;0
211000;Raub, räuberische Erpressung auf/gegen Geldinstitute, Postfilialen und -agenturen;3152012;Göttingen;X;0;0;0;0;0;0;0;0;0;0;0;0;0;0;0;0;0;0;0;0;0
211000;Raub, räuberische Erpressung auf/gegen Geldinstitute, Postfilialen und -agenturen;5914000;Hagen;M;0;0;0;0;0;0;0;0;0;0;0;0;0;0;0;0;0;0;0;0;0
211000;Raub, räuberische Erpressung auf/gegen Geldinstitute, Postfilialen und -agenturen;5914000;Hagen;W;0;0;0;0;0;0;0;0;0;0;0;0;0;0;0;0;0;0;0;0;0
211000;Raub, räuberische Erpressung auf/gegen Geldinstitute, Postfilialen und -agenturen;5914000;Hagen;X;0;0;0;0;0;0;0;0;0;0;0;0;0;0;0;0;0;0;0;0;0
211000;Raub, räuberische Erpressung auf/gegen Geldinstitute, Postfilialen und -agenturen;15002000;Halle (Saale);M;1;0;0;0;0;0;0;0;0;0;0;0;0;0;0;0;1;0;0;0;1
211000;Raub, räuberische Erpressung auf/gegen Geldinstitute, Postfilialen und -agenturen;15002000;Halle (Saale);W;0;0;0;0;0;0;0;0;0;0;0;0;0;0;0;0;0;0;0;0;0
211000;Raub, räuberische Erpressung auf/gegen Geldinstitute, Postfilialen und -agenturen;15002000;Halle (Saale);X;1;0;0;0;0;0;0;0;0;0;0;0;0;0;0;0;1;0;0;0;1
211000;Raub, räuberische Erpressung auf/gegen Geldinstitute, Postfilialen und -agenturen;2000000;Hamburg;M;4;0;0;0;0;0;0;0;0;0;2;2;0;1;1;0;1;0;0;0;2
211000;Raub, räuberische Erpressung auf/gegen Geldinstitute, Postfilialen und -agenturen;2000000;Hamburg;W;0;0;0;0;0;0;0;0;0;0;0;0;0;0;0;0;0;0;0;0;0
211000;Raub, räuberische Erpressung auf/gegen Geldinstitute, Postfilialen und -agenturen;2000000;Hamburg;X;4;0;0;0;0;0;0;0;0;0;2;2;0;1;1;0;1;0;0;0;2
211000;Raub, räuberische Erpressung auf/gegen Geldinstitute, Postfilialen und -agenturen;5915000;Hamm;M;1;0;0;0;0;0;0;0;0;0;0;0;0;1;1;0;0;0;0;0;1
211000;Raub, räuberische Erpressung auf/gegen Geldinstitute, Postfilialen und -agenturen;5915000;Hamm;W;0;0;0;0;0;0;0;0;0;0;0;0;0;0;0;0;0;0;0;0;0
211000;Raub, räuberische Erpressung auf/gegen Geldinstitute, Postfilialen und -agenturen;5915000;Hamm;X;1;0;0;0;0;0;0;0;0;0;0;0;0;1;1;0;0;0;0;0;1
211000;Raub, räuberische Erpressung auf/gegen Geldinstitute, Postfilialen und -agenturen;3241001;Hannover;M;0;0;0;0;0;0;0;0;0;0;0;0;0;0;0;0;0;0;0;0;0
211000;Raub, räuberische Erpressung auf/gegen Geldinstitute, Postfilialen und -agenturen;3241001;Hannover;W;0;0;0;0;0;0;0;0;0;0;0;0;0;0;0;0;0;0;0;0;0
211000;Raub, räuberische Erpressung auf/gegen Geldinstitute, Postfilialen und -agenturen;3241001;Hannover;X;0;0;0;0;0;0;0;0;0;0;0;0;0;0;0;0;0;0;0;0;0
211000;Raub, räuberische Erpressung auf/gegen Geldinstitute, Postfilialen und -agenturen;8221000;Heidelberg;M;0;0;0;0;0;0;0;0;0;0;0;0;0;0;0;0;0;0;0;0;0
211000;Raub, räuberische Erpressung auf/gegen Geldinstitute, Postfilialen und -agenturen;8221000;Heidelberg;W;0;0;0;0;0;0;0;0;0;0;0;0;0;0;0;0;0;0;0;0;0
211000;Raub, räuberische Erpressung auf/gegen Geldinstitute, Postfilialen und -agenturen;8221000;Heidelberg;X;0;0;0;0;0;0;0;0;0;0;0;0;0;0;0;0;0;0;0;0;0
211000;Raub, räuberische Erpressung auf/gegen Geldinstitute, Postfilialen und -agenturen;8121000;Heilbronn;M;0;0;0;0;0;0;0;0;0;0;0;0;0;0;0;0;0;0;0;0;0
211000;Raub, räuberische Erpressung auf/gegen Geldinstitute, Postfilialen und -agenturen;8121000;Heilbronn;W;0;0;0;0;0;0;0;0;0;0;0;0;0;0;0;0;0;0;0;0;0
211000;Raub, räuberische Erpressung auf/gegen Geldinstitute, Postfilialen und -agenturen;8121000;Heilbronn;X;0;0;0;0;0;0;0;0;0;0;0;0;0;0;0;0;0;0;0;0;0
211000;Raub, räuberische Erpressung auf/gegen Geldinstitute, Postfilialen und -agenturen;5916000;Herne;M;0;0;0;0;0;0;0;0;0;0;0;0;0;0;0;0;0;0;0;0;0
211000;Raub, räuberische Erpressung auf/gegen Geldinstitute, Postfilialen und -agenturen;5916000;Herne;W;0;0;0;0;0;0;0;0;0;0;0;0;0;0;0;0;0;0;0;0;0
211000;Raub, räuberische Erpressung auf/gegen Geldinstitute, Postfilialen und -agenturen;5916000;Herne;X;0;0;0;0;0;0;0;0;0;0;0;0;0;0;0;0;0;0;0;0;0
211000;Raub, räuberische Erpressung auf/gegen Geldinstitute, Postfilialen und -agenturen;9161000;Ingolstadt;M;3;0;0;0;0;0;0;0;0;0;1;1;0;0;0;0;0;2;0;0;2
211000;Raub, räuberische Erpressung auf/gegen Geldinstitute, Postfilialen und -agenturen;9161000;Ingolstadt;W;0;0;0;0;0;0;0;0;0;0;0;0;0;0;0;0;0;0;0;0;0
211000;Raub, räuberische Erpressung auf/gegen Geldinstitute, Postfilialen und -agenturen;9161000;Ingolstadt;X;3;0;0;0;0;0;0;0;0;0;1;1;0;0;0;0;0;2;0;0;2
211000;Raub, räuberische Erpressung auf/gegen Geldinstitute, Postfilialen und -agenturen;16053000;Jena;M;0;0;0;0;0;0;0;0;0;0;0;0;0;0;0;0;0;0;0;0;0
211000;Raub, räuberische Erpressung auf/gegen Geldinstitute, Postfilialen und -agenturen;16053000;Jena;W;0;0;0;0;0;0;0;0;0;0;0;0;0;0;0;0;0;0;0;0;0
211000;Raub, räuberische Erpressung auf/gegen Geldinstitute, Postfilialen und -agenturen;16053000;Jena;X;0;0;0;0;0;0;0;0;0;0;0;0;0;0;0;0;0;0;0;0;0
211000;Raub, räuberische Erpressung auf/gegen Geldinstitute, Postfilialen und -agenturen;8212000;Karlsruhe;M;0;0;0;0;0;0;0;0;0;0;0;0;0;0;0;0;0;0;0;0;0
211000;Raub, räuberische Erpressung auf/gegen Geldinstitute, Postfilialen und -agenturen;8212000;Karlsruhe;W;0;0;0;0;0;0;0;0;0;0;0;0;0;0;0;0;0;0;0;0;0
211000;Raub, räuberische Erpressung auf/gegen Geldinstitute, Postfilialen und -agenturen;8212000;Karlsruhe;X;0;0;0;0;0;0;0;0;0;0;0;0;0;0;0;0;0;0;0;0;0
211000;Raub, räuberische Erpressung auf/gegen Geldinstitute, Postfilialen und -agenturen;6611000;Kassel;M;0;0;0;0;0;0;0;0;0;0;0;0;0;0;0;0;0;0;0;0;0
211000;Raub, räuberische Erpressung auf/gegen Geldinstitute, Postfilialen und -agenturen;6611000;Kassel;W;0;0;0;0;0;0;0;0;0;0;0;0;0;0;0;0;0;0;0;0;0
211000;Raub, räuberische Erpressung auf/gegen Geldinstitute, Postfilialen und -agenturen;6611000;Kassel;X;0;0;0;0;0;0;0;0;0;0;0;0;0;0;0;0;0;0;0;0;0
211000;Raub, räuberische Erpressung auf/gegen Geldinstitute, Postfilialen und -agenturen;1002000;Kiel;M;1;0;0;0;0;0;0;0;0;0;0;0;0;1;1;0;0;0;0;0;1
211000;Raub, räuberische Erpressung auf/gegen Geldinstitute, Postfilialen und -agenturen;1002000;Kiel;W;0;0;0;0;0;0;0;0;0;0;0;0;0;0;0;0;0;0;0;0;0
211000;Raub, räuberische Erpressung auf/gegen Geldinstitute, Postfilialen und -agenturen;1002000;Kiel;X;1;0;0;0;0;0;0;0;0;0;0;0;0;1;1;0;0;0;0;0;1
211000;Raub, räuberische Erpressung auf/gegen Geldinstitute, Postfilialen und -agenturen;7111000;Koblenz;M;1;0;0;0;0;0;0;0;0;0;0;0;0;0;0;0;1;0;0;0;1
211000;Raub, räuberische Erpressung auf/gegen Geldinstitute, Postfilialen und -agenturen;7111000;Koblenz;W;0;0;0;0;0;0;0;0;0;0;0;0;0;0;0;0;0;0;0;0;0
211000;Raub, räuberische Erpressung auf/gegen Geldinstitute, Postfilialen und -agenturen;7111000;Koblenz;X;1;0;0;0;0;0;0;0;0;0;0;0;0;0;0;0;1;0;0;0;1
211000;Raub, räuberische Erpressung auf/gegen Geldinstitute, Postfilialen und -agenturen;5315000;Köln;M;2;0;0;0;0;0;0;0;0;0;0;0;0;1;1;0;0;1;0;0;2
211000;Raub, räuberische Erpressung auf/gegen Geldinstitute, Postfilialen und -agenturen;5315000;Köln;W;0;0;0;0;0;0;0;0;0;0;0;0;0;0;0;0;0;0;0;0;0
211000;Raub, räuberische Erpressung auf/gegen Geldinstitute, Postfilialen und -agenturen;5315000;Köln;X;2;0;0;0;0;0;0;0;0;0;0;0;0;1;1;0;0;1;0;0;2
211000;Raub, räuberische Erpressung auf/gegen Geldinstitute, Postfilialen und -agenturen;5114000;Krefeld;M;1;0;0;0;0;0;0;0;0;0;0;0;0;0;0;0;0;1;0;0;1
211000;Raub, räuberische Erpressung auf/gegen Geldinstitute, Postfilialen und -agenturen;5114000;Krefeld;W;0;0;0;0;0;0;0;0;0;0;0;0;0;0;0;0;0;0;0;0;0
211000;Raub, räuberische Erpressung auf/gegen Geldinstitute, Postfilialen und -agenturen;5114000;Krefeld;X;1;0;0;0;0;0;0;0;0;0;0;0;0;0;0;0;0;1;0;0;1
211000;Raub, räuberische Erpressung auf/gegen Geldinstitute, Postfilialen und -agenturen;14713000;Leipzig;M;6;0;0;0;0;0;0;1;2;3;1;4;0;0;0;1;1;0;0;0;2
211000;Raub, räuberische Erpressung auf/gegen Geldinstitute, Postfilialen und -agenturen;14713000;Leipzig;W;0;0;0;0;0;0;0;0;0;0;0;0;0;0;0;0;0;0;0;0;0
211000;Raub, räuberische Erpressung auf/gegen Geldinstitute, Postfilialen und -agenturen;14713000;Leipzig;X;6;0;0;0;0;0;0;1;2;3;1;4;0;0;0;1;1;0;0;0;2
211000;Raub, räuberische Erpressung auf/gegen Geldinstitute, Postfilialen und -agenturen;5316000;Leverkusen;M;0;0;0;0;0;0;0;0;0;0;0;0;0;0;0;0;0;0;0;0;0
211000;Raub, räuberische Erpressung auf/gegen Geldinstitute, Postfilialen und -agenturen;5316000;Leverkusen;W;0;0;0;0;0;0;0;0;0;0;0;0;0;0;0;0;0;0;0;0;0
211000;Raub, räuberische Erpressung auf/gegen Geldinstitute, Postfilialen und -agenturen;5316000;Leverkusen;X;0;0;0;0;0;0;0;0;0;0;0;0;0;0;0;0;0;0;0;0;0
211000;Raub, räuberische Erpressung auf/gegen Geldinstitute, Postfilialen und -agenturen;1003000;Lübeck;M;0;0;0;0;0;0;0;0;0;0;0;0;0;0;0;0;0;0;0;0;0
211000;Raub, räuberische Erpressung auf/gegen Geldinstitute, Postfilialen und -agenturen;1003000;Lübeck;W;0;0;0;0;0;0;0;0;0;0;0;0;0;0;0;0;0;0;0;0;0
211000;Raub, räuberische Erpressung auf/gegen Geldinstitute, Postfilialen und -agenturen;1003000;Lübeck;X;0;0;0;0;0;0;0;0;0;0;0;0;0;0;0;0;0;0;0;0;0
211000;Raub, räuberische Erpressung auf/gegen Geldinstitute, Postfilialen und -agenturen;7314000;Ludwigshafen am Rhein;M;0;0;0;0;0;0;0;0;0;0;0;0;0;0;0;0;0;0;0;0;0
211000;Raub, räuberische Erpressung auf/gegen Geldinstitute, Postfilialen und -agenturen;7314000;Ludwigshafen am Rhein;W;0;0;0;0;0;0;0;0;0;0;0;0;0;0;0;0;0;0;0;0;0
211000;Raub, räuberische Erpressung auf/gegen Geldinstitute, Postfilialen und -agenturen;7314000;Ludwigshafen am Rhein;X;0;0;0;0;0;0;0;0;0;0;0;0;0;0;0;0;0;0;0;0;0
211000;Raub, räuberische Erpressung auf/gegen Geldinstitute, Postfilialen und -agenturen;15003000;Magdeburg;M;1;0;0;0;0;0;0;0;0;0;1;1;0;0;0;0;0;0;0;0;0
211000;Raub, räuberische Erpressung auf/gegen Geldinstitute, Postfilialen und -agenturen;15003000;Magdeburg;W;0;0;0;0;0;0;0;0;0;0;0;0;0;0;0;0;0;0;0;0;0
211000;Raub, räuberische Erpressung auf/gegen Geldinstitute, Postfilialen und -agenturen;15003000;Magdeburg;X;1;0;0;0;0;0;0;0;0;0;1;1;0;0;0;0;0;0;0;0;0
211000;Raub, räuberische Erpressung auf/gegen Geldinstitute, Postfilialen und -agenturen;7315000;Mainz;M;1;0;0;0;0;0;0;0;1;1;0;1;0;0;0;0;0;0;0;0;0
211000;Raub, räuberische Erpressung auf/gegen Geldinstitute, Postfilialen und -agenturen;7315000;Mainz;W;0;0;0;0;0;0;0;0;0;0;0;0;0;0;0;0;0;0;0;0;0
211000;Raub, räuberische Erpressung auf/gegen Geldinstitute, Postfilialen und -agenturen;7315000;Mainz;X;1;0;0;0;0;0;0;0;1;1;0;1;0;0;0;0;0;0;0;0;0
211000;Raub, räuberische Erpressung auf/gegen Geldinstitute, Postfilialen und -agenturen;8222000;Mannheim;M;0;0;0;0;0;0;0;0;0;0;0;0;0;0;0;0;0;0;0;0;0
211000;Raub, räuberische Erpressung auf/gegen Geldinstitute, Postfilialen und -agenturen;8222000;Mannheim;W;0;0;0;0;0;0;0;0;0;0;0;0;0;0;0;0;0;0;0;0;0
211000;Raub, räuberische Erpressung auf/gegen Geldinstitute, Postfilialen und -agenturen;8222000;Mannheim;X;0;0;0;0;0;0;0;0;0;0;0;0;0;0;0;0;0;0;0;0;0
211000;Raub, räuberische Erpressung auf/gegen Geldinstitute, Postfilialen und -agenturen;5170024;Moers;M;0;0;0;0;0;0;0;0;0;0;0;0;0;0;0;0;0;0;0;0;0
211000;Raub, räuberische Erpressung auf/gegen Geldinstitute, Postfilialen und -agenturen;5170024;Moers;W;0;0;0;0;0;0;0;0;0;0;0;0;0;0;0;0;0;0;0;0;0
211000;Raub, räuberische Erpressung auf/gegen Geldinstitute, Postfilialen und -agenturen;5170024;Moers;X;0;0;0;0;0;0;0;0;0;0;0;0;0;0;0;0;0;0;0;0;0
211000;Raub, räuberische Erpressung auf/gegen Geldinstitute, Postfilialen und -agenturen;5116000;Mönchengladbach;M;0;0;0;0;0;0;0;0;0;0;0;0;0;0;0;0;0;0;0;0;0
211000;Raub, räuberische Erpressung auf/gegen Geldinstitute, Postfilialen und -agenturen;5116000;Mönchengladbach;W;0;0;0;0;0;0;0;0;0;0;0;0;0;0;0;0;0;0;0;0;0
211000;Raub, räuberische Erpressung auf/gegen Geldinstitute, Postfilialen und -agenturen;5116000;Mönchengladbach;X;0;0;0;0;0;0;0;0;0;0;0;0;0;0;0;0;0;0;0;0;0
211000;Raub, räuberische Erpressung auf/gegen Geldinstitute, Postfilialen und -agenturen;5117000;Mülheim an der Ruhr;M;0;0;0;0;0;0;0;0;0;0;0;0;0;0;0;0;0;0;0;0;0
211000;Raub, räuberische Erpressung auf/gegen Geldinstitute, Postfilialen und -agenturen;5117000;Mülheim an der Ruhr;W;0;0;0;0;0;0;0;0;0;0;0;0;0;0;0;0;0;0;0;0;0
211000;Raub, räuberische Erpressung auf/gegen Geldinstitute, Postfilialen und -agenturen;5117000;Mülheim an der Ruhr;X;0;0;0;0;0;0;0;0;0;0;0;0;0;0;0;0;0;0;0;0;0
211000;Raub, räuberische Erpressung auf/gegen Geldinstitute, Postfilialen und -agenturen;9162000;München;M;1;0;0;0;0;0;0;0;0;0;1;1;0;0;0;0;0;0;0;0;0
211000;Raub, räuberische Erpressung auf/gegen Geldinstitute, Postfilialen und -agenturen;9162000;München;W;0;0;0;0;0;0;0;0;0;0;0;0;0;0;0;0;0;0;0;0;0
211000;Raub, räuberische Erpressung auf/gegen Geldinstitute, Postfilialen und -agenturen;9162000;München;X;1;0;0;0;0;0;0;0;0;0;1;1;0;0;0;0;0;0;0;0;0
211000;Raub, räuberische Erpressung auf/gegen Geldinstitute, Postfilialen und -agenturen;5515000;Münster;M;1;0;0;0;0;0;0;0;0;0;0;0;0;0;0;0;1;0;0;0;1
211000;Raub, räuberische Erpressung auf/gegen Geldinstitute, Postfilialen und -agenturen;5515000;Münster;W;0;0;0;0;0;0;0;0;0;0;0;0;0;0;0;0;0;0;0;0;0
211000;Raub, räuberische Erpressung auf/gegen Geldinstitute, Postfilialen und -agenturen;5515000;Münster;X;1;0;0;0;0;0;0;0;0;0;0;0;0;0;0;0;1;0;0;0;1
211000;Raub, räuberische Erpressung auf/gegen Geldinstitute, Postfilialen und -agenturen;5162024;Neuss;M;1;0;0;0;0;0;0;0;0;0;0;0;0;0;0;0;1;0;0;0;1
211000;Raub, räuberische Erpressung auf/gegen Geldinstitute, Postfilialen und -agenturen;5162024;Neuss;W;0;0;0;0;0;0;0;0;0;0;0;0;0;0;0;0;0;0;0;0;0
211000;Raub, räuberische Erpressung auf/gegen Geldinstitute, Postfilialen und -agenturen;5162024;Neuss;X;1;0;0;0;0;0;0;0;0;0;0;0;0;0;0;0;1;0;0;0;1
211000;Raub, räuberische Erpressung auf/gegen Geldinstitute, Postfilialen und -agenturen;9564000;Nürnberg;M;2;0;0;0;0;0;0;0;0;0;1;1;0;0;0;0;1;0;0;0;1
211000;Raub, räuberische Erpressung auf/gegen Geldinstitute, Postfilialen und -agenturen;9564000;Nürnberg;W;0;0;0;0;0;0;0;0;0;0;0;0;0;0;0;0;0;0;0;0;0
211000;Raub, räuberische Erpressung auf/gegen Geldinstitute, Postfilialen und -agenturen;9564000;Nürnberg;X;2;0;0;0;0;0;0;0;0;0;1;1;0;0;0;0;1;0;0;0;1
211000;Raub, räuberische Erpressung auf/gegen Geldinstitute, Postfilialen und -agenturen;5119000;Oberhausen;M;0;0;0;0;0;0;0;0;0;0;0;0;0;0;0;0;0;0;0;0;0
211000;Raub, räuberische Erpressung auf/gegen Geldinstitute, Postfilialen und -agenturen;5119000;Oberhausen;W;0;0;0;0;0;0;0;0;0;0;0;0;0;0;0;0;0;0;0;0;0
211000;Raub, räuberische Erpressung auf/gegen Geldinstitute, Postfilialen und -agenturen;5119000;Oberhausen;X;0;0;0;0;0;0;0;0;0;0;0;0;0;0;0;0;0;0;0;0;0
211000;Raub, räuberische Erpressung auf/gegen Geldinstitute, Postfilialen und -agenturen;6413000;Offenbach am Main;M;0;0;0;0;0;0;0;0;0;0;0;0;0;0;0;0;0;0;0;0;0
211000;Raub, räuberische Erpressung auf/gegen Geldinstitute, Postfilialen und -agenturen;6413000;Offenbach am Main;W;0;0;0;0;0;0;0;0;0;0;0;0;0;0;0;0;0;0;0;0;0
211000;Raub, räuberische Erpressung auf/gegen Geldinstitute, Postfilialen und -agenturen;6413000;Offenbach am Main;X;0;0;0;0;0;0;0;0;0;0;0;0;0;0;0;0;0;0;0;0;0
211000;Raub, räuberische Erpressung auf/gegen Geldinstitute, Postfilialen und -agenturen;3403000;Oldenburg (Oldenburg);M;1;0;0;0;0;0;0;0;0;0;0;0;0;0;0;1;0;0;0;0;1
211000;Raub, räuberische Erpressung auf/gegen Geldinstitute, Postfilialen und -agenturen;3403000;Oldenburg (Oldenburg);W;0;0;0;0;0;0;0;0;0;0;0;0;0;0;0;0;0;0;0;0;0
211000;Raub, räuberische Erpressung auf/gegen Geldinstitute, Postfilialen und -agenturen;3403000;Oldenburg (Oldenburg);X;1;0;0;0;0;0;0;0;0;0;0;0;0;0;0;1;0;0;0;0;1
211000;Raub, räuberische Erpressung auf/gegen Geldinstitute, Postfilialen und -agenturen;3404000;Osnabrück;M;0;0;0;0;0;0;0;0;0;0;0;0;0;0;0;0;0;0;0;0;0
211000;Raub, räuberische Erpressung auf/gegen Geldinstitute, Postfilialen und -agenturen;3404000;Osnabrück;W;0;0;0;0;0;0;0;0;0;0;0;0;0;0;0;0;0;0;0;0;0
211000;Raub, räuberische Erpressung auf/gegen Geldinstitute, Postfilialen und -agenturen;3404000;Osnabrück;X;0;0;0;0;0;0;0;0;0;0;0;0;0;0;0;0;0;0;0;0;0
211000;Raub, räuberische Erpressung auf/gegen Geldinstitute, Postfilialen und -agenturen;5774032;Paderborn;M;0;0;0;0;0;0;0;0;0;0;0;0;0;0;0;0;0;0;0;0;0
211000;Raub, räuberische Erpressung auf/gegen Geldinstitute, Postfilialen und -agenturen;5774032;Paderborn;W;0;0;0;0;0;0;0;0;0;0;0;0;0;0;0;0;0;0;0;0;0
211000;Raub, räuberische Erpressung auf/gegen Geldinstitute, Postfilialen und -agenturen;5774032;Paderborn;X;0;0;0;0;0;0;0;0;0;0;0;0;0;0;0;0;0;0;0;0;0
211000;Raub, räuberische Erpressung auf/gegen Geldinstitute, Postfilialen und -agenturen;8231000;Pforzheim;M;0;0;0;0;0;0;0;0;0;0;0;0;0;0;0;0;0;0;0;0;0
211000;Raub, räuberische Erpressung auf/gegen Geldinstitute, Postfilialen und -agenturen;8231000;Pforzheim;W;0;0;0;0;0;0;0;0;0;0;0;0;0;0;0;0;0;0;0;0;0
211000;Raub, räuberische Erpressung auf/gegen Geldinstitute, Postfilialen und -agenturen;8231000;Pforzheim;X;0;0;0;0;0;0;0;0;0;0;0;0;0;0;0;0;0;0;0;0;0
211000;Raub, räuberische Erpressung auf/gegen Geldinstitute, Postfilialen und -agenturen;12054000;Potsdam;M;0;0;0;0;0;0;0;0;0;0;0;0;0;0;0;0;0;0;0;0;0
211000;Raub, räuberische Erpressung auf/gegen Geldinstitute, Postfilialen und -agenturen;12054000;Potsdam;W;0;0;0;0;0;0;0;0;0;0;0;0;0;0;0;0;0;0;0;0;0
211000;Raub, räuberische Erpressung auf/gegen Geldinstitute, Postfilialen und -agenturen;12054000;Potsdam;X;0;0;0;0;0;0;0;0;0;0;0;0;0;0;0;0;0;0;0;0;0
211000;Raub, räuberische Erpressung auf/gegen Geldinstitute, Postfilialen und -agenturen;5562032;Recklinghausen;M;0;0;0;0;0;0;0;0;0;0;0;0;0;0;0;0;0;0;0;0;0
211000;Raub, räuberische Erpressung auf/gegen Geldinstitute, Postfilialen und -agenturen;5562032;Recklinghausen;W;0;0;0;0;0;0;0;0;0;0;0;0;0;0;0;0;0;0;0;0;0
211000;Raub, räuberische Erpressung auf/gegen Geldinstitute, Postfilialen und -agenturen;5562032;Recklinghausen;X;0;0;0;0;0;0;0;0;0;0;0;0;0;0;0;0;0;0;0;0;0
211000;Raub, räuberische Erpressung auf/gegen Geldinstitute, Postfilialen und -agenturen;9362000;Regensburg;M;0;0;0;0;0;0;0;0;0;0;0;0;0;0;0;0;0;0;0;0;0
211000;Raub, räuberische Erpressung auf/gegen Geldinstitute, Postfilialen und -agenturen;9362000;Regensburg;W;0;0;0;0;0;0;0;0;0;0;0;0;0;0;0;0;0;0;0;0;0
211000;Raub, räuberische Erpressung auf/gegen Geldinstitute, Postfilialen und -agenturen;9362000;Regensburg;X;0;0;0;0;0;0;0;0;0;0;0;0;0;0;0;0;0;0;0;0;0
211000;Raub, räuberische Erpressung auf/gegen Geldinstitute, Postfilialen und -agenturen;5120000;Remscheid;M;0;0;0;0;0;0;0;0;0;0;0;0;0;0;0;0;0;0;0;0;0
211000;Raub, räuberische Erpressung auf/gegen Geldinstitute, Postfilialen und -agenturen;5120000;Remscheid;W;0;0;0;0;0;0;0;0;0;0;0;0;0;0;0;0;0;0;0;0;0
211000;Raub, räuberische Erpressung auf/gegen Geldinstitute, Postfilialen und -agenturen;5120000;Remscheid;X;0;0;0;0;0;0;0;0;0;0;0;0;0;0;0;0;0;0;0;0;0
211000;Raub, räuberische Erpressung auf/gegen Geldinstitute, Postfilialen und -agenturen;8415061;Reutlingen;M;0;0;0;0;0;0;0;0;0;0;0;0;0;0;0;0;0;0;0;0;0
211000;Raub, räuberische Erpressung auf/gegen Geldinstitute, Postfilialen und -agenturen;8415061;Reutlingen;W;0;0;0;0;0;0;0;0;0;0;0;0;0;0;0;0;0;0;0;0;0
211000;Raub, räuberische Erpressung auf/gegen Geldinstitute, Postfilialen und -agenturen;8415061;Reutlingen;X;0;0;0;0;0;0;0;0;0;0;0;0;0;0;0;0;0;0;0;0;0
211000;Raub, räuberische Erpressung auf/gegen Geldinstitute, Postfilialen und -agenturen;13003000;Rostock;M;0;0;0;0;0;0;0;0;0;0;0;0;0;0;0;0;0;0;0;0;0
211000;Raub, räuberische Erpressung auf/gegen Geldinstitute, Postfilialen und -agenturen;13003000;Rostock;W;0;0;0;0;0;0;0;0;0;0;0;0;0;0;0;0;0;0;0;0;0
211000;Raub, räuberische Erpressung auf/gegen Geldinstitute, Postfilialen und -agenturen;13003000;Rostock;X;0;0;0;0;0;0;0;0;0;0;0;0;0;0;0;0;0;0;0;0;0
211000;Raub, räuberische Erpressung auf/gegen Geldinstitute, Postfilialen und -agenturen;10041100;Saarbrücken;M;3;0;0;0;0;0;0;0;0;0;0;0;1;0;1;0;1;0;1;0;3
211000;Raub, räuberische Erpressung auf/gegen Geldinstitute, Postfilialen und -agenturen;10041100;Saarbrücken;W;0;0;0;0;0;0;0;0;0;0;0;0;0;0;0;0;0;0;0;0;0
211000;Raub, räuberische Erpressung auf/gegen Geldinstitute, Postfilialen und -agenturen;10041100;Saarbrücken;X;3;0;0;0;0;0;0;0;0;0;0;0;1;0;1;0;1;0;1;0;3
211000;Raub, räuberische Erpressung auf/gegen Geldinstitute, Postfilialen und -agenturen;5122000;Solingen;M;0;0;0;0;0;0;0;0;0;0;0;0;0;0;0;0;0;0;0;0;0
211000;Raub, räuberische Erpressung auf/gegen Geldinstitute, Postfilialen und -agenturen;5122000;Solingen;W;0;0;0;0;0;0;0;0;0;0;0;0;0;0;0;0;0;0;0;0;0
211000;Raub, räuberische Erpressung auf/gegen Geldinstitute, Postfilialen und -agenturen;5122000;Solingen;X;0;0;0;0;0;0;0;0;0;0;0;0;0;0;0;0;0;0;0;0;0
211000;Raub, räuberische Erpressung auf/gegen Geldinstitute, Postfilialen und -agenturen;8111000;Stuttgart;M;0;0;0;0;0;0;0;0;0;0;0;0;0;0;0;0;0;0;0;0;0
211000;Raub, räuberische Erpressung auf/gegen Geldinstitute, Postfilialen und -agenturen;8111000;Stuttgart;W;0;0;0;0;0;0;0;0;0;0;0;0;0;0;0;0;0;0;0;0;0
211000;Raub, räuberische Erpressung auf/gegen Geldinstitute, Postfilialen und -agenturen;8111000;Stuttgart;X;0;0;0;0;0;0;0;0;0;0;0;0;0;0;0;0;0;0;0;0;0
211000;Raub, räuberische Erpressung auf/gegen Geldinstitute, Postfilialen und -agenturen;7211000;Trier;M;0;0;0;0;0;0;0;0;0;0;0;0;0;0;0;0;0;0;0;0;0
211000;Raub, räuberische Erpressung auf/gegen Geldinstitute, Postfilialen und -agenturen;7211000;Trier;W;0;0;0;0;0;0;0;0;0;0;0;0;0;0;0;0;0;0;0;0;0
211000;Raub, räuberische Erpressung auf/gegen Geldinstitute, Postfilialen und -agenturen;7211000;Trier;X;0;0;0;0;0;0;0;0;0;0;0;0;0;0;0;0;0;0;0;0;0
211000;Raub, räuberische Erpressung auf/gegen Geldinstitute, Postfilialen und -agenturen;8421000;Ulm;M;1;0;0;0;0;0;0;0;0;0;0;0;1;0;1;0;0;0;0;0;1
211000;Raub, räuberische Erpressung auf/gegen Geldinstitute, Postfilialen und -agenturen;8421000;Ulm;W;0;0;0;0;0;0;0;0;0;0;0;0;0;0;0;0;0;0;0;0;0
211000;Raub, räuberische Erpressung auf/gegen Geldinstitute, Postfilialen und -agenturen;8421000;Ulm;X;1;0;0;0;0;0;0;0;0;0;0;0;1;0;1;0;0;0;0;0;1
211000;Raub, räuberische Erpressung auf/gegen Geldinstitute, Postfilialen und -agenturen;6414000;Wiesbaden;M;2;0;0;0;0;0;0;0;0;0;1;1;0;0;0;0;1;0;0;0;1
211000;Raub, räuberische Erpressung auf/gegen Geldinstitute, Postfilialen und -agenturen;6414000;Wiesbaden;W;0;0;0;0;0;0;0;0;0;0;0;0;0;0;0;0;0;0;0;0;0
211000;Raub, räuberische Erpressung auf/gegen Geldinstitute, Postfilialen und -agenturen;6414000;Wiesbaden;X;2;0;0;0;0;0;0;0;0;0;1;1;0;0;0;0;1;0;0;0;1
211000;Raub, räuberische Erpressung auf/gegen Geldinstitute, Postfilialen und -agenturen;3103000;Wolfsburg;M;0;0;0;0;0;0;0;0;0;0;0;0;0;0;0;0;0;0;0;0;0
211000;Raub, räuberische Erpressung auf/gegen Geldinstitute, Postfilialen und -agenturen;3103000;Wolfsburg;W;0;0;0;0;0;0;0;0;0;0;0;0;0;0;0;0;0;0;0;0;0
211000;Raub, räuberische Erpressung auf/gegen Geldinstitute, Postfilialen und -agenturen;3103000;Wolfsburg;X;0;0;0;0;0;0;0;0;0;0;0;0;0;0;0;0;0;0;0;0;0
211000;Raub, räuberische Erpressung auf/gegen Geldinstitute, Postfilialen und -agenturen;5124000;Wuppertal;M;0;0;0;0;0;0;0;0;0;0;0;0;0;0;0;0;0;0;0;0;0
211000;Raub, räuberische Erpressung auf/gegen Geldinstitute, Postfilialen und -agenturen;5124000;Wuppertal;W;0;0;0;0;0;0;0;0;0;0;0;0;0;0;0;0;0;0;0;0;0
211000;Raub, räuberische Erpressung auf/gegen Geldinstitute, Postfilialen und -agenturen;5124000;Wuppertal;X;0;0;0;0;0;0;0;0;0;0;0;0;0;0;0;0;0;0;0;0;0
211000;Raub, räuberische Erpressung auf/gegen Geldinstitute, Postfilialen und -agenturen;9663000;Würzburg;M;0;0;0;0;0;0;0;0;0;0;0;0;0;0;0;0;0;0;0;0;0
211000;Raub, räuberische Erpressung auf/gegen Geldinstitute, Postfilialen und -agenturen;9663000;Würzburg;W;0;0;0;0;0;0;0;0;0;0;0;0;0;0;0;0;0;0;0;0;0
211000;Raub, räuberische Erpressung auf/gegen Geldinstitute, Postfilialen und -agenturen;9663000;Würzburg;X;0;0;0;0;0;0;0;0;0;0;0;0;0;0;0;0;0;0;0;0;0
212000;Raub, räuberische Erpressung auf/gegen sonstige Zahlstellen und Geschäfte;5334002;Aachen;M;4;0;0;0;0;0;0;0;1;1;1;2;0;2;2;0;0;0;0;0;2
212000;Raub, räuberische Erpressung auf/gegen sonstige Zahlstellen und Geschäfte;5334002;Aachen;W;0;0;0;0;0;0;0;0;0;0;0;0;0;0;0;0;0;0;0;0;0
212000;Raub, räuberische Erpressung auf/gegen sonstige Zahlstellen und Geschäfte;5334002;Aachen;X;4;0;0;0;0;0;0;0;1;1;1;2;0;2;2;0;0;0;0;0;2
212000;Raub, räuberische Erpressung auf/gegen sonstige Zahlstellen und Geschäfte;9761000;Augsburg;M;8;0;0;0;0;0;0;0;0;0;0;0;2;0;2;2;2;0;2;0;8
212000;Raub, räuberische Erpressung auf/gegen sonstige Zahlstellen und Geschäfte;9761000;Augsburg;W;0;0;0;0;0;0;0;0;0;0;0;0;0;0;0;0;0;0;0;0;0
212000;Raub, räuberische Erpressung auf/gegen sonstige Zahlstellen und Geschäfte;9761000;Augsburg;X;8;0;0;0;0;0;0;0;0;0;0;0;2;0;2;2;2;0;2;0;8
212000;Raub, räuberische Erpressung auf/gegen sonstige Zahlstellen und Geschäfte;5378004;Bergisch Gladbach;M;4;0;0;0;0;0;0;0;0;0;0;0;1;0;1;1;0;2;0;0;4
212000;Raub, räuberische Erpressung auf/gegen sonstige Zahlstellen und Geschäfte;5378004;Bergisch Gladbach;W;0;0;0;0;0;0;0;0;0;0;0;0;0;0;0;0;0;0;0;0;0
212000;Raub, räuberische Erpressung auf/gegen sonstige Zahlstellen und Geschäfte;5378004;Bergisch Gladbach;X;4;0;0;0;0;0;0;0;0;0;0;0;1;0;1;1;0;2;0;0;4
212000;Raub, räuberische Erpressung auf/gegen sonstige Zahlstellen und Geschäfte;11000000;Berlin;M;185;0;0;0;0;0;0;7;28;35;48;83;20;19;39;27;23;7;6;0;102
212000;Raub, räuberische Erpressung auf/gegen sonstige Zahlstellen und Geschäfte;11000000;Berlin;W;4;0;0;0;0;0;0;0;0;0;1;1;1;1;2;0;1;0;0;0;3
212000;Raub, räuberische Erpressung auf/gegen sonstige Zahlstellen und Geschäfte;11000000;Berlin;X;189;0;0;0;0;0;0;7;28;35;49;84;21;20;41;27;24;7;6;0;105
212000;Raub, räuberische Erpressung auf/gegen sonstige Zahlstellen und Geschäfte;5711000;Bielefeld;M;7;0;0;0;0;0;0;0;1;1;1;2;0;2;2;1;0;0;2;0;5
212000;Raub, räuberische Erpressung auf/gegen sonstige Zahlstellen und Geschäfte;5711000;Bielefeld;W;0;0;0;0;0;0;0;0;0;0;0;0;0;0;0;0;0;0;0;0;0
212000;Raub, räuberische Erpressung auf/gegen sonstige Zahlstellen und Geschäfte;5711000;Bielefeld;X;7;0;0;0;0;0;0;0;1;1;1;2;0;2;2;1;0;0;2;0;5
212000;Raub, räuberische Erpressung auf/gegen sonstige Zahlstellen und Geschäfte;5911000;Bochum;M;8;0;0;0;0;0;0;0;1;1;1;2;1;2;3;2;0;1;0;0;6
212000;Raub, räuberische Erpressung auf/gegen sonstige Zahlstellen und Geschäfte;5911000;Bochum;W;0;0;0;0;0;0;0;0;0;0;0;0;0;0;0;0;0;0;0;0;0
212000;Raub, räuberische Erpressung auf/gegen sonstige Zahlstellen und Geschäfte;5911000;Bochum;X;8;0;0;0;0;0;0;0;1;1;1;2;1;2;3;2;0;1;0;0;6
212000;Raub, räuberische Erpressung auf/gegen sonstige Zahlstellen und Geschäfte;5314000;Bonn;M;5;0;0;0;0;0;0;0;0;0;2;2;1;1;2;1;0;0;0;0;3
212000;Raub, räuberische Erpressung auf/gegen sonstige Zahlstellen und Geschäfte;5314000;Bonn;W;0;0;0;0;0;0;0;0;0;0;0;0;0;0;0;0;0;0;0;0;0
212000;Raub, räuberische Erpressung auf/gegen sonstige Zahlstellen und Geschäfte;5314000;Bonn;X;5;0;0;0;0;0;0;0;0;0;2;2;1;1;2;1;0;0;0;0;3
212000;Raub, räuberische Erpressung auf/gegen sonstige Zahlstellen und Geschäfte;5512000;Bottrop;M;1;0;0;0;0;0;0;0;0;0;1;1;0;0;0;0;0;0;0;0;0
212000;Raub, räuberische Erpressung auf/gegen sonstige Zahlstellen und Geschäfte;5512000;Bottrop;W;0;0;0;0;0;0;0;0;0;0;0;0;0;0;0;0;0;0;0;0;0
212000;Raub, räuberische Erpressung auf/gegen sonstige Zahlstellen und Geschäfte;5512000;Bottrop;X;1;0;0;0;0;0;0;0;0;0;1;1;0;0;0;0;0;0;0;0;0
212000;Raub, räuberische Erpressung auf/gegen sonstige Zahlstellen und Geschäfte;3101000;Braunschweig;M;7;0;0;0;0;0;0;0;0;0;3;3;1;1;2;2;0;0;0;0;4
212000;Raub, räuberische Erpressung auf/gegen sonstige Zahlstellen und Geschäfte;3101000;Braunschweig;W;0;0;0;0;0;0;0;0;0;0;0;0;0;0;0;0;0;0;0;0;0
212000;Raub, räuberische Erpressung auf/gegen sonstige Zahlstellen und Geschäfte;3101000;Braunschweig;X;7;0;0;0;0;0;0;0;0;0;3;3;1;1;2;2;0;0;0;0;4
212000;Raub, räuberische Erpressung auf/gegen sonstige Zahlstellen und Geschäfte;4011000;Bremen;M;34;0;0;0;0;0;0;0;3;3;6;9;4;4;8;8;8;0;1;0;25
212000;Raub, räuberische Erpressung auf/gegen sonstige Zahlstellen und Geschäfte;4011000;Bremen;W;1;0;0;0;0;0;0;0;0;0;0;0;0;0;0;0;1;0;0;0;1
212000;Raub, räuberische Erpressung auf/gegen sonstige Zahlstellen und Geschäfte;4011000;Bremen;X;35;0;0;0;0;0;0;0;3;3;6;9;4;4;8;8;9;0;1;0;26
212000;Raub, räuberische Erpressung auf/gegen sonstige Zahlstellen und Geschäfte;4012000;Bremerhaven;M;10;0;0;0;0;0;0;0;1;1;4;5;0;1;1;1;2;1;0;0;5
212000;Raub, räuberische Erpressung auf/gegen sonstige Zahlstellen und Geschäfte;4012000;Bremerhaven;W;0;0;0;0;0;0;0;0;0;0;0;0;0;0;0;0;0;0;0;0;0
212000;Raub, räuberische Erpressung auf/gegen sonstige Zahlstellen und Geschäfte;4012000;Bremerhaven;X;10;0;0;0;0;0;0;0;1;1;4;5;0;1;1;1;2;1;0;0;5
212000;Raub, räuberische Erpressung auf/gegen sonstige Zahlstellen und Geschäfte;14511000;Chemnitz;M;1;0;0;0;0;0;0;0;0;0;0;0;0;0;0;1;0;0;0;0;1
212000;Raub, räuberische Erpressung auf/gegen sonstige Zahlstellen und Geschäfte;14511000;Chemnitz;W;0;0;0;0;0;0;0;0;0;0;0;0;0;0;0;0;0;0;0;0;0
212000;Raub, räuberische Erpressung auf/gegen sonstige Zahlstellen und Geschäfte;14511000;Chemnitz;X;1;0;0;0;0;0;0;0;0;0;0;0;0;0;0;1;0;0;0;0;1
212000;Raub, räuberische Erpressung auf/gegen sonstige Zahlstellen und Geschäfte;6411000;Darmstadt;M;4;0;0;0;0;0;0;0;0;0;1;1;1;1;2;0;0;0;1;0;3
212000;Raub, räuberische Erpressung auf/gegen sonstige Zahlstellen und Geschäfte;6411000;Darmstadt;W;0;0;0;0;0;0;0;0;0;0;0;0;0;0;0;0;0;0;0;0;0
212000;Raub, räuberische Erpressung auf/gegen sonstige Zahlstellen und Geschäfte;6411000;Darmstadt;X;4;0;0;0;0;0;0;0;0;0;1;1;1;1;2;0;0;0;1;0;3
212000;Raub, räuberische Erpressung auf/gegen sonstige Zahlstellen und Geschäfte;5913000;Dortmund;M;30;0;0;0;0;0;0;2;1;3;8;11;5;2;7;4;7;1;0;0;19
212000;Raub, räuberische Erpressung auf/gegen sonstige Zahlstellen und Geschäfte;5913000;Dortmund;W;3;0;0;0;0;0;0;0;0;0;0;0;0;0;0;1;1;0;1;0;3
212000;Raub, räuberische Erpressung auf/gegen sonstige Zahlstellen und Geschäfte;5913000;Dortmund;X;33;0;0;0;0;0;0;2;1;3;8;11;5;2;7;5;8;1;1;0;22
212000;Raub, räuberische Erpressung auf/gegen sonstige Zahlstellen und Geschäfte;14612000;Dresden;M;3;0;0;0;0;0;0;0;0;0;0;0;0;0;0;1;2;0;0;0;3
212000;Raub, räuberische Erpressung auf/gegen sonstige Zahlstellen und Geschäfte;14612000;Dresden;W;0;0;0;0;0;0;0;0;0;0;0;0;0;0;0;0;0;0;0;0;0
212000;Raub, räuberische Erpressung auf/gegen sonstige Zahlstellen und Geschäfte;14612000;Dresden;X;3;0;0;0;0;0;0;0;0;0;0;0;0;0;0;1;2;0;0;0;3
212000;Raub, räuberische Erpressung auf/gegen sonstige Zahlstellen und Geschäfte;5112000;Duisburg;M;21;0;0;0;0;0;0;2;2;4;4;8;1;1;2;2;7;1;1;0;13
212000;Raub, räuberische Erpressung auf/gegen sonstige Zahlstellen und Geschäfte;5112000;Duisburg;W;0;0;0;0;0;0;0;0;0;0;0;0;0;0;0;0;0;0;0;0;0
212000;Raub, räuberische Erpressung auf/gegen sonstige Zahlstellen und Geschäfte;5112000;Duisburg;X;21;0;0;0;0;0;0;2;2;4;4;8;1;1;2;2;7;1;1;0;13
212000;Raub, räuberische Erpressung auf/gegen sonstige Zahlstellen und Geschäfte;5111000;Düsseldorf;M;10;0;0;0;0;0;0;0;0;0;1;1;0;1;1;0;5;1;1;1;9
212000;Raub, räuberische Erpressung auf/gegen sonstige Zahlstellen und Geschäfte;5111000;Düsseldorf;W;0;0;0;0;0;0;0;0;0;0;0;0;0;0;0;0;0;0;0;0;0
212000;Raub, räuberische Erpressung auf/gegen sonstige Zahlstellen und Geschäfte;5111000;Düsseldorf;X;10;0;0;0;0;0;0;0;0;0;1;1;0;1;1;0;5;1;1;1;9
212000;Raub, räuberische Erpressung auf/gegen sonstige Zahlstellen und Geschäfte;16051000;Erfurt;M;0;0;0;0;0;0;0;0;0;0;0;0;0;0;0;0;0;0;0;0;0
212000;Raub, räuberische Erpressung auf/gegen sonstige Zahlstellen und Geschäfte;16051000;Erfurt;W;0;0;0;0;0;0;0;0;0;0;0;0;0;0;0;0;0;0;0;0;0
212000;Raub, räuberische Erpressung auf/gegen sonstige Zahlstellen und Geschäfte;16051000;Erfurt;X;0;0;0;0;0;0;0;0;0;0;0;0;0;0;0;0;0;0;0;0;0
212000;Raub, räuberische Erpressung auf/gegen sonstige Zahlstellen und Geschäfte;9562000;Erlangen;M;2;0;0;0;0;0;0;0;0;0;0;0;0;0;0;0;1;1;0;0;2
212000;Raub, räuberische Erpressung auf/gegen sonstige Zahlstellen und Geschäfte;9562000;Erlangen;W;0;0;0;0;0;0;0;0;0;0;0;0;0;0;0;0;0;0;0;0;0
212000;Raub, räuberische Erpressung auf/gegen sonstige Zahlstellen und Geschäfte;9562000;Erlangen;X;2;0;0;0;0;0;0;0;0;0;0;0;0;0;0;0;1;1;0;0;2
212000;Raub, räuberische Erpressung auf/gegen sonstige Zahlstellen und Geschäfte;5113000;Essen;M;8;0;0;0;0;0;0;0;3;3;1;4;0;2;2;0;1;1;0;0;4
212000;Raub, räuberische Erpressung auf/gegen sonstige Zahlstellen und Geschäfte;5113000;Essen;W;0;0;0;0;0;0;0;0;0;0;0;0;0;0;0;0;0;0;0;0;0
212000;Raub, räuberische Erpressung auf/gegen sonstige Zahlstellen und Geschäfte;5113000;Essen;X;8;0;0;0;0;0;0;0;3;3;1;4;0;2;2;0;1;1;0;0;4
212000;Raub, räuberische Erpressung auf/gegen sonstige Zahlstellen und Geschäfte;6412000;Frankfurt am Main;M;28;0;0;0;0;0;0;2;4;6;5;11;2;1;3;3;9;0;1;1;17
212000;Raub, räuberische Erpressung auf/gegen sonstige Zahlstellen und Geschäfte;6412000;Frankfurt am Main;W;0;0;0;0;0;0;0;0;0;0;0;0;0;0;0;0;0;0;0;0;0
212000;Raub, räuberische Erpressung auf/gegen sonstige Zahlstellen und Geschäfte;6412000;Frankfurt am Main;X;28;0;0;0;0;0;0;2;4;6;5;11;2;1;3;3;9;0;1;1;17
212000;Raub, räuberische Erpressung auf/gegen sonstige Zahlstellen und Geschäfte;8311000;Freiburg im Breisgau;M;5;0;0;0;0;0;0;0;0;0;0;0;3;0;3;0;2;0;0;0;5
212000;Raub, räuberische Erpressung auf/gegen sonstige Zahlstellen und Geschäfte;8311000;Freiburg im Breisgau;W;0;0;0;0;0;0;0;0;0;0;0;0;0;0;0;0;0;0;0;0;0
212000;Raub, räuberische Erpressung auf/gegen sonstige Zahlstellen und Geschäfte;8311000;Freiburg im Breisgau;X;5;0;0;0;0;0;0;0;0;0;0;0;3;0;3;0;2;0;0;0;5
212000;Raub, räuberische Erpressung auf/gegen sonstige Zahlstellen und Geschäfte;9563000;Fürth;M;3;0;0;0;0;0;0;0;0;0;2;2;0;0;0;1;0;0;0;0;1
212000;Raub, räuberische Erpressung auf/gegen sonstige Zahlstellen und Geschäfte;9563000;Fürth;W;0;0;0;0;0;0;0;0;0;0;0;0;0;0;0;0;0;0;0;0;0
212000;Raub, räuberische Erpressung auf/gegen sonstige Zahlstellen und Geschäfte;9563000;Fürth;X;3;0;0;0;0;0;0;0;0;0;2;2;0;0;0;1;0;0;0;0;1
212000;Raub, räuberische Erpressung auf/gegen sonstige Zahlstellen und Geschäfte;5513000;Gelsenkirchen;M;10;0;0;0;0;0;0;0;2;2;3;5;2;1;3;0;1;1;0;0;5
212000;Raub, räuberische Erpressung auf/gegen sonstige Zahlstellen und Geschäfte;5513000;Gelsenkirchen;W;0;0;0;0;0;0;0;0;0;0;0;0;0;0;0;0;0;0;0;0;0
212000;Raub, räuberische Erpressung auf/gegen sonstige Zahlstellen und Geschäfte;5513000;Gelsenkirchen;X;10;0;0;0;0;0;0;0;2;2;3;5;2;1;3;0;1;1;0;0;5
212000;Raub, räuberische Erpressung auf/gegen sonstige Zahlstellen und Geschäfte;3152012;Göttingen;M;8;0;0;0;0;0;0;0;0;0;1;1;1;2;3;2;2;0;0;0;7
212000;Raub, räuberische Erpressung auf/gegen sonstige Zahlstellen und Geschäfte;3152012;Göttingen;W;0;0;0;0;0;0;0;0;0;0;0;0;0;0;0;0;0;0;0;0;0
212000;Raub, räuberische Erpressung auf/gegen sonstige Zahlstellen und Geschäfte;3152012;Göttingen;X;8;0;0;0;0;0;0;0;0;0;1;1;1;2;3;2;2;0;0;0;7
212000;Raub, räuberische Erpressung auf/gegen sonstige Zahlstellen und Geschäfte;5914000;Hagen;M;15;0;0;0;0;0;0;2;2;4;5;9;2;1;3;1;1;0;1;0;6
212000;Raub, räuberische Erpressung auf/gegen sonstige Zahlstellen und Geschäfte;5914000;Hagen;W;3;0;0;0;0;0;0;0;0;0;0;0;2;1;3;0;0;0;0;0;3
212000;Raub, räuberische Erpressung auf/gegen sonstige Zahlstellen und Geschäfte;5914000;Hagen;X;18;0;0;0;0;0;0;2;2;4;5;9;4;2;6;1;1;0;1;0;9
212000;Raub, räuberische Erpressung auf/gegen sonstige Zahlstellen und Geschäfte;15002000;Halle (Saale);M;7;0;0;0;0;0;0;0;1;1;0;1;0;2;2;2;2;0;0;0;6
212000;Raub, räuberische Erpressung auf/gegen sonstige Zahlstellen und Geschäfte;15002000;Halle (Saale);W;0;0;0;0;0;0;0;0;0;0;0;0;0;0;0;0;0;0;0;0;0
212000;Raub, räuberische Erpressung auf/gegen sonstige Zahlstellen und Geschäfte;15002000;Halle (Saale);X;7;0;0;0;0;0;0;0;1;1;0;1;0;2;2;2;2;0;0;0;6
212000;Raub, räuberische Erpressung auf/gegen sonstige Zahlstellen und Geschäfte;2000000;Hamburg;M;69;0;0;0;0;0;0;0;4;4;18;22;9;9;18;8;16;3;2;0;47
212000;Raub, räuberische Erpressung auf/gegen sonstige Zahlstellen und Geschäfte;2000000;Hamburg;W;2;0;0;0;0;0;0;0;0;0;0;0;0;0;0;0;2;0;0;0;2
212000;Raub, räuberische Erpressung auf/gegen sonstige Zahlstellen und Geschäfte;2000000;Hamburg;X;71;0;0;0;0;0;0;0;4;4;18;22;9;9;18;8;18;3;2;0;49
212000;Raub, räuberische Erpressung auf/gegen sonstige Zahlstellen und Geschäfte;5915000;Hamm;M;10;0;0;0;0;0;0;0;2;2;4;6;0;0;0;0;2;1;1;0;4
212000;Raub, räuberische Erpressung auf/gegen sonstige Zahlstellen und Geschäfte;5915000;Hamm;W;0;0;0;0;0;0;0;0;0;0;0;0;0;0;0;0;0;0;0;0;0
212000;Raub, räuberische Erpressung auf/gegen sonstige Zahlstellen und Geschäfte;5915000;Hamm;X;10;0;0;0;0;0;0;0;2;2;4;6;0;0;0;0;2;1;1;0;4
212000;Raub, räuberische Erpressung auf/gegen sonstige Zahlstellen und Geschäfte;3241001;Hannover;M;29;0;0;0;0;0;0;1;3;4;8;12;2;2;4;4;4;3;2;0;17
212000;Raub, räuberische Erpressung auf/gegen sonstige Zahlstellen und Geschäfte;3241001;Hannover;W;0;0;0;0;0;0;0;0;0;0;0;0;0;0;0;0;0;0;0;0;0
212000;Raub, räuberische Erpressung auf/gegen sonstige Zahlstellen und Geschäfte;3241001;Hannover;X;29;0;0;0;0;0;0;1;3;4;8;12;2;2;4;4;4;3;2;0;17
212000;Raub, räuberische Erpressung auf/gegen sonstige Zahlstellen und Geschäfte;8221000;Heidelberg;M;1;0;0;0;0;0;0;0;0;0;0;0;1;0;1;0;0;0;0;0;1
212000;Raub, räuberische Erpressung auf/gegen sonstige Zahlstellen und Geschäfte;8221000;Heidelberg;W;0;0;0;0;0;0;0;0;0;0;0;0;0;0;0;0;0;0;0;0;0
212000;Raub, räuberische Erpressung auf/gegen sonstige Zahlstellen und Geschäfte;8221000;Heidelberg;X;1;0;0;0;0;0;0;0;0;0;0;0;1;0;1;0;0;0;0;0;1
212000;Raub, räuberische Erpressung auf/gegen sonstige Zahlstellen und Geschäfte;8121000;Heilbronn;M;3;0;0;0;0;0;0;0;1;1;1;2;0;1;1;0;0;0;0;0;1
212000;Raub, räuberische Erpressung auf/gegen sonstige Zahlstellen und Geschäfte;8121000;Heilbronn;W;0;0;0;0;0;0;0;0;0;0;0;0;0;0;0;0;0;0;0;0;0
212000;Raub, räuberische Erpressung auf/gegen sonstige Zahlstellen und Geschäfte;8121000;Heilbronn;X;3;0;0;0;0;0;0;0;1;1;1;2;0;1;1;0;0;0;0;0;1
212000;Raub, räuberische Erpressung auf/gegen sonstige Zahlstellen und Geschäfte;5916000;Herne;M;9;0;0;0;0;0;0;0;0;0;5;5;0;1;1;1;2;0;0;0;4
212000;Raub, räuberische Erpressung auf/gegen sonstige Zahlstellen und Geschäfte;5916000;Herne;W;1;0;0;0;0;0;0;0;0;0;1;1;0;0;0;0;0;0;0;0;0
212000;Raub, räuberische Erpressung auf/gegen sonstige Zahlstellen und Geschäfte;5916000;Herne;X;10;0;0;0;0;0;0;0;0;0;6;6;0;1;1;1;2;0;0;0;4
212000;Raub, räuberische Erpressung auf/gegen sonstige Zahlstellen und Geschäfte;9161000;Ingolstadt;M;0;0;0;0;0;0;0;0;0;0;0;0;0;0;0;0;0;0;0;0;0
212000;Raub, räuberische Erpressung auf/gegen sonstige Zahlstellen und Geschäfte;9161000;Ingolstadt;W;0;0;0;0;0;0;0;0;0;0;0;0;0;0;0;0;0;0;0;0;0
212000;Raub, räuberische Erpressung auf/gegen sonstige Zahlstellen und Geschäfte;9161000;Ingolstadt;X;0;0;0;0;0;0;0;0;0;0;0;0;0;0;0;0;0;0;0;0;0
212000;Raub, räuberische Erpressung auf/gegen sonstige Zahlstellen und Geschäfte;16053000;Jena;M;1;0;0;0;0;0;0;0;0;0;0;0;0;0;0;1;0;0;0;0;1
212000;Raub, räuberische Erpressung auf/gegen sonstige Zahlstellen und Geschäfte;16053000;Jena;W;0;0;0;0;0;0;0;0;0;0;0;0;0;0;0;0;0;0;0;0;0
212000;Raub, räuberische Erpressung auf/gegen sonstige Zahlstellen und Geschäfte;16053000;Jena;X;1;0;0;0;0;0;0;0;0;0;0;0;0;0;0;1;0;0;0;0;1
212000;Raub, räuberische Erpressung auf/gegen sonstige Zahlstellen und Geschäfte;8212000;Karlsruhe;M;4;0;0;0;0;0;0;0;0;0;2;2;1;0;1;0;0;0;1;0;2
212000;Raub, räuberische Erpressung auf/gegen sonstige Zahlstellen und Geschäfte;8212000;Karlsruhe;W;0;0;0;0;0;0;0;0;0;0;0;0;0;0;0;0;0;0;0;0;0
212000;Raub, räuberische Erpressung auf/gegen sonstige Zahlstellen und Geschäfte;8212000;Karlsruhe;X;4;0;0;0;0;0;0;0;0;0;2;2;1;0;1;0;0;0;1;0;2
212000;Raub, räuberische Erpressung auf/gegen sonstige Zahlstellen und Geschäfte;6611000;Kassel;M;5;0;0;0;0;0;0;1;0;1;1;2;0;1;1;0;0;0;2;0;3
212000;Raub, räuberische Erpressung auf/gegen sonstige Zahlstellen und Geschäfte;6611000;Kassel;W;0;0;0;0;0;0;0;0;0;0;0;0;0;0;0;0;0;0;0;0;0
212000;Raub, räuberische Erpressung auf/gegen sonstige Zahlstellen und Geschäfte;6611000;Kassel;X;5;0;0;0;0;0;0;1;0;1;1;2;0;1;1;0;0;0;2;0;3
212000;Raub, räuberische Erpressung auf/gegen sonstige Zahlstellen und Geschäfte;1002000;Kiel;M;15;0;0;0;0;0;0;0;2;2;3;5;2;5;7;2;1;0;0;0;10
212000;Raub, räuberische Erpressung auf/gegen sonstige Zahlstellen und Geschäfte;1002000;Kiel;W;1;0;0;0;0;0;0;0;0;0;0;0;0;0;0;1;0;0;0;0;1
212000;Raub, räuberische Erpressung auf/gegen sonstige Zahlstellen und Geschäfte;1002000;Kiel;X;16;0;0;0;0;0;0;0;2;2;3;5;2;5;7;3;1;0;0;0;11
212000;Raub, räuberische Erpressung auf/gegen sonstige Zahlstellen und Geschäfte;7111000;Koblenz;M;1;0;0;0;0;0;0;0;0;0;0;0;0;1;1;0;0;0;0;0;1
212000;Raub, räuberische Erpressung auf/gegen sonstige Zahlstellen und Geschäfte;7111000;Koblenz;W;0;0;0;0;0;0;0;0;0;0;0;0;0;0;0;0;0;0;0;0;0
212000;Raub, räuberische Erpressung auf/gegen sonstige Zahlstellen und Geschäfte;7111000;Koblenz;X;1;0;0;0;0;0;0;0;0;0;0;0;0;1;1;0;0;0;0;0;1
212000;Raub, räuberische Erpressung auf/gegen sonstige Zahlstellen und Geschäfte;5315000;Köln;M;52;0;0;0;0;0;0;0;9;9;14;23;8;5;13;3;9;4;0;0;29
212000;Raub, räuberische Erpressung auf/gegen sonstige Zahlstellen und Geschäfte;5315000;Köln;W;0;0;0;0;0;0;0;0;0;0;0;0;0;0;0;0;0;0;0;0;0
212000;Raub, räuberische Erpressung auf/gegen sonstige Zahlstellen und Geschäfte;5315000;Köln;X;52;0;0;0;0;0;0;0;9;9;14;23;8;5;13;3;9;4;0;0;29
212000;Raub, räuberische Erpressung auf/gegen sonstige Zahlstellen und Geschäfte;5114000;Krefeld;M;7;0;0;0;0;0;0;0;0;0;0;0;1;0;1;0;1;4;0;1;7
212000;Raub, räuberische Erpressung auf/gegen sonstige Zahlstellen und Geschäfte;5114000;Krefeld;W;2;0;0;0;0;0;0;0;0;0;0;0;0;0;0;1;1;0;0;0;2
212000;Raub, räuberische Erpressung auf/gegen sonstige Zahlstellen und Geschäfte;5114000;Krefeld;X;9;0;0;0;0;0;0;0;0;0;0;0;1;0;1;1;2;4;0;1;9
212000;Raub, räuberische Erpressung auf/gegen sonstige Zahlstellen und Geschäfte;14713000;Leipzig;M;10;0;0;0;0;0;0;0;2;2;1;3;2;1;3;1;2;0;1;0;7
212000;Raub, räuberische Erpressung auf/gegen sonstige Zahlstellen und Geschäfte;14713000;Leipzig;W;1;0;0;0;0;0;0;0;0;0;0;0;0;0;0;1;0;0;0;0;1
212000;Raub, räuberische Erpressung auf/gegen sonstige Zahlstellen und Geschäfte;14713000;Leipzig;X;11;0;0;0;0;0;0;0;2;2;1;3;2;1;3;2;2;0;1;0;8
212000;Raub, räuberische Erpressung auf/gegen sonstige Zahlstellen und Geschäfte;5316000;Leverkusen;M;3;0;0;0;0;0;0;0;1;1;0;1;1;1;2;0;0;0;0;0;2
212000;Raub, räuberische Erpressung auf/gegen sonstige Zahlstellen und Geschäfte;5316000;Leverkusen;W;0;0;0;0;0;0;0;0;0;0;0;0;0;0;0;0;0;0;0;0;0
212000;Raub, räuberische Erpressung auf/gegen sonstige Zahlstellen und Geschäfte;5316000;Leverkusen;X;3;0;0;0;0;0;0;0;1;1;0;1;1;1;2;0;0;0;0;0;2
212000;Raub, räuberische Erpressung auf/gegen sonstige Zahlstellen und Geschäfte;1003000;Lübeck;M;6;0;0;0;0;0;0;0;0;0;0;0;0;2;2;0;2;2;0;0;6
212000;Raub, räuberische Erpressung auf/gegen sonstige Zahlstellen und Geschäfte;1003000;Lübeck;W;1;0;0;0;0;0;0;0;0;0;0;0;0;0;0;0;0;1;0;0;1
212000;Raub, räuberische Erpressung auf/gegen sonstige Zahlstellen und Geschäfte;1003000;Lübeck;X;7;0;0;0;0;0;0;0;0;0;0;0;0;2;2;0;2;3;0;0;7
212000;Raub, räuberische Erpressung auf/gegen sonstige Zahlstellen und Geschäfte;7314000;Ludwigshafen am Rhein;M;4;0;0;0;0;0;0;0;0;0;2;2;0;1;1;1;0;0;0;0;2
212000;Raub, räuberische Erpressung auf/gegen sonstige Zahlstellen und Geschäfte;7314000;Ludwigshafen am Rhein;W;0;0;0;0;0;0;0;0;0;0;0;0;0;0;0;0;0;0;0;0;0
212000;Raub, räuberische Erpressung auf/gegen sonstige Zahlstellen und Geschäfte;7314000;Ludwigshafen am Rhein;X;4;0;0;0;0;0;0;0;0;0;2;2;0;1;1;1;0;0;0;0;2
212000;Raub, räuberische Erpressung auf/gegen sonstige Zahlstellen und Geschäfte;15003000;Magdeburg;M;5;0;0;0;0;0;0;1;1;2;1;3;0;0;0;1;0;0;1;0;2
212000;Raub, räuberische Erpressung auf/gegen sonstige Zahlstellen und Geschäfte;15003000;Magdeburg;W;0;0;0;0;0;0;0;0;0;0;0;0;0;0;0;0;0;0;0;0;0
212000;Raub, räuberische Erpressung auf/gegen sonstige Zahlstellen und Geschäfte;15003000;Magdeburg;X;5;0;0;0;0;0;0;1;1;2;1;3;0;0;0;1;0;0;1;0;2
212000;Raub, räuberische Erpressung auf/gegen sonstige Zahlstellen und Geschäfte;7315000;Mainz;M;9;0;0;0;0;0;0;0;2;2;6;8;0;1;1;0;0;0;0;0;1
212000;Raub, räuberische Erpressung auf/gegen sonstige Zahlstellen und Geschäfte;7315000;Mainz;W;0;0;0;0;0;0;0;0;0;0;0;0;0;0;0;0;0;0;0;0;0
212000;Raub, räuberische Erpressung auf/gegen sonstige Zahlstellen und Geschäfte;7315000;Mainz;X;9;0;0;0;0;0;0;0;2;2;6;8;0;1;1;0;0;0;0;0;1
212000;Raub, räuberische Erpressung auf/gegen sonstige Zahlstellen und Geschäfte;8222000;Mannheim;M;5;0;0;0;0;0;0;0;2;2;0;2;1;1;2;0;0;0;1;0;3
212000;Raub, räuberische Erpressung auf/gegen sonstige Zahlstellen und Geschäfte;8222000;Mannheim;W;0;0;0;0;0;0;0;0;0;0;0;0;0;0;0;0;0;0;0;0;0
212000;Raub, räuberische Erpressung auf/gegen sonstige Zahlstellen und Geschäfte;8222000;Mannheim;X;5;0;0;0;0;0;0;0;2;2;0;2;1;1;2;0;0;0;1;0;3
212000;Raub, räuberische Erpressung auf/gegen sonstige Zahlstellen und Geschäfte;5170024;Moers;M;0;0;0;0;0;0;0;0;0;0;0;0;0;0;0;0;0;0;0;0;0
212000;Raub, räuberische Erpressung auf/gegen sonstige Zahlstellen und Geschäfte;5170024;Moers;W;0;0;0;0;0;0;0;0;0;0;0;0;0;0;0;0;0;0;0;0;0
212000;Raub, räuberische Erpressung auf/gegen sonstige Zahlstellen und Geschäfte;5170024;Moers;X;0;0;0;0;0;0;0;0;0;0;0;0;0;0;0;0;0;0;0;0;0
212000;Raub, räuberische Erpressung auf/gegen sonstige Zahlstellen und Geschäfte;5116000;Mönchengladbach;M;16;0;0;0;0;0;0;0;4;4;4;8;0;2;2;1;3;2;0;0;8
212000;Raub, räuberische Erpressung auf/gegen sonstige Zahlstellen und Geschäfte;5116000;Mönchengladbach;W;0;0;0;0;0;0;0;0;0;0;0;0;0;0;0;0;0;0;0;0;0
212000;Raub, räuberische Erpressung auf/gegen sonstige Zahlstellen und Geschäfte;5116000;Mönchengladbach;X;16;0;0;0;0;0;0;0;4;4;4;8;0;2;2;1;3;2;0;0;8
212000;Raub, räuberische Erpressung auf/gegen sonstige Zahlstellen und Geschäfte;5117000;Mülheim an der Ruhr;M;6;0;0;0;0;0;0;1;5;6;0;6;0;0;0;0;0;0;0;0;0
212000;Raub, räuberische Erpressung auf/gegen sonstige Zahlstellen und Geschäfte;5117000;Mülheim an der Ruhr;W;0;0;0;0;0;0;0;0;0;0;0;0;0;0;0;0;0;0;0;0;0
212000;Raub, räuberische Erpressung auf/gegen sonstige Zahlstellen und Geschäfte;5117000;Mülheim an der Ruhr;X;6;0;0;0;0;0;0;1;5;6;0;6;0;0;0;0;0;0;0;0;0
212000;Raub, räuberische Erpressung auf/gegen sonstige Zahlstellen und Geschäfte;9162000;München;M;9;0;0;0;0;0;0;0;0;0;1;1;2;1;3;1;3;0;1;0;8
212000;Raub, räuberische Erpressung auf/gegen sonstige Zahlstellen und Geschäfte;9162000;München;W;0;0;0;0;0;0;0;0;0;0;0;0;0;0;0;0;0;0;0;0;0
212000;Raub, räuberische Erpressung auf/gegen sonstige Zahlstellen und Geschäfte;9162000;München;X;9;0;0;0;0;0;0;0;0;0;1;1;2;1;3;1;3;0;1;0;8
212000;Raub, räuberische Erpressung auf/gegen sonstige Zahlstellen und Geschäfte;5515000;Münster;M;5;0;0;0;0;0;0;0;0;0;2;2;1;0;1;2;0;0;0;0;3
212000;Raub, räuberische Erpressung auf/gegen sonstige Zahlstellen und Geschäfte;5515000;Münster;W;0;0;0;0;0;0;0;0;0;0;0;0;0;0;0;0;0;0;0;0;0
212000;Raub, räuberische Erpressung auf/gegen sonstige Zahlstellen und Geschäfte;5515000;Münster;X;5;0;0;0;0;0;0;0;0;0;2;2;1;0;1;2;0;0;0;0;3
212000;Raub, räuberische Erpressung auf/gegen sonstige Zahlstellen und Geschäfte;5162024;Neuss;M;2;0;0;0;0;0;0;0;0;0;2;2;0;0;0;0;0;0;0;0;0
212000;Raub, räuberische Erpressung auf/gegen sonstige Zahlstellen und Geschäfte;5162024;Neuss;W;0;0;0;0;0;0;0;0;0;0;0;0;0;0;0;0;0;0;0;0;0
212000;Raub, räuberische Erpressung auf/gegen sonstige Zahlstellen und Geschäfte;5162024;Neuss;X;2;0;0;0;0;0;0;0;0;0;2;2;0;0;0;0;0;0;0;0;0
212000;Raub, räuberische Erpressung auf/gegen sonstige Zahlstellen und Geschäfte;9564000;Nürnberg;M;17;0;0;0;0;0;0;0;1;1;1;2;2;2;4;6;2;0;1;2;15
212000;Raub, räuberische Erpressung auf/gegen sonstige Zahlstellen und Geschäfte;9564000;Nürnberg;W;1;0;0;0;0;0;0;0;0;0;0;0;0;0;0;1;0;0;0;0;1
212000;Raub, räuberische Erpressung auf/gegen sonstige Zahlstellen und Geschäfte;9564000;Nürnberg;X;18;0;0;0;0;0;0;0;1;1;1;2;2;2;4;7;2;0;1;2;16
212000;Raub, räuberische Erpressung auf/gegen sonstige Zahlstellen und Geschäfte;5119000;Oberhausen;M;4;0;0;0;0;0;0;0;0;0;0;0;0;1;1;0;2;0;1;0;4
212000;Raub, räuberische Erpressung auf/gegen sonstige Zahlstellen und Geschäfte;5119000;Oberhausen;W;0;0;0;0;0;0;0;0;0;0;0;0;0;0;0;0;0;0;0;0;0
212000;Raub, räuberische Erpressung auf/gegen sonstige Zahlstellen und Geschäfte;5119000;Oberhausen;X;4;0;0;0;0;0;0;0;0;0;0;0;0;1;1;0;2;0;1;0;4
212000;Raub, räuberische Erpressung auf/gegen sonstige Zahlstellen und Geschäfte;6413000;Offenbach am Main;M;1;0;0;0;0;0;0;0;0;0;0;0;0;1;1;0;0;0;0;0;1
212000;Raub, räuberische Erpressung auf/gegen sonstige Zahlstellen und Geschäfte;6413000;Offenbach am Main;W;0;0;0;0;0;0;0;0;0;0;0;0;0;0;0;0;0;0;0;0;0
212000;Raub, räuberische Erpressung auf/gegen sonstige Zahlstellen und Geschäfte;6413000;Offenbach am Main;X;1;0;0;0;0;0;0;0;0;0;0;0;0;1;1;0;0;0;0;0;1
212000;Raub, räuberische Erpressung auf/gegen sonstige Zahlstellen und Geschäfte;3403000;Oldenburg (Oldenburg);M;11;0;0;0;0;0;0;0;0;0;1;1;2;2;4;3;1;1;1;0;10
212000;Raub, räuberische Erpressung auf/gegen sonstige Zahlstellen und Geschäfte;3403000;Oldenburg (Oldenburg);W;0;0;0;0;0;0;0;0;0;0;0;0;0;0;0;0;0;0;0;0;0
212000;Raub, räuberische Erpressung auf/gegen sonstige Zahlstellen und Geschäfte;3403000;Oldenburg (Oldenburg);X;11;0;0;0;0;0;0;0;0;0;1;1;2;2;4;3;1;1;1;0;10
212000;Raub, räuberische Erpressung auf/gegen sonstige Zahlstellen und Geschäfte;3404000;Osnabrück;M;10;0;0;0;0;0;0;0;1;1;3;4;0;2;2;3;1;0;0;0;6
212000;Raub, räuberische Erpressung auf/gegen sonstige Zahlstellen und Geschäfte;3404000;Osnabrück;W;0;0;0;0;0;0;0;0;0;0;0;0;0;0;0;0;0;0;0;0;0
212000;Raub, räuberische Erpressung auf/gegen sonstige Zahlstellen und Geschäfte;3404000;Osnabrück;X;10;0;0;0;0;0;0;0;1;1;3;4;0;2;2;3;1;0;0;0;6
212000;Raub, räuberische Erpressung auf/gegen sonstige Zahlstellen und Geschäfte;5774032;Paderborn;M;1;0;0;0;0;0;0;0;0;0;0;0;0;0;0;0;0;0;1;0;1
212000;Raub, räuberische Erpressung auf/gegen sonstige Zahlstellen und Geschäfte;5774032;Paderborn;W;0;0;0;0;0;0;0;0;0;0;0;0;0;0;0;0;0;0;0;0;0
212000;Raub, räuberische Erpressung auf/gegen sonstige Zahlstellen und Geschäfte;5774032;Paderborn;X;1;0;0;0;0;0;0;0;0;0;0;0;0;0;0;0;0;0;1;0;1
212000;Raub, räuberische Erpressung auf/gegen sonstige Zahlstellen und Geschäfte;8231000;Pforzheim;M;6;0;0;0;0;0;0;0;0;0;3;3;1;0;1;0;2;0;0;0;3
212000;Raub, räuberische Erpressung auf/gegen sonstige Zahlstellen und Geschäfte;8231000;Pforzheim;W;0;0;0;0;0;0;0;0;0;0;0;0;0;0;0;0;0;0;0;0;0
212000;Raub, räuberische Erpressung auf/gegen sonstige Zahlstellen und Geschäfte;8231000;Pforzheim;X;6;0;0;0;0;0;0;0;0;0;3;3;1;0;1;0;2;0;0;0;3
212000;Raub, räuberische Erpressung auf/gegen sonstige Zahlstellen und Geschäfte;12054000;Potsdam;M;1;0;0;0;0;0;0;0;0;0;0;0;1;0;1;0;0;0;0;0;1
212000;Raub, räuberische Erpressung auf/gegen sonstige Zahlstellen und Geschäfte;12054000;Potsdam;W;0;0;0;0;0;0;0;0;0;0;0;0;0;0;0;0;0;0;0;0;0
212000;Raub, räuberische Erpressung auf/gegen sonstige Zahlstellen und Geschäfte;12054000;Potsdam;X;1;0;0;0;0;0;0;0;0;0;0;0;1;0;1;0;0;0;0;0;1
212000;Raub, räuberische Erpressung auf/gegen sonstige Zahlstellen und Geschäfte;5562032;Recklinghausen;M;8;0;0;0;0;0;0;0;3;3;2;5;0;2;2;1;0;0;0;0;3
212000;Raub, räuberische Erpressung auf/gegen sonstige Zahlstellen und Geschäfte;5562032;Recklinghausen;W;0;0;0;0;0;0;0;0;0;0;0;0;0;0;0;0;0;0;0;0;0
212000;Raub, räuberische Erpressung auf/gegen sonstige Zahlstellen und Geschäfte;5562032;Recklinghausen;X;8;0;0;0;0;0;0;0;3;3;2;5;0;2;2;1;0;0;0;0;3
212000;Raub, räuberische Erpressung auf/gegen sonstige Zahlstellen und Geschäfte;9362000;Regensburg;M;2;0;0;0;0;0;0;0;0;0;1;1;1;0;1;0;0;0;0;0;1
212000;Raub, räuberische Erpressung auf/gegen sonstige Zahlstellen und Geschäfte;9362000;Regensburg;W;1;0;0;0;0;0;0;0;0;0;0;0;0;0;0;0;1;0;0;0;1
212000;Raub, räuberische Erpressung auf/gegen sonstige Zahlstellen und Geschäfte;9362000;Regensburg;X;3;0;0;0;0;0;0;0;0;0;1;1;1;0;1;0;1;0;0;0;2
212000;Raub, räuberische Erpressung auf/gegen sonstige Zahlstellen und Geschäfte;5120000;Remscheid;M;1;0;0;0;0;0;0;0;0;0;0;0;0;1;1;0;0;0;0;0;1
212000;Raub, räuberische Erpressung auf/gegen sonstige Zahlstellen und Geschäfte;5120000;Remscheid;W;0;0;0;0;0;0;0;0;0;0;0;0;0;0;0;0;0;0;0;0;0
212000;Raub, räuberische Erpressung auf/gegen sonstige Zahlstellen und Geschäfte;5120000;Remscheid;X;1;0;0;0;0;0;0;0;0;0;0;0;0;1;1;0;0;0;0;0;1
212000;Raub, räuberische Erpressung auf/gegen sonstige Zahlstellen und Geschäfte;8415061;Reutlingen;M;2;0;0;0;0;0;0;0;0;0;1;1;1;0;1;0;0;0;0;0;1
212000;Raub, räuberische Erpressung auf/gegen sonstige Zahlstellen und Geschäfte;8415061;Reutlingen;W;0;0;0;0;0;0;0;0;0;0;0;0;0;0;0;0;0;0;0;0;0
212000;Raub, räuberische Erpressung auf/gegen sonstige Zahlstellen und Geschäfte;8415061;Reutlingen;X;2;0;0;0;0;0;0;0;0;0;1;1;1;0;1;0;0;0;0;0;1
212000;Raub, räuberische Erpressung auf/gegen sonstige Zahlstellen und Geschäfte;13003000;Rostock;M;3;0;0;0;0;0;0;0;1;1;0;1;0;1;1;1;0;0;0;0;2
212000;Raub, räuberische Erpressung auf/gegen sonstige Zahlstellen und Geschäfte;13003000;Rostock;W;0;0;0;0;0;0;0;0;0;0;0;0;0;0;0;0;0;0;0;0;0
212000;Raub, räuberische Erpressung auf/gegen sonstige Zahlstellen und Geschäfte;13003000;Rostock;X;3;0;0;0;0;0;0;0;1;1;0;1;0;1;1;1;0;0;0;0;2
212000;Raub, räuberische Erpressung auf/gegen sonstige Zahlstellen und Geschäfte;10041100;Saarbrücken;M;9;0;0;0;0;0;0;1;2;3;1;4;1;1;2;2;1;0;0;0;5
212000;Raub, räuberische Erpressung auf/gegen sonstige Zahlstellen und Geschäfte;10041100;Saarbrücken;W;0;0;0;0;0;0;0;0;0;0;0;0;0;0;0;0;0;0;0;0;0
212000;Raub, räuberische Erpressung auf/gegen sonstige Zahlstellen und Geschäfte;10041100;Saarbrücken;X;9;0;0;0;0;0;0;1;2;3;1;4;1;1;2;2;1;0;0;0;5
212000;Raub, räuberische Erpressung auf/gegen sonstige Zahlstellen und Geschäfte;5122000;Solingen;M;3;0;0;0;0;0;0;0;0;0;3;3;0;0;0;0;0;0;0;0;0
212000;Raub, räuberische Erpressung auf/gegen sonstige Zahlstellen und Geschäfte;5122000;Solingen;W;0;0;0;0;0;0;0;0;0;0;0;0;0;0;0;0;0;0;0;0;0
212000;Raub, räuberische Erpressung auf/gegen sonstige Zahlstellen und Geschäfte;5122000;Solingen;X;3;0;0;0;0;0;0;0;0;0;3;3;0;0;0;0;0;0;0;0;0
212000;Raub, räuberische Erpressung auf/gegen sonstige Zahlstellen und Geschäfte;8111000;Stuttgart;M;14;0;0;0;0;0;0;0;3;3;1;4;0;1;1;2;5;2;0;0;10
212000;Raub, räuberische Erpressung auf/gegen sonstige Zahlstellen und Geschäfte;8111000;Stuttgart;W;0;0;0;0;0;0;0;0;0;0;0;0;0;0;0;0;0;0;0;0;0
212000;Raub, räuberische Erpressung auf/gegen sonstige Zahlstellen und Geschäfte;8111000;Stuttgart;X;14;0;0;0;0;0;0;0;3;3;1;4;0;1;1;2;5;2;0;0;10
212000;Raub, räuberische Erpressung auf/gegen sonstige Zahlstellen und Geschäfte;7211000;Trier;M;4;0;0;0;0;0;0;0;1;1;2;3;0;0;0;0;0;0;1;0;1
212000;Raub, räuberische Erpressung auf/gegen sonstige Zahlstellen und Geschäfte;7211000;Trier;W;1;0;0;0;0;0;0;0;1;1;0;1;0;0;0;0;0;0;0;0;0
212000;Raub, räuberische Erpressung auf/gegen sonstige Zahlstellen und Geschäfte;7211000;Trier;X;5;0;0;0;0;0;0;0;2;2;2;4;0;0;0;0;0;0;1;0;1
212000;Raub, räuberische Erpressung auf/gegen sonstige Zahlstellen und Geschäfte;8421000;Ulm;M;2;0;0;0;0;0;0;0;0;0;0;0;0;0;0;1;1;0;0;0;2
212000;Raub, räuberische Erpressung auf/gegen sonstige Zahlstellen und Geschäfte;8421000;Ulm;W;0;0;0;0;0;0;0;0;0;0;0;0;0;0;0;0;0;0;0;0;0
212000;Raub, räuberische Erpressung auf/gegen sonstige Zahlstellen und Geschäfte;8421000;Ulm;X;2;0;0;0;0;0;0;0;0;0;0;0;0;0;0;1;1;0;0;0;2
212000;Raub, räuberische Erpressung auf/gegen sonstige Zahlstellen und Geschäfte;6414000;Wiesbaden;M;21;0;0;0;0;0;0;0;0;0;6;6;4;2;6;3;4;2;0;0;15
212000;Raub, räuberische Erpressung auf/gegen sonstige Zahlstellen und Geschäfte;6414000;Wiesbaden;W;0;0;0;0;0;0;0;0;0;0;0;0;0;0;0;0;0;0;0;0;0
212000;Raub, räuberische Erpressung auf/gegen sonstige Zahlstellen und Geschäfte;6414000;Wiesbaden;X;21;0;0;0;0;0;0;0;0;0;6;6;4;2;6;3;4;2;0;0;15
212000;Raub, räuberische Erpressung auf/gegen sonstige Zahlstellen und Geschäfte;3103000;Wolfsburg;M;4;0;0;0;0;0;0;0;0;0;0;0;1;0;1;0;0;2;1;0;4
212000;Raub, räuberische Erpressung auf/gegen sonstige Zahlstellen und Geschäfte;3103000;Wolfsburg;W;0;0;0;0;0;0;0;0;0;0;0;0;0;0;0;0;0;0;0;0;0
212000;Raub, räuberische Erpressung auf/gegen sonstige Zahlstellen und Geschäfte;3103000;Wolfsburg;X;4;0;0;0;0;0;0;0;0;0;0;0;1;0;1;0;0;2;1;0;4
212000;Raub, räuberische Erpressung auf/gegen sonstige Zahlstellen und Geschäfte;5124000;Wuppertal;M;10;0;0;0;0;0;0;0;0;0;4;4;1;2;3;1;2;0;0;0;6
212000;Raub, räuberische Erpressung auf/gegen sonstige Zahlstellen und Geschäfte;5124000;Wuppertal;W;2;0;0;0;0;0;0;0;0;0;1;1;0;0;0;0;1;0;0;0;1
212000;Raub, räuberische Erpressung auf/gegen sonstige Zahlstellen und Geschäfte;5124000;Wuppertal;X;12;0;0;0;0;0;0;0;0;0;5;5;1;2;3;1;3;0;0;0;7
212000;Raub, räuberische Erpressung auf/gegen sonstige Zahlstellen und Geschäfte;9663000;Würzburg;M;0;0;0;0;0;0;0;0;0;0;0;0;0;0;0;0;0;0;0;0;0
212000;Raub, räuberische Erpressung auf/gegen sonstige Zahlstellen und Geschäfte;9663000;Würzburg;W;0;0;0;0;0;0;0;0;0;0;0;0;0;0;0;0;0;0;0;0;0
212000;Raub, räuberische Erpressung auf/gegen sonstige Zahlstellen und Geschäfte;9663000;Würzburg;X;0;0;0;0;0;0;0;0;0;0;0;0;0;0;0;0;0;0;0;0;0
216000;Handtaschenraub;5334002;Aachen;M;2;0;0;0;0;0;0;0;2;2;0;2;0;0;0;0;0;0;0;0;0
216000;Handtaschenraub;5334002;Aachen;W;0;0;0;0;0;0;0;0;0;0;0;0;0;0;0;0;0;0;0;0;0
216000;Handtaschenraub;5334002;Aachen;X;2;0;0;0;0;0;0;0;2;2;0;2;0;0;0;0;0;0;0;0;0
216000;Handtaschenraub;9761000;Augsburg;M;3;0;0;0;0;0;0;0;1;1;0;1;0;1;1;0;0;0;1;0;2
216000;Handtaschenraub;9761000;Augsburg;W;0;0;0;0;0;0;0;0;0;0;0;0;0;0;0;0;0;0;0;0;0
216000;Handtaschenraub;9761000;Augsburg;X;3;0;0;0;0;0;0;0;1;1;0;1;0;1;1;0;0;0;1;0;2
216000;Handtaschenraub;5378004;Bergisch Gladbach;M;2;0;0;0;0;0;0;0;0;0;0;0;0;0;0;0;1;0;1;0;2
216000;Handtaschenraub;5378004;Bergisch Gladbach;W;0;0;0;0;0;0;0;0;0;0;0;0;0;0;0;0;0;0;0;0;0
216000;Handtaschenraub;5378004;Bergisch Gladbach;X;2;0;0;0;0;0;0;0;0;0;0;0;0;0;0;0;1;0;1;0;2
216000;Handtaschenraub;11000000;Berlin;M;95;0;0;0;0;1;1;6;24;30;29;60;6;3;9;7;12;5;2;0;35
216000;Handtaschenraub;11000000;Berlin;W;2;0;0;0;0;0;0;0;0;0;1;1;1;0;1;0;0;0;0;0;1
216000;Handtaschenraub;11000000;Berlin;X;97;0;0;0;0;1;1;6;24;30;30;61;7;3;10;7;12;5;2;0;36
216000;Handtaschenraub;5711000;Bielefeld;M;1;0;0;0;0;0;0;0;0;0;0;0;0;0;0;0;0;0;1;0;1
216000;Handtaschenraub;5711000;Bielefeld;W;0;0;0;0;0;0;0;0;0;0;0;0;0;0;0;0;0;0;0;0;0
216000;Handtaschenraub;5711000;Bielefeld;X;1;0;0;0;0;0;0;0;0;0;0;0;0;0;0;0;0;0;1;0;1
216000;Handtaschenraub;5911000;Bochum;M;3;0;0;0;0;0;0;0;1;1;1;2;1;0;1;0;0;0;0;0;1
216000;Handtaschenraub;5911000;Bochum;W;0;0;0;0;0;0;0;0;0;0;0;0;0;0;0;0;0;0;0;0;0
216000;Handtaschenraub;5911000;Bochum;X;3;0;0;0;0;0;0;0;1;1;1;2;1;0;1;0;0;0;0;0;1
216000;Handtaschenraub;5314000;Bonn;M;15;0;0;0;0;0;0;2;3;5;3;8;1;1;2;3;2;0;0;0;7
216000;Handtaschenraub;5314000;Bonn;W;2;0;0;0;0;1;1;0;0;0;1;2;0;0;0;0;0;0;0;0;0
216000;Handtaschenraub;5314000;Bonn;X;17;0;0;0;0;1;1;2;3;5;4;10;1;1;2;3;2;0;0;0;7
216000;Handtaschenraub;5512000;Bottrop;M;1;0;0;0;0;0;0;0;0;0;0;0;0;0;0;1;0;0;0;0;1
216000;Handtaschenraub;5512000;Bottrop;W;0;0;0;0;0;0;0;0;0;0;0;0;0;0;0;0;0;0;0;0;0
216000;Handtaschenraub;5512000;Bottrop;X;1;0;0;0;0;0;0;0;0;0;0;0;0;0;0;1;0;0;0;0;1
216000;Handtaschenraub;3101000;Braunschweig;M;1;0;0;0;0;0;0;0;0;0;1;1;0;0;0;0;0;0;0;0;0
216000;Handtaschenraub;3101000;Braunschweig;W;1;0;0;0;0;0;0;0;0;0;0;0;0;0;0;1;0;0;0;0;1
216000;Handtaschenraub;3101000;Braunschweig;X;2;0;0;0;0;0;0;0;0;0;1;1;0;0;0;1;0;0;0;0;1
216000;Handtaschenraub;4011000;Bremen;M;10;0;0;0;0;0;0;1;0;1;0;1;0;0;0;4;4;1;0;0;9
216000;Handtaschenraub;4011000;Bremen;W;0;0;0;0;0;0;0;0;0;0;0;0;0;0;0;0;0;0;0;0;0
216000;Handtaschenraub;4011000;Bremen;X;10;0;0;0;0;0;0;1;0;1;0;1;0;0;0;4;4;1;0;0;9
216000;Handtaschenraub;4012000;Bremerhaven;M;7;0;0;0;0;0;0;0;1;1;3;4;0;0;0;0;2;1;0;0;3
216000;Handtaschenraub;4012000;Bremerhaven;W;0;0;0;0;0;0;0;0;0;0;0;0;0;0;0;0;0;0;0;0;0
216000;Handtaschenraub;4012000;Bremerhaven;X;7;0;0;0;0;0;0;0;1;1;3;4;0;0;0;0;2;1;0;0;3
216000;Handtaschenraub;14511000;Chemnitz;M;7;0;0;0;0;0;0;0;2;2;0;2;0;1;1;1;1;1;1;0;5
216000;Handtaschenraub;14511000;Chemnitz;W;0;0;0;0;0;0;0;0;0;0;0;0;0;0;0;0;0;0;0;0;0
216000;Handtaschenraub;14511000;Chemnitz;X;7;0;0;0;0;0;0;0;2;2;0;2;0;1;1;1;1;1;1;0;5
216000;Handtaschenraub;6411000;Darmstadt;M;1;0;0;0;0;0;0;0;0;0;0;0;0;1;1;0;0;0;0;0;1
216000;Handtaschenraub;6411000;Darmstadt;W;0;0;0;0;0;0;0;0;0;0;0;0;0;0;0;0;0;0;0;0;0
216000;Handtaschenraub;6411000;Darmstadt;X;1;0;0;0;0;0;0;0;0;0;0;0;0;1;1;0;0;0;0;0;1
216000;Handtaschenraub;5913000;Dortmund;M;24;0;0;0;2;0;2;2;7;9;1;12;1;1;2;3;7;0;0;0;12
216000;Handtaschenraub;5913000;Dortmund;W;0;0;0;0;0;0;0;0;0;0;0;0;0;0;0;0;0;0;0;0;0
216000;Handtaschenraub;5913000;Dortmund;X;24;0;0;0;2;0;2;2;7;9;1;12;1;1;2;3;7;0;0;0;12
216000;Handtaschenraub;14612000;Dresden;M;3;0;0;0;0;0;0;0;0;0;0;0;0;1;1;0;2;0;0;0;3
216000;Handtaschenraub;14612000;Dresden;W;0;0;0;0;0;0;0;0;0;0;0;0;0;0;0;0;0;0;0;0;0
216000;Handtaschenraub;14612000;Dresden;X;3;0;0;0;0;0;0;0;0;0;0;0;0;1;1;0;2;0;0;0;3
216000;Handtaschenraub;5112000;Duisburg;M;13;0;0;0;0;0;0;6;2;8;2;10;2;0;2;1;0;0;0;0;3
216000;Handtaschenraub;5112000;Duisburg;W;0;0;0;0;0;0;0;0;0;0;0;0;0;0;0;0;0;0;0;0;0
216000;Handtaschenraub;5112000;Duisburg;X;13;0;0;0;0;0;0;6;2;8;2;10;2;0;2;1;0;0;0;0;3
216000;Handtaschenraub;5111000;Düsseldorf;M;8;0;0;0;0;0;0;1;0;1;4;5;1;0;1;1;1;0;0;0;3
216000;Handtaschenraub;5111000;Düsseldorf;W;2;0;0;0;0;0;0;0;0;0;2;2;0;0;0;0;0;0;0;0;0
216000;Handtaschenraub;5111000;Düsseldorf;X;10;0;0;0;0;0;0;1;0;1;6;7;1;0;1;1;1;0;0;0;3
216000;Handtaschenraub;16051000;Erfurt;M;1;0;0;0;0;0;0;0;0;0;1;1;0;0;0;0;0;0;0;0;0
216000;Handtaschenraub;16051000;Erfurt;W;0;0;0;0;0;0;0;0;0;0;0;0;0;0;0;0;0;0;0;0;0
216000;Handtaschenraub;16051000;Erfurt;X;1;0;0;0;0;0;0;0;0;0;1;1;0;0;0;0;0;0;0;0;0
216000;Handtaschenraub;9562000;Erlangen;M;0;0;0;0;0;0;0;0;0;0;0;0;0;0;0;0;0;0;0;0;0
216000;Handtaschenraub;9562000;Erlangen;W;0;0;0;0;0;0;0;0;0;0;0;0;0;0;0;0;0;0;0;0;0
216000;Handtaschenraub;9562000;Erlangen;X;0;0;0;0;0;0;0;0;0;0;0;0;0;0;0;0;0;0;0;0;0
216000;Handtaschenraub;5113000;Essen;M;4;0;0;0;0;2;2;0;1;1;0;3;0;1;1;0;0;0;0;0;1
216000;Handtaschenraub;5113000;Essen;W;4;0;0;0;0;0;0;0;0;0;3;3;0;0;0;0;1;0;0;0;1
216000;Handtaschenraub;5113000;Essen;X;8;0;0;0;0;2;2;0;1;1;3;6;0;1;1;0;1;0;0;0;2
216000;Handtaschenraub;6412000;Frankfurt am Main;M;22;0;0;0;0;0;0;0;2;2;3;5;3;2;5;2;8;2;0;0;17
216000;Handtaschenraub;6412000;Frankfurt am Main;W;2;0;0;0;0;0;0;0;0;0;0;0;0;0;0;1;1;0;0;0;2
216000;Handtaschenraub;6412000;Frankfurt am Main;X;24;0;0;0;0;0;0;0;2;2;3;5;3;2;5;3;9;2;0;0;19
216000;Handtaschenraub;8311000;Freiburg im Breisgau;M;3;0;0;0;0;0;0;0;0;0;0;0;1;0;1;1;0;1;0;0;3
216000;Handtaschenraub;8311000;Freiburg im Breisgau;W;1;0;0;0;0;0;0;0;0;0;0;0;0;0;0;1;0;0;0;0;1
216000;Handtaschenraub;8311000;Freiburg im Breisgau;X;4;0;0;0;0;0;0;0;0;0;0;0;1;0;1;2;0;1;0;0;4
216000;Handtaschenraub;9563000;Fürth;M;2;0;0;0;0;0;0;0;1;1;1;2;0;0;0;0;0;0;0;0;0
216000;Handtaschenraub;9563000;Fürth;W;0;0;0;0;0;0;0;0;0;0;0;0;0;0;0;0;0;0;0;0;0
216000;Handtaschenraub;9563000;Fürth;X;2;0;0;0;0;0;0;0;1;1;1;2;0;0;0;0;0;0;0;0;0
216000;Handtaschenraub;5513000;Gelsenkirchen;M;9;0;0;0;0;0;0;3;2;5;3;8;1;0;1;0;0;0;0;0;1
216000;Handtaschenraub;5513000;Gelsenkirchen;W;0;0;0;0;0;0;0;0;0;0;0;0;0;0;0;0;0;0;0;0;0
216000;Handtaschenraub;5513000;Gelsenkirchen;X;9;0;0;0;0;0;0;3;2;5;3;8;1;0;1;0;0;0;0;0;1
216000;Handtaschenraub;3152012;Göttingen;M;0;0;0;0;0;0;0;0;0;0;0;0;0;0;0;0;0;0;0;0;0
216000;Handtaschenraub;3152012;Göttingen;W;1;0;0;0;0;0;0;0;0;0;0;0;0;0;0;0;1;0;0;0;1
216000;Handtaschenraub;3152012;Göttingen;X;1;0;0;0;0;0;0;0;0;0;0;0;0;0;0;0;1;0;0;0;1
216000;Handtaschenraub;5914000;Hagen;M;3;0;0;0;0;0;0;2;0;2;0;2;0;0;0;0;1;0;0;0;1
216000;Handtaschenraub;5914000;Hagen;W;2;0;0;0;0;0;0;1;0;1;0;1;0;0;0;0;1;0;0;0;1
216000;Handtaschenraub;5914000;Hagen;X;5;0;0;0;0;0;0;3;0;3;0;3;0;0;0;0;2;0;0;0;2
216000;Handtaschenraub;15002000;Halle (Saale);M;13;0;0;0;0;0;0;1;2;3;5;8;1;1;2;2;0;1;0;0;5
216000;Handtaschenraub;15002000;Halle (Saale);W;0;0;0;0;0;0;0;0;0;0;0;0;0;0;0;0;0;0;0;0;0
216000;Handtaschenraub;15002000;Halle (Saale);X;13;0;0;0;0;0;0;1;2;3;5;8;1;1;2;2;0;1;0;0;5
216000;Handtaschenraub;2000000;Hamburg;M;26;0;0;0;0;2;2;1;4;5;4;11;2;4;6;3;6;0;0;0;15
216000;Handtaschenraub;2000000;Hamburg;W;0;0;0;0;0;0;0;0;0;0;0;0;0;0;0;0;0;0;0;0;0
216000;Handtaschenraub;2000000;Hamburg;X;26;0;0;0;0;2;2;1;4;5;4;11;2;4;6;3;6;0;0;0;15
216000;Handtaschenraub;5915000;Hamm;M;3;0;0;0;0;0;0;0;0;0;2;2;0;1;1;0;0;0;0;0;1
216000;Handtaschenraub;5915000;Hamm;W;0;0;0;0;0;0;0;0;0;0;0;0;0;0;0;0;0;0;0;0;0
216000;Handtaschenraub;5915000;Hamm;X;3;0;0;0;0;0;0;0;0;0;2;2;0;1;1;0;0;0;0;0;1
216000;Handtaschenraub;3241001;Hannover;M;24;0;0;1;1;1;3;1;2;3;11;17;1;0;1;2;2;2;0;0;7
216000;Handtaschenraub;3241001;Hannover;W;3;0;0;0;0;0;0;1;0;1;0;1;0;0;0;1;0;1;0;0;2
216000;Handtaschenraub;3241001;Hannover;X;27;0;0;1;1;1;3;2;2;4;11;18;1;0;1;3;2;3;0;0;9
216000;Handtaschenraub;8221000;Heidelberg;M;0;0;0;0;0;0;0;0;0;0;0;0;0;0;0;0;0;0;0;0;0
216000;Handtaschenraub;8221000;Heidelberg;W;0;0;0;0;0;0;0;0;0;0;0;0;0;0;0;0;0;0;0;0;0
216000;Handtaschenraub;8221000;Heidelberg;X;0;0;0;0;0;0;0;0;0;0;0;0;0;0;0;0;0;0;0;0;0
216000;Handtaschenraub;8121000;Heilbronn;M;2;0;0;0;0;0;0;0;1;1;1;2;0;0;0;0;0;0;0;0;0
216000;Handtaschenraub;8121000;Heilbronn;W;1;0;0;0;0;0;0;0;0;0;1;1;0;0;0;0;0;0;0;0;0
216000;Handtaschenraub;8121000;Heilbronn;X;3;0;0;0;0;0;0;0;1;1;2;3;0;0;0;0;0;0;0;0;0
216000;Handtaschenraub;5916000;Herne;M;0;0;0;0;0;0;0;0;0;0;0;0;0;0;0;0;0;0;0;0;0
216000;Handtaschenraub;5916000;Herne;W;0;0;0;0;0;0;0;0;0;0;0;0;0;0;0;0;0;0;0;0;0
216000;Handtaschenraub;5916000;Herne;X;0;0;0;0;0;0;0;0;0;0;0;0;0;0;0;0;0;0;0;0;0
216000;Handtaschenraub;9161000;Ingolstadt;M;1;0;0;0;0;0;0;0;0;0;0;0;0;0;0;0;1;0;0;0;1
216000;Handtaschenraub;9161000;Ingolstadt;W;0;0;0;0;0;0;0;0;0;0;0;0;0;0;0;0;0;0;0;0;0
216000;Handtaschenraub;9161000;Ingolstadt;X;1;0;0;0;0;0;0;0;0;0;0;0;0;0;0;0;1;0;0;0;1
216000;Handtaschenraub;16053000;Jena;M;0;0;0;0;0;0;0;0;0;0;0;0;0;0;0;0;0;0;0;0;0
216000;Handtaschenraub;16053000;Jena;W;0;0;0;0;0;0;0;0;0;0;0;0;0;0;0;0;0;0;0;0;0
216000;Handtaschenraub;16053000;Jena;X;0;0;0;0;0;0;0;0;0;0;0;0;0;0;0;0;0;0;0;0;0
216000;Handtaschenraub;8212000;Karlsruhe;M;6;0;0;0;0;0;0;0;1;1;3;4;0;1;1;0;1;0;0;0;2
216000;Handtaschenraub;8212000;Karlsruhe;W;0;0;0;0;0;0;0;0;0;0;0;0;0;0;0;0;0;0;0;0;0
216000;Handtaschenraub;8212000;Karlsruhe;X;6;0;0;0;0;0;0;0;1;1;3;4;0;1;1;0;1;0;0;0;2
216000;Handtaschenraub;6611000;Kassel;M;1;0;0;0;0;0;0;0;0;0;0;0;0;0;0;0;1;0;0;0;1
216000;Handtaschenraub;6611000;Kassel;W;0;0;0;0;0;0;0;0;0;0;0;0;0;0;0;0;0;0;0;0;0
216000;Handtaschenraub;6611000;Kassel;X;1;0;0;0;0;0;0;0;0;0;0;0;0;0;0;0;1;0;0;0;1
216000;Handtaschenraub;1002000;Kiel;M;2;0;0;0;0;0;0;0;0;0;0;0;0;0;0;2;0;0;0;0;2
216000;Handtaschenraub;1002000;Kiel;W;1;0;0;0;0;0;0;0;0;0;0;0;0;0;0;0;0;1;0;0;1
216000;Handtaschenraub;1002000;Kiel;X;3;0;0;0;0;0;0;0;0;0;0;0;0;0;0;2;0;1;0;0;3
216000;Handtaschenraub;7111000;Koblenz;M;0;0;0;0;0;0;0;0;0;0;0;0;0;0;0;0;0;0;0;0;0
216000;Handtaschenraub;7111000;Koblenz;W;1;0;0;0;0;0;0;0;0;0;0;0;1;0;1;0;0;0;0;0;1
216000;Handtaschenraub;7111000;Koblenz;X;1;0;0;0;0;0;0;0;0;0;0;0;1;0;1;0;0;0;0;0;1
216000;Handtaschenraub;5315000;Köln;M;43;0;0;0;0;2;2;4;11;15;3;20;2;4;6;3;8;4;2;0;23
216000;Handtaschenraub;5315000;Köln;W;5;0;0;0;0;1;1;1;2;3;0;4;0;0;0;0;1;0;0;0;1
216000;Handtaschenraub;5315000;Köln;X;48;0;0;0;0;3;3;5;13;18;3;24;2;4;6;3;9;4;2;0;24
216000;Handtaschenraub;5114000;Krefeld;M;4;0;0;0;0;0;0;0;0;0;2;2;0;1;1;0;1;0;0;0;2
216000;Handtaschenraub;5114000;Krefeld;W;2;0;0;0;0;0;0;0;0;0;1;1;0;0;0;0;0;0;0;1;1
216000;Handtaschenraub;5114000;Krefeld;X;6;0;0;0;0;0;0;0;0;0;3;3;0;1;1;0;1;0;0;1;3
216000;Handtaschenraub;14713000;Leipzig;M;14;0;0;0;0;1;1;1;0;1;2;4;1;1;2;3;5;0;0;0;10
216000;Handtaschenraub;14713000;Leipzig;W;3;0;0;0;0;1;1;1;0;1;0;2;0;0;0;0;0;0;1;0;1
216000;Handtaschenraub;14713000;Leipzig;X;17;0;0;0;0;2;2;2;0;2;2;6;1;1;2;3;5;0;1;0;11
216000;Handtaschenraub;5316000;Leverkusen;M;2;0;0;0;0;0;0;0;0;0;1;1;0;0;0;0;1;0;0;0;1
216000;Handtaschenraub;5316000;Leverkusen;W;0;0;0;0;0;0;0;0;0;0;0;0;0;0;0;0;0;0;0;0;0
216000;Handtaschenraub;5316000;Leverkusen;X;2;0;0;0;0;0;0;0;0;0;1;1;0;0;0;0;1;0;0;0;1
216000;Handtaschenraub;1003000;Lübeck;M;0;0;0;0;0;0;0;0;0;0;0;0;0;0;0;0;0;0;0;0;0
216000;Handtaschenraub;1003000;Lübeck;W;0;0;0;0;0;0;0;0;0;0;0;0;0;0;0;0;0;0;0;0;0
216000;Handtaschenraub;1003000;Lübeck;X;0;0;0;0;0;0;0;0;0;0;0;0;0;0;0;0;0;0;0;0;0
216000;Handtaschenraub;7314000;Ludwigshafen am Rhein;M;9;0;0;0;0;0;0;1;2;3;1;4;0;1;1;2;1;0;0;1;5
216000;Handtaschenraub;7314000;Ludwigshafen am Rhein;W;0;0;0;0;0;0;0;0;0;0;0;0;0;0;0;0;0;0;0;0;0
216000;Handtaschenraub;7314000;Ludwigshafen am Rhein;X;9;0;0;0;0;0;0;1;2;3;1;4;0;1;1;2;1;0;0;1;5
216000;Handtaschenraub;15003000;Magdeburg;M;6;0;0;0;0;0;0;1;1;2;2;4;0;1;1;0;1;0;0;0;2
216000;Handtaschenraub;15003000;Magdeburg;W;0;0;0;0;0;0;0;0;0;0;0;0;0;0;0;0;0;0;0;0;0
216000;Handtaschenraub;15003000;Magdeburg;X;6;0;0;0;0;0;0;1;1;2;2;4;0;1;1;0;1;0;0;0;2
216000;Handtaschenraub;7315000;Mainz;M;10;0;0;0;0;0;0;2;2;4;4;8;0;0;0;0;1;1;0;0;2
216000;Handtaschenraub;7315000;Mainz;W;0;0;0;0;0;0;0;0;0;0;0;0;0;0;0;0;0;0;0;0;0
216000;Handtaschenraub;7315000;Mainz;X;10;0;0;0;0;0;0;2;2;4;4;8;0;0;0;0;1;1;0;0;2
216000;Handtaschenraub;8222000;Mannheim;M;6;0;0;0;0;1;1;1;0;1;2;4;0;0;0;1;0;1;0;0;2
216000;Handtaschenraub;8222000;Mannheim;W;0;0;0;0;0;0;0;0;0;0;0;0;0;0;0;0;0;0;0;0;0
216000;Handtaschenraub;8222000;Mannheim;X;6;0;0;0;0;1;1;1;0;1;2;4;0;0;0;1;0;1;0;0;2
216000;Handtaschenraub;5170024;Moers;M;0;0;0;0;0;0;0;0;0;0;0;0;0;0;0;0;0;0;0;0;0
216000;Handtaschenraub;5170024;Moers;W;0;0;0;0;0;0;0;0;0;0;0;0;0;0;0;0;0;0;0;0;0
216000;Handtaschenraub;5170024;Moers;X;0;0;0;0;0;0;0;0;0;0;0;0;0;0;0;0;0;0;0;0;0
216000;Handtaschenraub;5116000;Mönchengladbach;M;3;0;0;0;0;0;0;0;0;0;3;3;0;0;0;0;0;0;0;0;0
216000;Handtaschenraub;5116000;Mönchengladbach;W;0;0;0;0;0;0;0;0;0;0;0;0;0;0;0;0;0;0;0;0;0
216000;Handtaschenraub;5116000;Mönchengladbach;X;3;0;0;0;0;0;0;0;0;0;3;3;0;0;0;0;0;0;0;0;0
216000;Handtaschenraub;5117000;Mülheim an der Ruhr;M;1;0;0;0;0;0;0;0;0;0;0;0;0;0;0;0;1;0;0;0;1
216000;Handtaschenraub;5117000;Mülheim an der Ruhr;W;0;0;0;0;0;0;0;0;0;0;0;0;0;0;0;0;0;0;0;0;0
216000;Handtaschenraub;5117000;Mülheim an der Ruhr;X;1;0;0;0;0;0;0;0;0;0;0;0;0;0;0;0;1;0;0;0;1
216000;Handtaschenraub;9162000;München;M;15;0;0;0;0;0;0;0;0;0;1;1;1;1;2;7;4;1;0;0;14
216000;Handtaschenraub;9162000;München;W;2;0;0;0;0;0;0;0;0;0;0;0;0;0;0;0;1;1;0;0;2
216000;Handtaschenraub;9162000;München;X;17;0;0;0;0;0;0;0;0;0;1;1;1;1;2;7;5;2;0;0;16
216000;Handtaschenraub;5515000;Münster;M;1;0;0;0;0;0;0;0;0;0;1;1;0;0;0;0;0;0;0;0;0
216000;Handtaschenraub;5515000;Münster;W;0;0;0;0;0;0;0;0;0;0;0;0;0;0;0;0;0;0;0;0;0
216000;Handtaschenraub;5515000;Münster;X;1;0;0;0;0;0;0;0;0;0;1;1;0;0;0;0;0;0;0;0;0
216000;Handtaschenraub;5162024;Neuss;M;1;0;0;0;0;0;0;0;1;1;0;1;0;0;0;0;0;0;0;0;0
216000;Handtaschenraub;5162024;Neuss;W;0;0;0;0;0;0;0;0;0;0;0;0;0;0;0;0;0;0;0;0;0
216000;Handtaschenraub;5162024;Neuss;X;1;0;0;0;0;0;0;0;1;1;0;1;0;0;0;0;0;0;0;0;0
216000;Handtaschenraub;9564000;Nürnberg;M;14;0;0;0;0;0;0;2;2;4;5;9;0;2;2;1;1;1;0;0;5
216000;Handtaschenraub;9564000;Nürnberg;W;4;0;0;0;0;0;0;1;1;2;0;2;0;0;0;0;0;1;0;1;2
216000;Handtaschenraub;9564000;Nürnberg;X;18;0;0;0;0;0;0;3;3;6;5;11;0;2;2;1;1;2;0;1;7
216000;Handtaschenraub;5119000;Oberhausen;M;1;0;0;0;0;0;0;0;0;0;0;0;0;1;1;0;0;0;0;0;1
216000;Handtaschenraub;5119000;Oberhausen;W;0;0;0;0;0;0;0;0;0;0;0;0;0;0;0;0;0;0;0;0;0
216000;Handtaschenraub;5119000;Oberhausen;X;1;0;0;0;0;0;0;0;0;0;0;0;0;1;1;0;0;0;0;0;1
216000;Handtaschenraub;6413000;Offenbach am Main;M;4;0;0;0;0;0;0;0;0;0;1;1;0;0;0;1;1;1;0;0;3
216000;Handtaschenraub;6413000;Offenbach am Main;W;0;0;0;0;0;0;0;0;0;0;0;0;0;0;0;0;0;0;0;0;0
216000;Handtaschenraub;6413000;Offenbach am Main;X;4;0;0;0;0;0;0;0;0;0;1;1;0;0;0;1;1;1;0;0;3
216000;Handtaschenraub;3403000;Oldenburg (Oldenburg);M;1;0;0;0;0;0;0;0;1;1;0;1;0;0;0;0;0;0;0;0;0
216000;Handtaschenraub;3403000;Oldenburg (Oldenburg);W;0;0;0;0;0;0;0;0;0;0;0;0;0;0;0;0;0;0;0;0;0
216000;Handtaschenraub;3403000;Oldenburg (Oldenburg);X;1;0;0;0;0;0;0;0;1;1;0;1;0;0;0;0;0;0;0;0;0
216000;Handtaschenraub;3404000;Osnabrück;M;9;0;0;0;0;0;0;0;2;2;1;3;1;1;2;4;0;0;0;0;6
216000;Handtaschenraub;3404000;Osnabrück;W;1;0;0;0;0;0;0;0;0;0;0;0;0;0;0;0;0;1;0;0;1
216000;Handtaschenraub;3404000;Osnabrück;X;10;0;0;0;0;0;0;0;2;2;1;3;1;1;2;4;0;1;0;0;7
216000;Handtaschenraub;5774032;Paderborn;M;2;0;0;0;0;0;0;0;1;1;0;1;0;0;0;0;1;0;0;0;1
216000;Handtaschenraub;5774032;Paderborn;W;0;0;0;0;0;0;0;0;0;0;0;0;0;0;0;0;0;0;0;0;0
216000;Handtaschenraub;5774032;Paderborn;X;2;0;0;0;0;0;0;0;1;1;0;1;0;0;0;0;1;0;0;0;1
216000;Handtaschenraub;8231000;Pforzheim;M;0;0;0;0;0;0;0;0;0;0;0;0;0;0;0;0;0;0;0;0;0
216000;Handtaschenraub;8231000;Pforzheim;W;0;0;0;0;0;0;0;0;0;0;0;0;0;0;0;0;0;0;0;0;0
216000;Handtaschenraub;8231000;Pforzheim;X;0;0;0;0;0;0;0;0;0;0;0;0;0;0;0;0;0;0;0;0;0
216000;Handtaschenraub;12054000;Potsdam;M;4;0;0;0;0;1;1;2;1;3;0;4;0;0;0;0;0;0;0;0;0
216000;Handtaschenraub;12054000;Potsdam;W;2;0;0;0;0;0;0;1;1;2;0;2;0;0;0;0;0;0;0;0;0
216000;Handtaschenraub;12054000;Potsdam;X;6;0;0;0;0;1;1;3;2;5;0;6;0;0;0;0;0;0;0;0;0
216000;Handtaschenraub;5562032;Recklinghausen;M;0;0;0;0;0;0;0;0;0;0;0;0;0;0;0;0;0;0;0;0;0
216000;Handtaschenraub;5562032;Recklinghausen;W;0;0;0;0;0;0;0;0;0;0;0;0;0;0;0;0;0;0;0;0;0
216000;Handtaschenraub;5562032;Recklinghausen;X;0;0;0;0;0;0;0;0;0;0;0;0;0;0;0;0;0;0;0;0;0
216000;Handtaschenraub;9362000;Regensburg;M;5;0;0;0;0;0;0;0;0;0;0;0;2;0;2;1;2;0;0;0;5
216000;Handtaschenraub;9362000;Regensburg;W;0;0;0;0;0;0;0;0;0;0;0;0;0;0;0;0;0;0;0;0;0
216000;Handtaschenraub;9362000;Regensburg;X;5;0;0;0;0;0;0;0;0;0;0;0;2;0;2;1;2;0;0;0;5
216000;Handtaschenraub;5120000;Remscheid;M;0;0;0;0;0;0;0;0;0;0;0;0;0;0;0;0;0;0;0;0;0
216000;Handtaschenraub;5120000;Remscheid;W;0;0;0;0;0;0;0;0;0;0;0;0;0;0;0;0;0;0;0;0;0
216000;Handtaschenraub;5120000;Remscheid;X;0;0;0;0;0;0;0;0;0;0;0;0;0;0;0;0;0;0;0;0;0
216000;Handtaschenraub;8415061;Reutlingen;M;0;0;0;0;0;0;0;0;0;0;0;0;0;0;0;0;0;0;0;0;0
216000;Handtaschenraub;8415061;Reutlingen;W;0;0;0;0;0;0;0;0;0;0;0;0;0;0;0;0;0;0;0;0;0
216000;Handtaschenraub;8415061;Reutlingen;X;0;0;0;0;0;0;0;0;0;0;0;0;0;0;0;0;0;0;0;0;0
216000;Handtaschenraub;13003000;Rostock;M;2;0;0;0;0;0;0;0;0;0;0;0;0;1;1;0;1;0;0;0;2
216000;Handtaschenraub;13003000;Rostock;W;0;0;0;0;0;0;0;0;0;0;0;0;0;0;0;0;0;0;0;0;0
216000;Handtaschenraub;13003000;Rostock;X;2;0;0;0;0;0;0;0;0;0;0;0;0;1;1;0;1;0;0;0;2
216000;Handtaschenraub;10041100;Saarbrücken;M;4;0;0;0;0;1;1;1;1;2;1;4;0;0;0;0;0;0;0;0;0
216000;Handtaschenraub;10041100;Saarbrücken;W;0;0;0;0;0;0;0;0;0;0;0;0;0;0;0;0;0;0;0;0;0
216000;Handtaschenraub;10041100;Saarbrücken;X;4;0;0;0;0;1;1;1;1;2;1;4;0;0;0;0;0;0;0;0;0
216000;Handtaschenraub;5122000;Solingen;M;0;0;0;0;0;0;0;0;0;0;0;0;0;0;0;0;0;0;0;0;0
216000;Handtaschenraub;5122000;Solingen;W;0;0;0;0;0;0;0;0;0;0;0;0;0;0;0;0;0;0;0;0;0
216000;Handtaschenraub;5122000;Solingen;X;0;0;0;0;0;0;0;0;0;0;0;0;0;0;0;0;0;0;0;0;0
216000;Handtaschenraub;8111000;Stuttgart;M;9;0;0;0;0;0;0;0;2;2;3;5;0;1;1;2;1;0;0;0;4
216000;Handtaschenraub;8111000;Stuttgart;W;1;0;0;0;0;0;0;0;0;0;0;0;0;0;0;1;0;0;0;0;1
216000;Handtaschenraub;8111000;Stuttgart;X;10;0;0;0;0;0;0;0;2;2;3;5;0;1;1;3;1;0;0;0;5
216000;Handtaschenraub;7211000;Trier;M;0;0;0;0;0;0;0;0;0;0;0;0;0;0;0;0;0;0;0;0;0
216000;Handtaschenraub;7211000;Trier;W;0;0;0;0;0;0;0;0;0;0;0;0;0;0;0;0;0;0;0;0;0
216000;Handtaschenraub;7211000;Trier;X;0;0;0;0;0;0;0;0;0;0;0;0;0;0;0;0;0;0;0;0;0
216000;Handtaschenraub;8421000;Ulm;M;2;0;0;0;0;0;0;0;0;0;1;1;0;0;0;0;1;0;0;0;1
216000;Handtaschenraub;8421000;Ulm;W;0;0;0;0;0;0;0;0;0;0;0;0;0;0;0;0;0;0;0;0;0
216000;Handtaschenraub;8421000;Ulm;X;2;0;0;0;0;0;0;0;0;0;1;1;0;0;0;0;1;0;0;0;1
216000;Handtaschenraub;6414000;Wiesbaden;M;10;0;0;0;0;0;0;4;2;6;2;8;1;0;1;0;1;0;0;0;2
216000;Handtaschenraub;6414000;Wiesbaden;W;0;0;0;0;0;0;0;0;0;0;0;0;0;0;0;0;0;0;0;0;0
216000;Handtaschenraub;6414000;Wiesbaden;X;10;0;0;0;0;0;0;4;2;6;2;8;1;0;1;0;1;0;0;0;2
216000;Handtaschenraub;3103000;Wolfsburg;M;5;0;0;0;0;0;0;0;1;1;0;1;1;0;1;0;3;0;0;0;4
216000;Handtaschenraub;3103000;Wolfsburg;W;0;0;0;0;0;0;0;0;0;0;0;0;0;0;0;0;0;0;0;0;0
216000;Handtaschenraub;3103000;Wolfsburg;X;5;0;0;0;0;0;0;0;1;1;0;1;1;0;1;0;3;0;0;0;4
216000;Handtaschenraub;5124000;Wuppertal;M;5;0;0;0;0;0;0;1;0;1;2;3;1;0;1;0;0;1;0;0;2
216000;Handtaschenraub;5124000;Wuppertal;W;0;0;0;0;0;0;0;0;0;0;0;0;0;0;0;0;0;0;0;0;0
216000;Handtaschenraub;5124000;Wuppertal;X;5;0;0;0;0;0;0;1;0;1;2;3;1;0;1;0;0;1;0;0;2
216000;Handtaschenraub;9663000;Würzburg;M;0;0;0;0;0;0;0;0;0;0;0;0;0;0;0;0;0;0;0;0;0
216000;Handtaschenraub;9663000;Würzburg;W;0;0;0;0;0;0;0;0;0;0;0;0;0;0;0;0;0;0;0;0;0
216000;Handtaschenraub;9663000;Würzburg;X;0;0;0;0;0;0;0;0;0;0;0;0;0;0;0;0;0;0;0;0;0
217000;Sonstige Raubüberfälle auf Straßen, Wegen oder Plätzen;5334002;Aachen;M;107;0;0;0;1;4;5;21;27;48;19;72;7;10;17;7;6;3;2;0;35
217000;Sonstige Raubüberfälle auf Straßen, Wegen oder Plätzen;5334002;Aachen;W;3;0;0;0;0;0;0;0;2;2;0;2;1;0;1;0;0;0;0;0;1
217000;Sonstige Raubüberfälle auf Straßen, Wegen oder Plätzen;5334002;Aachen;X;110;0;0;0;1;4;5;21;29;50;19;74;8;10;18;7;6;3;2;0;36
217000;Sonstige Raubüberfälle auf Straßen, Wegen oder Plätzen;9761000;Augsburg;M;10;0;0;0;1;0;1;0;0;0;4;5;1;2;3;0;0;1;0;1;5
217000;Sonstige Raubüberfälle auf Straßen, Wegen oder Plätzen;9761000;Augsburg;W;0;0;0;0;0;0;0;0;0;0;0;0;0;0;0;0;0;0;0;0;0
217000;Sonstige Raubüberfälle auf Straßen, Wegen oder Plätzen;9761000;Augsburg;X;10;0;0;0;1;0;1;0;0;0;4;5;1;2;3;0;0;1;0;1;5
217000;Sonstige Raubüberfälle auf Straßen, Wegen oder Plätzen;5378004;Bergisch Gladbach;M;24;0;0;0;1;0;1;1;8;9;9;19;1;0;1;2;2;0;0;0;5
217000;Sonstige Raubüberfälle auf Straßen, Wegen oder Plätzen;5378004;Bergisch Gladbach;W;3;0;0;0;0;0;0;0;1;1;0;1;0;0;0;1;1;0;0;0;2
217000;Sonstige Raubüberfälle auf Straßen, Wegen oder Plätzen;5378004;Bergisch Gladbach;X;27;0;0;0;1;0;1;1;9;10;9;20;1;0;1;3;3;0;0;0;7
217000;Sonstige Raubüberfälle auf Straßen, Wegen oder Plätzen;11000000;Berlin;M;985;0;0;0;16;53;69;158;221;379;211;659;73;44;117;76;91;33;9;0;326
217000;Sonstige Raubüberfälle auf Straßen, Wegen oder Plätzen;11000000;Berlin;W;86;0;0;1;0;13;14;28;16;44;7;65;2;3;5;3;7;5;1;0;21
217000;Sonstige Raubüberfälle auf Straßen, Wegen oder Plätzen;11000000;Berlin;X;1071;0;0;1;16;66;83;186;237;423;218;724;75;47;122;79;98;38;10;0;347
217000;Sonstige Raubüberfälle auf Straßen, Wegen oder Plätzen;5711000;Bielefeld;M;61;0;0;0;0;1;1;5;16;21;11;33;4;7;11;6;8;3;0;0;28
217000;Sonstige Raubüberfälle auf Straßen, Wegen oder Plätzen;5711000;Bielefeld;W;8;0;0;0;0;0;0;5;2;7;0;7;1;0;1;0;0;0;0;0;1
217000;Sonstige Raubüberfälle auf Straßen, Wegen oder Plätzen;5711000;Bielefeld;X;69;0;0;0;0;1;1;10;18;28;11;40;5;7;12;6;8;3;0;0;29
217000;Sonstige Raubüberfälle auf Straßen, Wegen oder Plätzen;5911000;Bochum;M;93;0;0;0;1;3;4;14;29;43;16;63;5;5;10;10;6;3;1;0;30
217000;Sonstige Raubüberfälle auf Straßen, Wegen oder Plätzen;5911000;Bochum;W;12;0;0;0;0;3;3;1;2;3;3;9;0;0;0;2;0;1;0;0;3
217000;Sonstige Raubüberfälle auf Straßen, Wegen oder Plätzen;5911000;Bochum;X;105;0;0;0;1;6;7;15;31;46;19;72;5;5;10;12;6;4;1;0;33
217000;Sonstige Raubüberfälle auf Straßen, Wegen oder Plätzen;5314000;Bonn;M;100;0;0;0;2;6;8;15;17;32;28;68;7;4;11;8;5;6;2;0;32
217000;Sonstige Raubüberfälle auf Straßen, Wegen oder Plätzen;5314000;Bonn;W;11;0;0;0;0;2;2;3;0;3;0;5;0;0;0;1;3;2;0;0;6
217000;Sonstige Raubüberfälle auf Straßen, Wegen oder Plätzen;5314000;Bonn;X;111;0;0;0;2;8;10;18;17;35;28;73;7;4;11;9;8;8;2;0;38
217000;Sonstige Raubüberfälle auf Straßen, Wegen oder Plätzen;5512000;Bottrop;M;10;0;0;0;1;0;1;0;0;0;2;3;2;1;3;3;1;0;0;0;7
217000;Sonstige Raubüberfälle auf Straßen, Wegen oder Plätzen;5512000;Bottrop;W;3;0;0;0;0;2;2;1;0;1;0;3;0;0;0;0;0;0;0;0;0
217000;Sonstige Raubüberfälle auf Straßen, Wegen oder Plätzen;5512000;Bottrop;X;13;0;0;0;1;2;3;1;0;1;2;6;2;1;3;3;1;0;0;0;7
217000;Sonstige Raubüberfälle auf Straßen, Wegen oder Plätzen;3101000;Braunschweig;M;57;0;0;0;0;0;0;3;9;12;15;27;4;6;10;10;6;3;1;0;30
217000;Sonstige Raubüberfälle auf Straßen, Wegen oder Plätzen;3101000;Braunschweig;W;3;0;0;0;0;0;0;0;0;0;2;2;0;0;0;1;0;0;0;0;1
217000;Sonstige Raubüberfälle auf Straßen, Wegen oder Plätzen;3101000;Braunschweig;X;60;0;0;0;0;0;0;3;9;12;17;29;4;6;10;11;6;3;1;0;31
217000;Sonstige Raubüberfälle auf Straßen, Wegen oder Plätzen;4011000;Bremen;M;144;0;0;0;5;1;6;15;33;48;27;81;14;13;27;11;16;5;4;0;63
217000;Sonstige Raubüberfälle auf Straßen, Wegen oder Plätzen;4011000;Bremen;W;6;0;0;0;0;0;0;1;0;1;0;1;0;1;1;0;2;1;1;0;5
217000;Sonstige Raubüberfälle auf Straßen, Wegen oder Plätzen;4011000;Bremen;X;150;0;0;0;5;1;6;16;33;49;27;82;14;14;28;11;18;6;5;0;68
217000;Sonstige Raubüberfälle auf Straßen, Wegen oder Plätzen;4012000;Bremerhaven;M;35;0;0;0;0;0;0;1;3;4;7;11;1;7;8;4;6;3;2;1;24
217000;Sonstige Raubüberfälle auf Straßen, Wegen oder Plätzen;4012000;Bremerhaven;W;2;0;0;0;0;0;0;0;0;0;2;2;0;0;0;0;0;0;0;0;0
217000;Sonstige Raubüberfälle auf Straßen, Wegen oder Plätzen;4012000;Bremerhaven;X;37;0;0;0;0;0;0;1;3;4;9;13;1;7;8;4;6;3;2;1;24
217000;Sonstige Raubüberfälle auf Straßen, Wegen oder Plätzen;14511000;Chemnitz;M;59;0;0;0;0;0;0;4;5;9;8;17;2;7;9;15;13;5;0;0;42
217000;Sonstige Raubüberfälle auf Straßen, Wegen oder Plätzen;14511000;Chemnitz;W;13;0;0;0;0;0;0;5;2;7;2;9;0;0;0;1;2;1;0;0;4
217000;Sonstige Raubüberfälle auf Straßen, Wegen oder Plätzen;14511000;Chemnitz;X;72;0;0;0;0;0;0;9;7;16;10;26;2;7;9;16;15;6;0;0;46
217000;Sonstige Raubüberfälle auf Straßen, Wegen oder Plätzen;6411000;Darmstadt;M;39;0;0;0;0;2;2;6;10;16;10;28;1;3;4;3;1;3;0;0;11
217000;Sonstige Raubüberfälle auf Straßen, Wegen oder Plätzen;6411000;Darmstadt;W;2;0;0;0;0;0;0;0;1;1;0;1;0;0;0;1;0;0;0;0;1
217000;Sonstige Raubüberfälle auf Straßen, Wegen oder Plätzen;6411000;Darmstadt;X;41;0;0;0;0;2;2;6;11;17;10;29;1;3;4;4;1;3;0;0;12
217000;Sonstige Raubüberfälle auf Straßen, Wegen oder Plätzen;5913000;Dortmund;M;288;0;1;2;6;7;16;23;55;78;59;153;33;23;56;38;31;9;1;0;135
217000;Sonstige Raubüberfälle auf Straßen, Wegen oder Plätzen;5913000;Dortmund;W;20;0;0;2;0;0;2;2;5;7;4;13;0;0;0;0;3;1;3;0;7
217000;Sonstige Raubüberfälle auf Straßen, Wegen oder Plätzen;5913000;Dortmund;X;308;0;1;4;6;7;18;25;60;85;63;166;33;23;56;38;34;10;4;0;142
217000;Sonstige Raubüberfälle auf Straßen, Wegen oder Plätzen;14612000;Dresden;M;92;0;0;0;0;3;3;6;7;13;14;30;9;8;17;12;20;11;2;0;62
217000;Sonstige Raubüberfälle auf Straßen, Wegen oder Plätzen;14612000;Dresden;W;2;0;0;0;0;0;0;0;0;0;1;1;0;0;0;1;0;0;0;0;1
217000;Sonstige Raubüberfälle auf Straßen, Wegen oder Plätzen;14612000;Dresden;X;94;0;0;0;0;3;3;6;7;13;15;31;9;8;17;13;20;11;2;0;63
217000;Sonstige Raubüberfälle auf Straßen, Wegen oder Plätzen;5112000;Duisburg;M;133;0;0;0;2;15;17;20;29;49;29;95;9;1;10;13;10;4;0;1;38
217000;Sonstige Raubüberfälle auf Straßen, Wegen oder Plätzen;5112000;Duisburg;W;11;0;0;0;0;2;2;2;0;2;1;5;0;0;0;0;4;2;0;0;6
217000;Sonstige Raubüberfälle auf Straßen, Wegen oder Plätzen;5112000;Duisburg;X;144;0;0;0;2;17;19;22;29;51;30;100;9;1;10;13;14;6;0;1;44
217000;Sonstige Raubüberfälle auf Straßen, Wegen oder Plätzen;5111000;Düsseldorf;M;197;0;0;0;3;7;10;22;29;51;41;102;20;13;33;22;23;15;2;0;95
217000;Sonstige Raubüberfälle auf Straßen, Wegen oder Plätzen;5111000;Düsseldorf;W;16;0;0;0;0;5;5;2;3;5;1;11;0;1;1;1;3;0;0;0;5
217000;Sonstige Raubüberfälle auf Straßen, Wegen oder Plätzen;5111000;Düsseldorf;X;213;0;0;0;3;12;15;24;32;56;42;113;20;14;34;23;26;15;2;0;100
217000;Sonstige Raubüberfälle auf Straßen, Wegen oder Plätzen;16051000;Erfurt;M;17;0;0;0;0;1;1;1;5;6;4;11;2;1;3;2;1;0;0;0;6
217000;Sonstige Raubüberfälle auf Straßen, Wegen oder Plätzen;16051000;Erfurt;W;0;0;0;0;0;0;0;0;0;0;0;0;0;0;0;0;0;0;0;0;0
217000;Sonstige Raubüberfälle auf Straßen, Wegen oder Plätzen;16051000;Erfurt;X;17;0;0;0;0;1;1;1;5;6;4;11;2;1;3;2;1;0;0;0;6
217000;Sonstige Raubüberfälle auf Straßen, Wegen oder Plätzen;9562000;Erlangen;M;3;0;0;0;0;0;0;0;2;2;0;2;0;0;0;0;1;0;0;0;1
217000;Sonstige Raubüberfälle auf Straßen, Wegen oder Plätzen;9562000;Erlangen;W;0;0;0;0;0;0;0;0;0;0;0;0;0;0;0;0;0;0;0;0;0
217000;Sonstige Raubüberfälle auf Straßen, Wegen oder Plätzen;9562000;Erlangen;X;3;0;0;0;0;0;0;0;2;2;0;2;0;0;0;0;1;0;0;0;1
217000;Sonstige Raubüberfälle auf Straßen, Wegen oder Plätzen;5113000;Essen;M;191;0;0;1;1;13;15;32;39;71;32;118;16;6;22;19;16;13;2;1;73
217000;Sonstige Raubüberfälle auf Straßen, Wegen oder Plätzen;5113000;Essen;W;17;0;0;0;0;3;3;2;4;6;1;10;0;1;1;1;4;1;0;0;7
217000;Sonstige Raubüberfälle auf Straßen, Wegen oder Plätzen;5113000;Essen;X;208;0;0;1;1;16;18;34;43;77;33;128;16;7;23;20;20;14;2;1;80
217000;Sonstige Raubüberfälle auf Straßen, Wegen oder Plätzen;6412000;Frankfurt am Main;M;269;0;0;1;1;7;9;19;54;73;52;134;21;13;34;39;36;22;2;2;135
217000;Sonstige Raubüberfälle auf Straßen, Wegen oder Plätzen;6412000;Frankfurt am Main;W;22;0;0;0;0;1;1;3;2;5;3;9;2;0;2;2;6;3;0;0;13
217000;Sonstige Raubüberfälle auf Straßen, Wegen oder Plätzen;6412000;Frankfurt am Main;X;291;0;0;1;1;8;10;22;56;78;55;143;23;13;36;41;42;25;2;2;148
217000;Sonstige Raubüberfälle auf Straßen, Wegen oder Plätzen;8311000;Freiburg im Breisgau;M;45;0;0;0;0;1;1;8;12;20;7;28;6;3;9;3;3;2;0;0;17
217000;Sonstige Raubüberfälle auf Straßen, Wegen oder Plätzen;8311000;Freiburg im Breisgau;W;0;0;0;0;0;0;0;0;0;0;0;0;0;0;0;0;0;0;0;0;0
217000;Sonstige Raubüberfälle auf Straßen, Wegen oder Plätzen;8311000;Freiburg im Breisgau;X;45;0;0;0;0;1;1;8;12;20;7;28;6;3;9;3;3;2;0;0;17
217000;Sonstige Raubüberfälle auf Straßen, Wegen oder Plätzen;9563000;Fürth;M;4;0;0;0;0;0;0;1;1;2;0;2;0;0;0;0;0;1;0;1;2
217000;Sonstige Raubüberfälle auf Straßen, Wegen oder Plätzen;9563000;Fürth;W;2;0;0;0;0;0;0;0;0;0;2;2;0;0;0;0;0;0;0;0;0
217000;Sonstige Raubüberfälle auf Straßen, Wegen oder Plätzen;9563000;Fürth;X;6;0;0;0;0;0;0;1;1;2;2;4;0;0;0;0;0;1;0;1;2
217000;Sonstige Raubüberfälle auf Straßen, Wegen oder Plätzen;5513000;Gelsenkirchen;M;72;0;0;1;2;8;11;17;17;34;13;58;3;2;5;5;3;1;0;0;14
217000;Sonstige Raubüberfälle auf Straßen, Wegen oder Plätzen;5513000;Gelsenkirchen;W;4;0;0;0;0;0;0;1;0;1;0;1;0;0;0;1;2;0;0;0;3
217000;Sonstige Raubüberfälle auf Straßen, Wegen oder Plätzen;5513000;Gelsenkirchen;X;76;0;0;1;2;8;11;18;17;35;13;59;3;2;5;6;5;1;0;0;17
217000;Sonstige Raubüberfälle auf Straßen, Wegen oder Plätzen;3152012;Göttingen;M;18;0;0;0;0;1;1;2;1;3;5;9;1;2;3;3;3;0;0;0;9
217000;Sonstige Raubüberfälle auf Straßen, Wegen oder Plätzen;3152012;Göttingen;W;4;0;0;0;0;0;0;0;0;0;1;1;0;0;0;1;2;0;0;0;3
217000;Sonstige Raubüberfälle auf Straßen, Wegen oder Plätzen;3152012;Göttingen;X;22;0;0;0;0;1;1;2;1;3;6;10;1;2;3;4;5;0;0;0;12
217000;Sonstige Raubüberfälle auf Straßen, Wegen oder Plätzen;5914000;Hagen;M;53;0;0;0;0;1;1;3;18;21;10;32;6;5;11;5;4;1;0;0;21
217000;Sonstige Raubüberfälle auf Straßen, Wegen oder Plätzen;5914000;Hagen;W;1;0;0;0;0;0;0;0;0;0;0;0;0;0;0;0;0;1;0;0;1
217000;Sonstige Raubüberfälle auf Straßen, Wegen oder Plätzen;5914000;Hagen;X;54;0;0;0;0;1;1;3;18;21;10;32;6;5;11;5;4;2;0;0;22
217000;Sonstige Raubüberfälle auf Straßen, Wegen oder Plätzen;15002000;Halle (Saale);M;97;0;0;3;1;1;5;8;12;20;31;56;10;8;18;11;9;3;0;0;41
217000;Sonstige Raubüberfälle auf Straßen, Wegen oder Plätzen;15002000;Halle (Saale);W;2;0;0;0;0;0;0;0;0;0;0;0;1;1;2;0;0;0;0;0;2
217000;Sonstige Raubüberfälle auf Straßen, Wegen oder Plätzen;15002000;Halle (Saale);X;99;0;0;3;1;1;5;8;12;20;31;56;11;9;20;11;9;3;0;0;43
217000;Sonstige Raubüberfälle auf Straßen, Wegen oder Plätzen;2000000;Hamburg;M;697;0;0;4;5;27;36;84;143;227;150;413;50;44;94;65;88;28;8;1;284
217000;Sonstige Raubüberfälle auf Straßen, Wegen oder Plätzen;2000000;Hamburg;W;44;0;0;0;0;3;3;9;4;13;7;23;2;0;2;6;10;1;2;0;21
217000;Sonstige Raubüberfälle auf Straßen, Wegen oder Plätzen;2000000;Hamburg;X;741;0;0;4;5;30;39;93;147;240;157;436;52;44;96;71;98;29;10;1;305
217000;Sonstige Raubüberfälle auf Straßen, Wegen oder Plätzen;5915000;Hamm;M;50;0;0;0;3;2;5;5;9;14;16;35;4;5;9;3;2;1;0;0;15
217000;Sonstige Raubüberfälle auf Straßen, Wegen oder Plätzen;5915000;Hamm;W;5;0;0;0;0;0;0;0;4;4;0;4;0;0;0;1;0;0;0;0;1
217000;Sonstige Raubüberfälle auf Straßen, Wegen oder Plätzen;5915000;Hamm;X;55;0;0;0;3;2;5;5;13;18;16;39;4;5;9;4;2;1;0;0;16
217000;Sonstige Raubüberfälle auf Straßen, Wegen oder Plätzen;3241001;Hannover;M;144;0;0;0;1;6;7;17;19;36;32;75;10;12;22;17;22;4;3;1;69
217000;Sonstige Raubüberfälle auf Straßen, Wegen oder Plätzen;3241001;Hannover;W;5;0;0;0;0;1;1;0;0;0;1;2;0;1;1;0;1;0;1;0;3
217000;Sonstige Raubüberfälle auf Straßen, Wegen oder Plätzen;3241001;Hannover;X;149;0;0;0;1;7;8;17;19;36;33;77;10;13;23;17;23;4;4;1;72
217000;Sonstige Raubüberfälle auf Straßen, Wegen oder Plätzen;8221000;Heidelberg;M;9;0;0;0;0;0;0;1;1;2;3;5;0;0;0;1;1;1;1;0;4
217000;Sonstige Raubüberfälle auf Straßen, Wegen oder Plätzen;8221000;Heidelberg;W;0;0;0;0;0;0;0;0;0;0;0;0;0;0;0;0;0;0;0;0;0
217000;Sonstige Raubüberfälle auf Straßen, Wegen oder Plätzen;8221000;Heidelberg;X;9;0;0;0;0;0;0;1;1;2;3;5;0;0;0;1;1;1;1;0;4
217000;Sonstige Raubüberfälle auf Straßen, Wegen oder Plätzen;8121000;Heilbronn;M;17;0;0;0;0;0;0;2;4;6;1;7;2;2;4;4;2;0;0;0;10
217000;Sonstige Raubüberfälle auf Straßen, Wegen oder Plätzen;8121000;Heilbronn;W;2;0;0;0;0;0;0;0;1;1;0;1;0;1;1;0;0;0;0;0;1
217000;Sonstige Raubüberfälle auf Straßen, Wegen oder Plätzen;8121000;Heilbronn;X;19;0;0;0;0;0;0;2;5;7;1;8;2;3;5;4;2;0;0;0;11
217000;Sonstige Raubüberfälle auf Straßen, Wegen oder Plätzen;5916000;Herne;M;38;0;0;0;1;2;3;10;7;17;6;26;0;2;2;4;4;2;0;0;12
217000;Sonstige Raubüberfälle auf Straßen, Wegen oder Plätzen;5916000;Herne;W;2;0;0;0;0;0;0;0;2;2;0;2;0;0;0;0;0;0;0;0;0
217000;Sonstige Raubüberfälle auf Straßen, Wegen oder Plätzen;5916000;Herne;X;40;0;0;0;1;2;3;10;9;19;6;28;0;2;2;4;4;2;0;0;12
217000;Sonstige Raubüberfälle auf Straßen, Wegen oder Plätzen;9161000;Ingolstadt;M;3;0;0;0;0;0;0;0;1;1;1;2;0;0;0;1;0;0;0;0;1
217000;Sonstige Raubüberfälle auf Straßen, Wegen oder Plätzen;9161000;Ingolstadt;W;0;0;0;0;0;0;0;0;0;0;0;0;0;0;0;0;0;0;0;0;0
217000;Sonstige Raubüberfälle auf Straßen, Wegen oder Plätzen;9161000;Ingolstadt;X;3;0;0;0;0;0;0;0;1;1;1;2;0;0;0;1;0;0;0;0;1
217000;Sonstige Raubüberfälle auf Straßen, Wegen oder Plätzen;16053000;Jena;M;3;0;0;0;0;0;0;1;1;2;0;2;0;0;0;1;0;0;0;0;1
217000;Sonstige Raubüberfälle auf Straßen, Wegen oder Plätzen;16053000;Jena;W;0;0;0;0;0;0;0;0;0;0;0;0;0;0;0;0;0;0;0;0;0
217000;Sonstige Raubüberfälle auf Straßen, Wegen oder Plätzen;16053000;Jena;X;3;0;0;0;0;0;0;1;1;2;0;2;0;0;0;1;0;0;0;0;1
217000;Sonstige Raubüberfälle auf Straßen, Wegen oder Plätzen;8212000;Karlsruhe;M;60;0;0;0;0;0;0;1;22;23;9;32;4;1;5;9;10;2;2;0;28
217000;Sonstige Raubüberfälle auf Straßen, Wegen oder Plätzen;8212000;Karlsruhe;W;13;0;0;0;0;0;0;5;4;9;1;10;1;0;1;0;1;1;0;0;3
217000;Sonstige Raubüberfälle auf Straßen, Wegen oder Plätzen;8212000;Karlsruhe;X;73;0;0;0;0;0;0;6;26;32;10;42;5;1;6;9;11;3;2;0;31
217000;Sonstige Raubüberfälle auf Straßen, Wegen oder Plätzen;6611000;Kassel;M;49;0;0;0;0;1;1;3;12;15;8;24;4;2;6;8;6;5;0;0;25
217000;Sonstige Raubüberfälle auf Straßen, Wegen oder Plätzen;6611000;Kassel;W;9;0;0;0;0;1;1;0;1;1;2;4;0;1;1;1;2;1;0;0;5
217000;Sonstige Raubüberfälle auf Straßen, Wegen oder Plätzen;6611000;Kassel;X;58;0;0;0;0;2;2;3;13;16;10;28;4;3;7;9;8;6;0;0;30
217000;Sonstige Raubüberfälle auf Straßen, Wegen oder Plätzen;1002000;Kiel;M;70;0;0;0;0;0;0;4;6;10;27;37;5;6;11;10;9;2;0;1;33
217000;Sonstige Raubüberfälle auf Straßen, Wegen oder Plätzen;1002000;Kiel;W;8;0;0;0;0;0;0;0;1;1;2;3;0;0;0;2;2;0;0;1;5
217000;Sonstige Raubüberfälle auf Straßen, Wegen oder Plätzen;1002000;Kiel;X;78;0;0;0;0;0;0;4;7;11;29;40;5;6;11;12;11;2;0;2;38
217000;Sonstige Raubüberfälle auf Straßen, Wegen oder Plätzen;7111000;Koblenz;M;18;0;0;0;0;1;1;5;2;7;1;9;1;3;4;2;2;0;1;0;9
217000;Sonstige Raubüberfälle auf Straßen, Wegen oder Plätzen;7111000;Koblenz;W;0;0;0;0;0;0;0;0;0;0;0;0;0;0;0;0;0;0;0;0;0
217000;Sonstige Raubüberfälle auf Straßen, Wegen oder Plätzen;7111000;Koblenz;X;18;0;0;0;0;1;1;5;2;7;1;9;1;3;4;2;2;0;1;0;9
217000;Sonstige Raubüberfälle auf Straßen, Wegen oder Plätzen;5315000;Köln;M;367;0;0;0;3;16;19;30;89;119;74;212;29;20;49;39;43;19;4;1;155
217000;Sonstige Raubüberfälle auf Straßen, Wegen oder Plätzen;5315000;Köln;W;24;0;0;0;0;1;1;9;5;14;1;16;0;2;2;2;4;0;0;0;8
217000;Sonstige Raubüberfälle auf Straßen, Wegen oder Plätzen;5315000;Köln;X;391;0;0;0;3;17;20;39;94;133;75;228;29;22;51;41;47;19;4;1;163
217000;Sonstige Raubüberfälle auf Straßen, Wegen oder Plätzen;5114000;Krefeld;M;46;0;0;0;0;0;0;2;11;13;7;20;8;3;11;4;6;1;4;0;26
217000;Sonstige Raubüberfälle auf Straßen, Wegen oder Plätzen;5114000;Krefeld;W;3;0;0;0;0;0;0;0;0;0;0;0;0;0;0;2;0;1;0;0;3
217000;Sonstige Raubüberfälle auf Straßen, Wegen oder Plätzen;5114000;Krefeld;X;49;0;0;0;0;0;0;2;11;13;7;20;8;3;11;6;6;2;4;0;29
217000;Sonstige Raubüberfälle auf Straßen, Wegen oder Plätzen;14713000;Leipzig;M;141;0;0;0;2;6;8;8;15;23;27;58;15;21;36;20;19;7;0;1;83
217000;Sonstige Raubüberfälle auf Straßen, Wegen oder Plätzen;14713000;Leipzig;W;10;0;0;0;0;0;0;4;1;5;0;5;0;1;1;2;2;0;0;0;5
217000;Sonstige Raubüberfälle auf Straßen, Wegen oder Plätzen;14713000;Leipzig;X;151;0;0;0;2;6;8;12;16;28;27;63;15;22;37;22;21;7;0;1;88
217000;Sonstige Raubüberfälle auf Straßen, Wegen oder Plätzen;5316000;Leverkusen;M;43;0;0;0;0;0;0;2;7;9;10;19;10;2;12;6;4;0;2;0;24
217000;Sonstige Raubüberfälle auf Straßen, Wegen oder Plätzen;5316000;Leverkusen;W;5;0;0;0;0;0;0;1;1;2;1;3;1;0;1;0;0;1;0;0;2
217000;Sonstige Raubüberfälle auf Straßen, Wegen oder Plätzen;5316000;Leverkusen;X;48;0;0;0;0;0;0;3;8;11;11;22;11;2;13;6;4;1;2;0;26
217000;Sonstige Raubüberfälle auf Straßen, Wegen oder Plätzen;1003000;Lübeck;M;41;0;0;0;0;1;1;3;6;9;9;19;4;8;12;2;5;2;1;0;22
217000;Sonstige Raubüberfälle auf Straßen, Wegen oder Plätzen;1003000;Lübeck;W;3;0;0;0;0;0;0;0;2;2;0;2;0;0;0;1;0;0;0;0;1
217000;Sonstige Raubüberfälle auf Straßen, Wegen oder Plätzen;1003000;Lübeck;X;44;0;0;0;0;1;1;3;8;11;9;21;4;8;12;3;5;2;1;0;23
217000;Sonstige Raubüberfälle auf Straßen, Wegen oder Plätzen;7314000;Ludwigshafen am Rhein;M;42;0;0;2;0;1;3;4;10;14;8;25;4;2;6;7;3;0;0;1;17
217000;Sonstige Raubüberfälle auf Straßen, Wegen oder Plätzen;7314000;Ludwigshafen am Rhein;W;7;0;0;0;0;0;0;1;1;2;0;2;2;0;2;1;1;1;0;0;5
217000;Sonstige Raubüberfälle auf Straßen, Wegen oder Plätzen;7314000;Ludwigshafen am Rhein;X;49;0;0;2;0;1;3;5;11;16;8;27;6;2;8;8;4;1;0;1;22
217000;Sonstige Raubüberfälle auf Straßen, Wegen oder Plätzen;15003000;Magdeburg;M;79;0;0;0;0;3;3;10;14;24;23;50;12;3;15;7;5;1;1;0;29
217000;Sonstige Raubüberfälle auf Straßen, Wegen oder Plätzen;15003000;Magdeburg;W;10;0;0;0;0;2;2;1;1;2;2;6;1;0;1;1;2;0;0;0;4
217000;Sonstige Raubüberfälle auf Straßen, Wegen oder Plätzen;15003000;Magdeburg;X;89;0;0;0;0;5;5;11;15;26;25;56;13;3;16;8;7;1;1;0;33
217000;Sonstige Raubüberfälle auf Straßen, Wegen oder Plätzen;7315000;Mainz;M;46;0;0;0;0;0;0;8;7;15;15;30;2;1;3;4;3;5;1;0;16
217000;Sonstige Raubüberfälle auf Straßen, Wegen oder Plätzen;7315000;Mainz;W;1;0;0;0;0;0;0;0;0;0;0;0;0;0;0;1;0;0;0;0;1
217000;Sonstige Raubüberfälle auf Straßen, Wegen oder Plätzen;7315000;Mainz;X;47;0;0;0;0;0;0;8;7;15;15;30;2;1;3;5;3;5;1;0;17
217000;Sonstige Raubüberfälle auf Straßen, Wegen oder Plätzen;8222000;Mannheim;M;63;0;0;0;1;1;2;12;17;29;14;45;2;2;4;7;5;2;0;0;18
217000;Sonstige Raubüberfälle auf Straßen, Wegen oder Plätzen;8222000;Mannheim;W;4;0;0;0;0;0;0;1;1;2;0;2;0;1;1;0;0;1;0;0;2
217000;Sonstige Raubüberfälle auf Straßen, Wegen oder Plätzen;8222000;Mannheim;X;67;0;0;0;1;1;2;13;18;31;14;47;2;3;5;7;5;3;0;0;20
217000;Sonstige Raubüberfälle auf Straßen, Wegen oder Plätzen;5170024;Moers;M;23;0;0;0;1;0;1;0;7;7;6;14;1;2;3;3;2;1;0;0;9
217000;Sonstige Raubüberfälle auf Straßen, Wegen oder Plätzen;5170024;Moers;W;0;0;0;0;0;0;0;0;0;0;0;0;0;0;0;0;0;0;0;0;0
217000;Sonstige Raubüberfälle auf Straßen, Wegen oder Plätzen;5170024;Moers;X;23;0;0;0;1;0;1;0;7;7;6;14;1;2;3;3;2;1;0;0;9
217000;Sonstige Raubüberfälle auf Straßen, Wegen oder Plätzen;5116000;Mönchengladbach;M;87;0;0;0;1;1;2;5;16;21;21;44;9;9;18;11;11;3;0;0;43
217000;Sonstige Raubüberfälle auf Straßen, Wegen oder Plätzen;5116000;Mönchengladbach;W;4;0;0;0;0;0;0;1;0;1;1;2;0;1;1;1;0;0;0;0;2
217000;Sonstige Raubüberfälle auf Straßen, Wegen oder Plätzen;5116000;Mönchengladbach;X;91;0;0;0;1;1;2;6;16;22;22;46;9;10;19;12;11;3;0;0;45
217000;Sonstige Raubüberfälle auf Straßen, Wegen oder Plätzen;5117000;Mülheim an der Ruhr;M;39;0;0;0;0;2;2;6;10;16;9;27;2;3;5;4;1;1;0;1;12
217000;Sonstige Raubüberfälle auf Straßen, Wegen oder Plätzen;5117000;Mülheim an der Ruhr;W;4;0;0;0;0;0;0;1;0;1;0;1;0;2;2;0;0;0;1;0;3
217000;Sonstige Raubüberfälle auf Straßen, Wegen oder Plätzen;5117000;Mülheim an der Ruhr;X;43;0;0;0;0;2;2;7;10;17;9;28;2;5;7;4;1;1;1;1;15
217000;Sonstige Raubüberfälle auf Straßen, Wegen oder Plätzen;9162000;München;M;124;0;0;0;0;6;6;11;32;43;27;76;10;9;19;10;11;7;1;0;48
217000;Sonstige Raubüberfälle auf Straßen, Wegen oder Plätzen;9162000;München;W;11;0;0;0;0;1;1;3;3;6;0;7;0;0;0;1;3;0;0;0;4
217000;Sonstige Raubüberfälle auf Straßen, Wegen oder Plätzen;9162000;München;X;135;0;0;0;0;7;7;14;35;49;27;83;10;9;19;11;14;7;1;0;52
217000;Sonstige Raubüberfälle auf Straßen, Wegen oder Plätzen;5515000;Münster;M;73;0;0;0;0;7;7;6;15;21;11;39;9;3;12;8;7;6;1;0;34
217000;Sonstige Raubüberfälle auf Straßen, Wegen oder Plätzen;5515000;Münster;W;2;0;0;0;0;0;0;0;0;0;0;0;0;0;0;2;0;0;0;0;2
217000;Sonstige Raubüberfälle auf Straßen, Wegen oder Plätzen;5515000;Münster;X;75;0;0;0;0;7;7;6;15;21;11;39;9;3;12;10;7;6;1;0;36
217000;Sonstige Raubüberfälle auf Straßen, Wegen oder Plätzen;5162024;Neuss;M;29;0;0;0;0;0;0;3;6;9;9;18;1;0;1;1;6;3;0;0;11
217000;Sonstige Raubüberfälle auf Straßen, Wegen oder Plätzen;5162024;Neuss;W;2;0;0;0;0;0;0;1;0;1;1;2;0;0;0;0;0;0;0;0;0
217000;Sonstige Raubüberfälle auf Straßen, Wegen oder Plätzen;5162024;Neuss;X;31;0;0;0;0;0;0;4;6;10;10;20;1;0;1;1;6;3;0;0;11
217000;Sonstige Raubüberfälle auf Straßen, Wegen oder Plätzen;9564000;Nürnberg;M;90;0;0;0;0;1;1;6;8;14;27;42;11;11;22;13;7;4;1;1;48
217000;Sonstige Raubüberfälle auf Straßen, Wegen oder Plätzen;9564000;Nürnberg;W;5;0;0;0;0;0;0;0;0;0;3;3;1;0;1;1;0;0;0;0;2
217000;Sonstige Raubüberfälle auf Straßen, Wegen oder Plätzen;9564000;Nürnberg;X;95;0;0;0;0;1;1;6;8;14;30;45;12;11;23;14;7;4;1;1;50
217000;Sonstige Raubüberfälle auf Straßen, Wegen oder Plätzen;5119000;Oberhausen;M;62;0;0;0;0;0;0;8;15;23;20;43;4;3;7;6;4;1;1;0;19
217000;Sonstige Raubüberfälle auf Straßen, Wegen oder Plätzen;5119000;Oberhausen;W;6;0;0;0;0;1;1;2;1;3;1;5;0;1;1;0;0;0;0;0;1
217000;Sonstige Raubüberfälle auf Straßen, Wegen oder Plätzen;5119000;Oberhausen;X;68;0;0;0;0;1;1;10;16;26;21;48;4;4;8;6;4;1;1;0;20
217000;Sonstige Raubüberfälle auf Straßen, Wegen oder Plätzen;6413000;Offenbach am Main;M;61;0;0;0;0;3;3;9;17;26;14;43;4;2;6;5;4;1;1;1;18
217000;Sonstige Raubüberfälle auf Straßen, Wegen oder Plätzen;6413000;Offenbach am Main;W;3;0;0;0;0;0;0;0;1;1;0;1;0;0;0;1;1;0;0;0;2
217000;Sonstige Raubüberfälle auf Straßen, Wegen oder Plätzen;6413000;Offenbach am Main;X;64;0;0;0;0;3;3;9;18;27;14;44;4;2;6;6;5;1;1;1;20
217000;Sonstige Raubüberfälle auf Straßen, Wegen oder Plätzen;3403000;Oldenburg (Oldenburg);M;23;0;0;0;0;3;3;2;4;6;4;13;0;2;2;4;2;2;0;0;10
217000;Sonstige Raubüberfälle auf Straßen, Wegen oder Plätzen;3403000;Oldenburg (Oldenburg);W;0;0;0;0;0;0;0;0;0;0;0;0;0;0;0;0;0;0;0;0;0
217000;Sonstige Raubüberfälle auf Straßen, Wegen oder Plätzen;3403000;Oldenburg (Oldenburg);X;23;0;0;0;0;3;3;2;4;6;4;13;0;2;2;4;2;2;0;0;10
217000;Sonstige Raubüberfälle auf Straßen, Wegen oder Plätzen;3404000;Osnabrück;M;31;0;0;0;0;0;0;2;1;3;9;12;4;3;7;6;3;1;1;1;19
217000;Sonstige Raubüberfälle auf Straßen, Wegen oder Plätzen;3404000;Osnabrück;W;6;0;0;0;0;0;0;1;2;3;0;3;0;0;0;2;0;1;0;0;3
217000;Sonstige Raubüberfälle auf Straßen, Wegen oder Plätzen;3404000;Osnabrück;X;37;0;0;0;0;0;0;3;3;6;9;15;4;3;7;8;3;2;1;1;22
217000;Sonstige Raubüberfälle auf Straßen, Wegen oder Plätzen;5774032;Paderborn;M;33;0;0;0;0;3;3;1;8;9;7;19;4;3;7;2;4;1;0;0;14
217000;Sonstige Raubüberfälle auf Straßen, Wegen oder Plätzen;5774032;Paderborn;W;0;0;0;0;0;0;0;0;0;0;0;0;0;0;0;0;0;0;0;0;0
217000;Sonstige Raubüberfälle auf Straßen, Wegen oder Plätzen;5774032;Paderborn;X;33;0;0;0;0;3;3;1;8;9;7;19;4;3;7;2;4;1;0;0;14
217000;Sonstige Raubüberfälle auf Straßen, Wegen oder Plätzen;8231000;Pforzheim;M;23;0;0;0;0;1;1;3;6;9;5;15;2;1;3;2;3;0;0;0;8
217000;Sonstige Raubüberfälle auf Straßen, Wegen oder Plätzen;8231000;Pforzheim;W;1;0;0;0;0;0;0;0;0;0;0;0;1;0;1;0;0;0;0;0;1
217000;Sonstige Raubüberfälle auf Straßen, Wegen oder Plätzen;8231000;Pforzheim;X;24;0;0;0;0;1;1;3;6;9;5;15;3;1;4;2;3;0;0;0;9
217000;Sonstige Raubüberfälle auf Straßen, Wegen oder Plätzen;12054000;Potsdam;M;31;0;0;0;0;1;1;5;9;14;9;24;1;3;4;0;3;0;0;0;7
217000;Sonstige Raubüberfälle auf Straßen, Wegen oder Plätzen;12054000;Potsdam;W;2;0;0;0;0;0;0;0;0;0;0;0;0;2;2;0;0;0;0;0;2
217000;Sonstige Raubüberfälle auf Straßen, Wegen oder Plätzen;12054000;Potsdam;X;33;0;0;0;0;1;1;5;9;14;9;24;1;5;6;0;3;0;0;0;9
217000;Sonstige Raubüberfälle auf Straßen, Wegen oder Plätzen;5562032;Recklinghausen;M;49;0;0;0;0;0;0;11;12;23;20;43;2;1;3;1;0;2;0;0;6
217000;Sonstige Raubüberfälle auf Straßen, Wegen oder Plätzen;5562032;Recklinghausen;W;4;0;0;0;0;0;0;1;3;4;0;4;0;0;0;0;0;0;0;0;0
217000;Sonstige Raubüberfälle auf Straßen, Wegen oder Plätzen;5562032;Recklinghausen;X;53;0;0;0;0;0;0;12;15;27;20;47;2;1;3;1;0;2;0;0;6
217000;Sonstige Raubüberfälle auf Straßen, Wegen oder Plätzen;9362000;Regensburg;M;15;0;0;0;0;0;0;0;2;2;2;4;2;2;4;1;3;3;0;0;11
217000;Sonstige Raubüberfälle auf Straßen, Wegen oder Plätzen;9362000;Regensburg;W;2;0;0;0;0;0;0;0;0;0;1;1;0;0;0;0;1;0;0;0;1
217000;Sonstige Raubüberfälle auf Straßen, Wegen oder Plätzen;9362000;Regensburg;X;17;0;0;0;0;0;0;0;2;2;3;5;2;2;4;1;4;3;0;0;12
217000;Sonstige Raubüberfälle auf Straßen, Wegen oder Plätzen;5120000;Remscheid;M;18;0;0;0;0;0;0;1;5;6;1;7;1;2;3;2;2;2;2;0;11
217000;Sonstige Raubüberfälle auf Straßen, Wegen oder Plätzen;5120000;Remscheid;W;1;0;0;0;0;0;0;0;0;0;0;0;0;0;0;0;0;1;0;0;1
217000;Sonstige Raubüberfälle auf Straßen, Wegen oder Plätzen;5120000;Remscheid;X;19;0;0;0;0;0;0;1;5;6;1;7;1;2;3;2;2;3;2;0;12
217000;Sonstige Raubüberfälle auf Straßen, Wegen oder Plätzen;8415061;Reutlingen;M;10;0;0;0;0;0;0;0;2;2;3;5;2;2;4;0;1;0;0;0;5
217000;Sonstige Raubüberfälle auf Straßen, Wegen oder Plätzen;8415061;Reutlingen;W;0;0;0;0;0;0;0;0;0;0;0;0;0;0;0;0;0;0;0;0;0
217000;Sonstige Raubüberfälle auf Straßen, Wegen oder Plätzen;8415061;Reutlingen;X;10;0;0;0;0;0;0;0;2;2;3;5;2;2;4;0;1;0;0;0;5
217000;Sonstige Raubüberfälle auf Straßen, Wegen oder Plätzen;13003000;Rostock;M;45;0;0;1;3;1;5;4;9;13;3;21;1;4;5;4;13;2;0;0;24
217000;Sonstige Raubüberfälle auf Straßen, Wegen oder Plätzen;13003000;Rostock;W;7;0;0;0;0;1;1;0;1;1;1;3;0;0;0;2;2;0;0;0;4
217000;Sonstige Raubüberfälle auf Straßen, Wegen oder Plätzen;13003000;Rostock;X;52;0;0;1;3;2;6;4;10;14;4;24;1;4;5;6;15;2;0;0;28
217000;Sonstige Raubüberfälle auf Straßen, Wegen oder Plätzen;10041100;Saarbrücken;M;72;0;0;0;0;1;1;13;23;36;15;52;5;3;8;5;5;1;1;0;20
217000;Sonstige Raubüberfälle auf Straßen, Wegen oder Plätzen;10041100;Saarbrücken;W;9;0;0;0;0;1;1;0;0;0;1;2;3;0;3;0;3;0;1;0;7
217000;Sonstige Raubüberfälle auf Straßen, Wegen oder Plätzen;10041100;Saarbrücken;X;81;0;0;0;0;2;2;13;23;36;16;54;8;3;11;5;8;1;2;0;27
217000;Sonstige Raubüberfälle auf Straßen, Wegen oder Plätzen;5122000;Solingen;M;39;0;0;0;0;0;0;5;14;19;3;22;6;3;9;5;3;0;0;0;17
217000;Sonstige Raubüberfälle auf Straßen, Wegen oder Plätzen;5122000;Solingen;W;3;0;0;0;0;0;0;0;1;1;0;1;0;0;0;0;1;1;0;0;2
217000;Sonstige Raubüberfälle auf Straßen, Wegen oder Plätzen;5122000;Solingen;X;42;0;0;0;0;0;0;5;15;20;3;23;6;3;9;5;4;1;0;0;19
217000;Sonstige Raubüberfälle auf Straßen, Wegen oder Plätzen;8111000;Stuttgart;M;92;0;0;0;1;3;4;6;18;24;17;45;11;6;17;14;13;1;2;0;47
217000;Sonstige Raubüberfälle auf Straßen, Wegen oder Plätzen;8111000;Stuttgart;W;12;0;0;0;0;0;0;4;4;8;2;10;0;0;0;1;0;1;0;0;2
217000;Sonstige Raubüberfälle auf Straßen, Wegen oder Plätzen;8111000;Stuttgart;X;104;0;0;0;1;3;4;10;22;32;19;55;11;6;17;15;13;2;2;0;49
217000;Sonstige Raubüberfälle auf Straßen, Wegen oder Plätzen;7211000;Trier;M;23;0;0;0;0;0;0;2;8;10;4;14;3;1;4;2;1;2;0;0;9
217000;Sonstige Raubüberfälle auf Straßen, Wegen oder Plätzen;7211000;Trier;W;0;0;0;0;0;0;0;0;0;0;0;0;0;0;0;0;0;0;0;0;0
217000;Sonstige Raubüberfälle auf Straßen, Wegen oder Plätzen;7211000;Trier;X;23;0;0;0;0;0;0;2;8;10;4;14;3;1;4;2;1;2;0;0;9
217000;Sonstige Raubüberfälle auf Straßen, Wegen oder Plätzen;8421000;Ulm;M;43;0;0;0;0;0;0;2;14;16;7;23;4;5;9;6;3;1;1;0;20
217000;Sonstige Raubüberfälle auf Straßen, Wegen oder Plätzen;8421000;Ulm;W;8;0;0;0;0;2;2;2;1;3;3;8;0;0;0;0;0;0;0;0;0
217000;Sonstige Raubüberfälle auf Straßen, Wegen oder Plätzen;8421000;Ulm;X;51;0;0;0;0;2;2;4;15;19;10;31;4;5;9;6;3;1;1;0;20
217000;Sonstige Raubüberfälle auf Straßen, Wegen oder Plätzen;6414000;Wiesbaden;M;64;0;0;0;0;1;1;10;16;26;20;47;2;3;5;7;2;2;1;0;17
217000;Sonstige Raubüberfälle auf Straßen, Wegen oder Plätzen;6414000;Wiesbaden;W;5;0;0;0;1;0;1;0;1;1;1;3;1;1;2;0;0;0;0;0;2
217000;Sonstige Raubüberfälle auf Straßen, Wegen oder Plätzen;6414000;Wiesbaden;X;69;0;0;0;1;1;2;10;17;27;21;50;3;4;7;7;2;2;1;0;19
217000;Sonstige Raubüberfälle auf Straßen, Wegen oder Plätzen;3103000;Wolfsburg;M;24;0;0;0;0;0;0;2;6;8;6;14;0;2;2;2;4;2;0;0;10
217000;Sonstige Raubüberfälle auf Straßen, Wegen oder Plätzen;3103000;Wolfsburg;W;1;0;0;0;0;0;0;0;1;1;0;1;0;0;0;0;0;0;0;0;0
217000;Sonstige Raubüberfälle auf Straßen, Wegen oder Plätzen;3103000;Wolfsburg;X;25;0;0;0;0;0;0;2;7;9;6;15;0;2;2;2;4;2;0;0;10
217000;Sonstige Raubüberfälle auf Straßen, Wegen oder Plätzen;5124000;Wuppertal;M;67;0;1;1;2;1;5;9;19;28;8;41;2;5;7;2;15;2;0;0;26
217000;Sonstige Raubüberfälle auf Straßen, Wegen oder Plätzen;5124000;Wuppertal;W;7;0;0;0;0;0;0;1;3;4;0;4;0;0;0;0;3;0;0;0;3
217000;Sonstige Raubüberfälle auf Straßen, Wegen oder Plätzen;5124000;Wuppertal;X;74;0;1;1;2;1;5;10;22;32;8;45;2;5;7;2;18;2;0;0;29
217000;Sonstige Raubüberfälle auf Straßen, Wegen oder Plätzen;9663000;Würzburg;M;5;0;0;0;0;0;0;0;0;0;1;1;1;1;2;0;2;0;0;0;4
217000;Sonstige Raubüberfälle auf Straßen, Wegen oder Plätzen;9663000;Würzburg;W;1;0;0;0;0;0;0;0;0;0;0;0;0;0;0;1;0;0;0;0;1
217000;Sonstige Raubüberfälle auf Straßen, Wegen oder Plätzen;9663000;Würzburg;X;6;0;0;0;0;0;0;0;0;0;1;1;1;1;2;1;2;0;0;0;5
219000;Raubüberfälle in Wohnungen;5334002;Aachen;M;17;0;0;0;0;0;0;1;1;2;3;5;0;2;2;1;6;2;1;0;12
219000;Raubüberfälle in Wohnungen;5334002;Aachen;W;1;0;0;0;0;0;0;0;0;0;0;0;0;0;0;0;1;0;0;0;1
219000;Raubüberfälle in Wohnungen;5334002;Aachen;X;18;0;0;0;0;0;0;1;1;2;3;5;0;2;2;1;7;2;1;0;13
219000;Raubüberfälle in Wohnungen;9761000;Augsburg;M;2;0;0;0;0;0;0;1;0;1;0;1;0;0;0;0;1;0;0;0;1
219000;Raubüberfälle in Wohnungen;9761000;Augsburg;W;0;0;0;0;0;0;0;0;0;0;0;0;0;0;0;0;0;0;0;0;0
219000;Raubüberfälle in Wohnungen;9761000;Augsburg;X;2;0;0;0;0;0;0;1;0;1;0;1;0;0;0;0;1;0;0;0;1
219000;Raubüberfälle in Wohnungen;5378004;Bergisch Gladbach;M;2;0;0;0;0;0;0;0;0;0;1;1;0;0;0;0;1;0;0;0;1
219000;Raubüberfälle in Wohnungen;5378004;Bergisch Gladbach;W;0;0;0;0;0;0;0;0;0;0;0;0;0;0;0;0;0;0;0;0;0
219000;Raubüberfälle in Wohnungen;5378004;Bergisch Gladbach;X;2;0;0;0;0;0;0;0;0;0;1;1;0;0;0;0;1;0;0;0;1
219000;Raubüberfälle in Wohnungen;11000000;Berlin;M;203;0;0;0;0;2;2;3;22;25;39;66;21;13;34;32;46;18;3;4;137
219000;Raubüberfälle in Wohnungen;11000000;Berlin;W;23;0;0;0;0;0;0;0;0;0;2;2;0;2;2;5;7;3;4;0;21
219000;Raubüberfälle in Wohnungen;11000000;Berlin;X;226;0;0;0;0;2;2;3;22;25;41;68;21;15;36;37;53;21;7;4;158
219000;Raubüberfälle in Wohnungen;5711000;Bielefeld;M;14;0;0;0;0;0;0;0;0;0;5;5;0;1;1;1;5;1;1;0;9
219000;Raubüberfälle in Wohnungen;5711000;Bielefeld;W;7;0;0;0;0;0;0;0;1;1;1;2;1;0;1;0;3;1;0;0;5
219000;Raubüberfälle in Wohnungen;5711000;Bielefeld;X;21;0;0;0;0;0;0;0;1;1;6;7;1;1;2;1;8;2;1;0;14
219000;Raubüberfälle in Wohnungen;5911000;Bochum;M;15;0;0;0;0;0;0;0;0;0;3;3;3;3;6;3;1;2;0;0;12
219000;Raubüberfälle in Wohnungen;5911000;Bochum;W;3;0;0;0;0;0;0;1;0;1;1;2;0;0;0;0;1;0;0;0;1
219000;Raubüberfälle in Wohnungen;5911000;Bochum;X;18;0;0;0;0;0;0;1;0;1;4;5;3;3;6;3;2;2;0;0;13
219000;Raubüberfälle in Wohnungen;5314000;Bonn;M;17;0;0;0;0;1;1;1;1;2;1;4;1;1;2;0;8;2;1;0;13
219000;Raubüberfälle in Wohnungen;5314000;Bonn;W;4;0;0;0;0;0;0;0;0;0;0;0;1;0;1;1;1;1;0;0;4
219000;Raubüberfälle in Wohnungen;5314000;Bonn;X;21;0;0;0;0;1;1;1;1;2;1;4;2;1;3;1;9;3;1;0;17
219000;Raubüberfälle in Wohnungen;5512000;Bottrop;M;2;0;0;0;0;0;0;0;0;0;0;0;0;0;0;1;0;1;0;0;2
219000;Raubüberfälle in Wohnungen;5512000;Bottrop;W;0;0;0;0;0;0;0;0;0;0;0;0;0;0;0;0;0;0;0;0;0
219000;Raubüberfälle in Wohnungen;5512000;Bottrop;X;2;0;0;0;0;0;0;0;0;0;0;0;0;0;0;1;0;1;0;0;2
219000;Raubüberfälle in Wohnungen;3101000;Braunschweig;M;16;0;0;0;0;0;0;0;1;1;1;2;3;0;3;3;4;2;2;0;14
219000;Raubüberfälle in Wohnungen;3101000;Braunschweig;W;4;0;0;0;0;0;0;0;0;0;1;1;0;0;0;1;1;1;0;0;3
219000;Raubüberfälle in Wohnungen;3101000;Braunschweig;X;20;0;0;0;0;0;0;0;1;1;2;3;3;0;3;4;5;3;2;0;17
219000;Raubüberfälle in Wohnungen;4011000;Bremen;M;30;0;0;0;0;0;0;1;4;5;4;9;2;2;4;4;11;2;0;0;21
219000;Raubüberfälle in Wohnungen;4011000;Bremen;W;1;0;0;0;0;0;0;0;0;0;0;0;0;0;0;0;1;0;0;0;1
219000;Raubüberfälle in Wohnungen;4011000;Bremen;X;31;0;0;0;0;0;0;1;4;5;4;9;2;2;4;4;12;2;0;0;22
219000;Raubüberfälle in Wohnungen;4012000;Bremerhaven;M;12;0;0;0;0;0;0;0;2;2;2;4;2;2;4;3;1;0;0;0;8
219000;Raubüberfälle in Wohnungen;4012000;Bremerhaven;W;1;0;0;0;0;0;0;0;0;0;0;0;0;0;0;1;0;0;0;0;1
219000;Raubüberfälle in Wohnungen;4012000;Bremerhaven;X;13;0;0;0;0;0;0;0;2;2;2;4;2;2;4;4;1;0;0;0;9
219000;Raubüberfälle in Wohnungen;14511000;Chemnitz;M;21;0;0;0;0;0;0;0;2;2;3;5;1;2;3;6;6;0;0;1;16
219000;Raubüberfälle in Wohnungen;14511000;Chemnitz;W;1;0;0;0;0;0;0;0;0;0;0;0;0;0;0;1;0;0;0;0;1
219000;Raubüberfälle in Wohnungen;14511000;Chemnitz;X;22;0;0;0;0;0;0;0;2;2;3;5;1;2;3;7;6;0;0;1;17
219000;Raubüberfälle in Wohnungen;6411000;Darmstadt;M;1;0;0;0;0;0;0;0;1;1;0;1;0;0;0;0;0;0;0;0;0
219000;Raubüberfälle in Wohnungen;6411000;Darmstadt;W;1;0;0;0;0;0;0;0;0;0;1;1;0;0;0;0;0;0;0;0;0
219000;Raubüberfälle in Wohnungen;6411000;Darmstadt;X;2;0;0;0;0;0;0;0;1;1;1;2;0;0;0;0;0;0;0;0;0
219000;Raubüberfälle in Wohnungen;5913000;Dortmund;M;44;0;0;0;0;0;0;0;3;3;5;8;3;1;4;7;13;7;4;1;36
219000;Raubüberfälle in Wohnungen;5913000;Dortmund;W;5;0;0;0;0;0;0;1;1;2;1;3;1;0;1;1;0;0;0;0;2
219000;Raubüberfälle in Wohnungen;5913000;Dortmund;X;49;0;0;0;0;0;0;1;4;5;6;11;4;1;5;8;13;7;4;1;38
219000;Raubüberfälle in Wohnungen;14612000;Dresden;M;29;0;0;0;0;0;0;0;1;1;2;3;6;4;10;8;5;2;0;1;26
219000;Raubüberfälle in Wohnungen;14612000;Dresden;W;6;0;0;0;0;0;0;0;0;0;1;1;0;0;0;2;3;0;0;0;5
219000;Raubüberfälle in Wohnungen;14612000;Dresden;X;35;0;0;0;0;0;0;0;1;1;3;4;6;4;10;10;8;2;0;1;31
219000;Raubüberfälle in Wohnungen;5112000;Duisburg;M;39;0;0;0;0;0;0;1;0;1;6;7;8;7;15;9;8;0;0;0;32
219000;Raubüberfälle in Wohnungen;5112000;Duisburg;W;6;0;0;0;0;0;0;0;0;0;0;0;3;1;4;1;0;1;0;0;6
219000;Raubüberfälle in Wohnungen;5112000;Duisburg;X;45;0;0;0;0;0;0;1;0;1;6;7;11;8;19;10;8;1;0;0;38
219000;Raubüberfälle in Wohnungen;5111000;Düsseldorf;M;34;0;0;0;0;2;2;2;2;4;2;8;4;6;10;3;7;6;0;0;26
219000;Raubüberfälle in Wohnungen;5111000;Düsseldorf;W;7;0;0;0;0;0;0;0;0;0;0;0;0;1;1;2;1;1;2;0;7
219000;Raubüberfälle in Wohnungen;5111000;Düsseldorf;X;41;0;0;0;0;2;2;2;2;4;2;8;4;7;11;5;8;7;2;0;33
219000;Raubüberfälle in Wohnungen;16051000;Erfurt;M;13;0;0;0;0;0;0;0;2;2;1;3;1;2;3;2;5;0;0;0;10
219000;Raubüberfälle in Wohnungen;16051000;Erfurt;W;2;0;0;0;0;0;0;0;0;0;0;0;1;0;1;0;1;0;0;0;2
219000;Raubüberfälle in Wohnungen;16051000;Erfurt;X;15;0;0;0;0;0;0;0;2;2;1;3;2;2;4;2;6;0;0;0;12
219000;Raubüberfälle in Wohnungen;9562000;Erlangen;M;1;0;0;0;0;0;0;0;0;0;0;0;0;0;0;0;1;0;0;0;1
219000;Raubüberfälle in Wohnungen;9562000;Erlangen;W;0;0;0;0;0;0;0;0;0;0;0;0;0;0;0;0;0;0;0;0;0
219000;Raubüberfälle in Wohnungen;9562000;Erlangen;X;1;0;0;0;0;0;0;0;0;0;0;0;0;0;0;0;1;0;0;0;1
219000;Raubüberfälle in Wohnungen;5113000;Essen;M;26;0;0;0;0;1;1;1;0;1;2;4;2;4;6;5;4;5;2;0;22
219000;Raubüberfälle in Wohnungen;5113000;Essen;W;10;0;0;0;0;0;0;0;2;2;1;3;0;1;1;1;1;1;2;1;7
219000;Raubüberfälle in Wohnungen;5113000;Essen;X;36;0;0;0;0;1;1;1;2;3;3;7;2;5;7;6;5;6;4;1;29
219000;Raubüberfälle in Wohnungen;6412000;Frankfurt am Main;M;29;0;0;0;0;0;0;0;1;1;5;6;2;1;3;6;8;4;2;0;23
219000;Raubüberfälle in Wohnungen;6412000;Frankfurt am Main;W;0;0;0;0;0;0;0;0;0;0;0;0;0;0;0;0;0;0;0;0;0
219000;Raubüberfälle in Wohnungen;6412000;Frankfurt am Main;X;29;0;0;0;0;0;0;0;1;1;5;6;2;1;3;6;8;4;2;0;23
219000;Raubüberfälle in Wohnungen;8311000;Freiburg im Breisgau;M;4;0;0;0;0;0;0;0;0;0;2;2;1;0;1;0;0;1;0;0;2
219000;Raubüberfälle in Wohnungen;8311000;Freiburg im Breisgau;W;2;0;0;0;0;0;0;0;0;0;1;1;1;0;1;0;0;0;0;0;1
219000;Raubüberfälle in Wohnungen;8311000;Freiburg im Breisgau;X;6;0;0;0;0;0;0;0;0;0;3;3;2;0;2;0;0;1;0;0;3
219000;Raubüberfälle in Wohnungen;9563000;Fürth;M;1;0;0;0;0;0;0;0;0;0;0;0;0;0;0;0;1;0;0;0;1
219000;Raubüberfälle in Wohnungen;9563000;Fürth;W;0;0;0;0;0;0;0;0;0;0;0;0;0;0;0;0;0;0;0;0;0
219000;Raubüberfälle in Wohnungen;9563000;Fürth;X;1;0;0;0;0;0;0;0;0;0;0;0;0;0;0;0;1;0;0;0;1
219000;Raubüberfälle in Wohnungen;5513000;Gelsenkirchen;M;14;0;0;0;0;0;0;0;0;0;4;4;1;3;4;4;2;0;0;0;10
219000;Raubüberfälle in Wohnungen;5513000;Gelsenkirchen;W;2;0;0;0;0;0;0;0;0;0;1;1;0;0;0;0;0;1;0;0;1
219000;Raubüberfälle in Wohnungen;5513000;Gelsenkirchen;X;16;0;0;0;0;0;0;0;0;0;5;5;1;3;4;4;2;1;0;0;11
219000;Raubüberfälle in Wohnungen;3152012;Göttingen;M;14;0;0;0;0;0;0;0;3;3;1;4;3;1;4;2;1;1;2;0;10
219000;Raubüberfälle in Wohnungen;3152012;Göttingen;W;1;0;0;0;0;0;0;0;0;0;1;1;0;0;0;0;0;0;0;0;0
219000;Raubüberfälle in Wohnungen;3152012;Göttingen;X;15;0;0;0;0;0;0;0;3;3;2;5;3;1;4;2;1;1;2;0;10
219000;Raubüberfälle in Wohnungen;5914000;Hagen;M;7;0;0;0;0;0;0;0;0;0;1;1;1;1;2;0;0;4;0;0;6
219000;Raubüberfälle in Wohnungen;5914000;Hagen;W;0;0;0;0;0;0;0;0;0;0;0;0;0;0;0;0;0;0;0;0;0
219000;Raubüberfälle in Wohnungen;5914000;Hagen;X;7;0;0;0;0;0;0;0;0;0;1;1;1;1;2;0;0;4;0;0;6
219000;Raubüberfälle in Wohnungen;15002000;Halle (Saale);M;32;0;0;0;0;0;0;0;3;3;7;10;4;4;8;5;4;5;0;0;22
219000;Raubüberfälle in Wohnungen;15002000;Halle (Saale);W;6;0;0;0;0;0;0;0;0;0;3;3;1;1;2;1;0;0;0;0;3
219000;Raubüberfälle in Wohnungen;15002000;Halle (Saale);X;38;0;0;0;0;0;0;0;3;3;10;13;5;5;10;6;4;5;0;0;25
219000;Raubüberfälle in Wohnungen;2000000;Hamburg;M;74;0;0;0;1;1;2;0;7;7;10;19;6;8;14;14;15;9;3;0;55
219000;Raubüberfälle in Wohnungen;2000000;Hamburg;W;10;0;0;0;0;0;0;0;1;1;0;1;0;1;1;2;3;3;0;0;9
219000;Raubüberfälle in Wohnungen;2000000;Hamburg;X;84;0;0;0;1;1;2;0;8;8;10;20;6;9;15;16;18;12;3;0;64
219000;Raubüberfälle in Wohnungen;5915000;Hamm;M;10;0;0;0;0;0;0;0;1;1;1;2;1;2;3;1;4;0;0;0;8
219000;Raubüberfälle in Wohnungen;5915000;Hamm;W;2;0;0;0;0;0;0;0;0;0;0;0;0;1;1;0;0;1;0;0;2
219000;Raubüberfälle in Wohnungen;5915000;Hamm;X;12;0;0;0;0;0;0;0;1;1;1;2;1;3;4;1;4;1;0;0;10
219000;Raubüberfälle in Wohnungen;3241001;Hannover;M;35;0;0;0;0;0;0;0;1;1;4;5;4;7;11;5;6;7;1;0;30
219000;Raubüberfälle in Wohnungen;3241001;Hannover;W;4;0;0;0;0;0;0;0;1;1;0;1;0;0;0;0;1;2;0;0;3
219000;Raubüberfälle in Wohnungen;3241001;Hannover;X;39;0;0;0;0;0;0;0;2;2;4;6;4;7;11;5;7;9;1;0;33
219000;Raubüberfälle in Wohnungen;8221000;Heidelberg;M;1;0;0;0;0;0;0;0;0;0;1;1;0;0;0;0;0;0;0;0;0
219000;Raubüberfälle in Wohnungen;8221000;Heidelberg;W;0;0;0;0;0;0;0;0;0;0;0;0;0;0;0;0;0;0;0;0;0
219000;Raubüberfälle in Wohnungen;8221000;Heidelberg;X;1;0;0;0;0;0;0;0;0;0;1;1;0;0;0;0;0;0;0;0;0
219000;Raubüberfälle in Wohnungen;8121000;Heilbronn;M;2;0;0;0;0;0;0;0;0;0;0;0;1;0;1;1;0;0;0;0;2
219000;Raubüberfälle in Wohnungen;8121000;Heilbronn;W;1;0;0;0;0;0;0;0;0;0;0;0;0;0;0;1;0;0;0;0;1
219000;Raubüberfälle in Wohnungen;8121000;Heilbronn;X;3;0;0;0;0;0;0;0;0;0;0;0;1;0;1;2;0;0;0;0;3
219000;Raubüberfälle in Wohnungen;5916000;Herne;M;2;0;0;0;0;0;0;0;0;0;0;0;0;0;0;1;1;0;0;0;2
219000;Raubüberfälle in Wohnungen;5916000;Herne;W;0;0;0;0;0;0;0;0;0;0;0;0;0;0;0;0;0;0;0;0;0
219000;Raubüberfälle in Wohnungen;5916000;Herne;X;2;0;0;0;0;0;0;0;0;0;0;0;0;0;0;1;1;0;0;0;2
219000;Raubüberfälle in Wohnungen;9161000;Ingolstadt;M;2;0;0;0;0;0;0;0;1;1;1;2;0;0;0;0;0;0;0;0;0
219000;Raubüberfälle in Wohnungen;9161000;Ingolstadt;W;0;0;0;0;0;0;0;0;0;0;0;0;0;0;0;0;0;0;0;0;0
219000;Raubüberfälle in Wohnungen;9161000;Ingolstadt;X;2;0;0;0;0;0;0;0;1;1;1;2;0;0;0;0;0;0;0;0;0
219000;Raubüberfälle in Wohnungen;16053000;Jena;M;0;0;0;0;0;0;0;0;0;0;0;0;0;0;0;0;0;0;0;0;0
219000;Raubüberfälle in Wohnungen;16053000;Jena;W;0;0;0;0;0;0;0;0;0;0;0;0;0;0;0;0;0;0;0;0;0
219000;Raubüberfälle in Wohnungen;16053000;Jena;X;0;0;0;0;0;0;0;0;0;0;0;0;0;0;0;0;0;0;0;0;0
219000;Raubüberfälle in Wohnungen;8212000;Karlsruhe;M;8;0;0;0;0;0;0;0;0;0;1;1;2;1;3;0;2;2;0;0;7
219000;Raubüberfälle in Wohnungen;8212000;Karlsruhe;W;1;0;0;0;0;0;0;0;0;0;0;0;0;0;0;0;1;0;0;0;1
219000;Raubüberfälle in Wohnungen;8212000;Karlsruhe;X;9;0;0;0;0;0;0;0;0;0;1;1;2;1;3;0;3;2;0;0;8
219000;Raubüberfälle in Wohnungen;6611000;Kassel;M;33;0;0;0;0;0;0;1;6;7;4;11;3;5;8;4;4;6;0;0;22
219000;Raubüberfälle in Wohnungen;6611000;Kassel;W;5;0;0;0;0;0;0;0;0;0;2;2;0;0;0;2;0;1;0;0;3
219000;Raubüberfälle in Wohnungen;6611000;Kassel;X;38;0;0;0;0;0;0;1;6;7;6;13;3;5;8;6;4;7;0;0;25
219000;Raubüberfälle in Wohnungen;1002000;Kiel;M;23;0;0;0;0;0;0;1;6;7;5;12;4;1;5;3;1;2;0;0;11
219000;Raubüberfälle in Wohnungen;1002000;Kiel;W;2;0;0;0;0;0;0;0;0;0;0;0;1;0;1;0;0;1;0;0;2
219000;Raubüberfälle in Wohnungen;1002000;Kiel;X;25;0;0;0;0;0;0;1;6;7;5;12;5;1;6;3;1;3;0;0;13
219000;Raubüberfälle in Wohnungen;7111000;Koblenz;M;2;0;0;0;0;0;0;0;0;0;1;1;0;1;1;0;0;0;0;0;1
219000;Raubüberfälle in Wohnungen;7111000;Koblenz;W;0;0;0;0;0;0;0;0;0;0;0;0;0;0;0;0;0;0;0;0;0
219000;Raubüberfälle in Wohnungen;7111000;Koblenz;X;2;0;0;0;0;0;0;0;0;0;1;1;0;1;1;0;0;0;0;0;1
219000;Raubüberfälle in Wohnungen;5315000;Köln;M;69;0;0;0;0;0;0;2;2;4;2;6;5;7;12;20;20;7;4;0;63
219000;Raubüberfälle in Wohnungen;5315000;Köln;W;8;0;0;0;0;0;0;0;0;0;2;2;0;0;0;3;1;2;0;0;6
219000;Raubüberfälle in Wohnungen;5315000;Köln;X;77;0;0;0;0;0;0;2;2;4;4;8;5;7;12;23;21;9;4;0;69
219000;Raubüberfälle in Wohnungen;5114000;Krefeld;M;18;0;0;0;0;0;0;0;0;0;4;4;4;1;5;3;4;1;1;0;14
219000;Raubüberfälle in Wohnungen;5114000;Krefeld;W;1;0;0;0;0;0;0;0;0;0;0;0;0;0;0;0;0;0;1;0;1
219000;Raubüberfälle in Wohnungen;5114000;Krefeld;X;19;0;0;0;0;0;0;0;0;0;4;4;4;1;5;3;4;1;2;0;15
219000;Raubüberfälle in Wohnungen;14713000;Leipzig;M;54;0;0;0;0;0;0;0;5;5;6;11;6;3;9;11;17;6;0;0;43
219000;Raubüberfälle in Wohnungen;14713000;Leipzig;W;7;0;0;0;0;0;0;0;3;3;0;3;1;0;1;2;1;0;0;0;4
219000;Raubüberfälle in Wohnungen;14713000;Leipzig;X;61;0;0;0;0;0;0;0;8;8;6;14;7;3;10;13;18;6;0;0;47
219000;Raubüberfälle in Wohnungen;5316000;Leverkusen;M;10;0;0;0;0;0;0;0;0;0;1;1;0;1;1;0;5;2;1;0;9
219000;Raubüberfälle in Wohnungen;5316000;Leverkusen;W;0;0;0;0;0;0;0;0;0;0;0;0;0;0;0;0;0;0;0;0;0
219000;Raubüberfälle in Wohnungen;5316000;Leverkusen;X;10;0;0;0;0;0;0;0;0;0;1;1;0;1;1;0;5;2;1;0;9
219000;Raubüberfälle in Wohnungen;1003000;Lübeck;M;9;0;0;0;0;0;0;0;0;0;1;1;1;2;3;0;4;1;0;0;8
219000;Raubüberfälle in Wohnungen;1003000;Lübeck;W;0;0;0;0;0;0;0;0;0;0;0;0;0;0;0;0;0;0;0;0;0
219000;Raubüberfälle in Wohnungen;1003000;Lübeck;X;9;0;0;0;0;0;0;0;0;0;1;1;1;2;3;0;4;1;0;0;8
219000;Raubüberfälle in Wohnungen;7314000;Ludwigshafen am Rhein;M;15;0;0;0;0;0;0;0;1;1;7;8;2;1;3;2;1;1;0;0;7
219000;Raubüberfälle in Wohnungen;7314000;Ludwigshafen am Rhein;W;1;0;0;0;0;0;0;0;0;0;0;0;0;0;0;0;0;1;0;0;1
219000;Raubüberfälle in Wohnungen;7314000;Ludwigshafen am Rhein;X;16;0;0;0;0;0;0;0;1;1;7;8;2;1;3;2;1;2;0;0;8
219000;Raubüberfälle in Wohnungen;15003000;Magdeburg;M;22;0;0;0;0;0;0;1;2;3;6;9;1;2;3;5;3;2;0;0;13
219000;Raubüberfälle in Wohnungen;15003000;Magdeburg;W;5;0;0;0;0;0;0;0;3;3;0;3;0;1;1;1;0;0;0;0;2
219000;Raubüberfälle in Wohnungen;15003000;Magdeburg;X;27;0;0;0;0;0;0;1;5;6;6;12;1;3;4;6;3;2;0;0;15
219000;Raubüberfälle in Wohnungen;7315000;Mainz;M;8;0;0;0;0;0;0;0;0;0;2;2;0;0;0;2;1;2;1;0;6
219000;Raubüberfälle in Wohnungen;7315000;Mainz;W;1;0;0;0;0;0;0;0;0;0;0;0;0;0;0;0;0;1;0;0;1
219000;Raubüberfälle in Wohnungen;7315000;Mainz;X;9;0;0;0;0;0;0;0;0;0;2;2;0;0;0;2;1;3;1;0;7
219000;Raubüberfälle in Wohnungen;8222000;Mannheim;M;17;0;0;0;0;0;0;2;3;5;3;8;0;1;1;3;3;1;1;0;9
219000;Raubüberfälle in Wohnungen;8222000;Mannheim;W;0;0;0;0;0;0;0;0;0;0;0;0;0;0;0;0;0;0;0;0;0
219000;Raubüberfälle in Wohnungen;8222000;Mannheim;X;17;0;0;0;0;0;0;2;3;5;3;8;0;1;1;3;3;1;1;0;9
219000;Raubüberfälle in Wohnungen;5170024;Moers;M;4;0;0;0;0;0;0;0;0;0;0;0;1;0;1;2;1;0;0;0;4
219000;Raubüberfälle in Wohnungen;5170024;Moers;W;0;0;0;0;0;0;0;0;0;0;0;0;0;0;0;0;0;0;0;0;0
219000;Raubüberfälle in Wohnungen;5170024;Moers;X;4;0;0;0;0;0;0;0;0;0;0;0;1;0;1;2;1;0;0;0;4
219000;Raubüberfälle in Wohnungen;5116000;Mönchengladbach;M;12;0;0;0;0;0;0;0;1;1;1;2;1;3;4;2;4;0;0;0;10
219000;Raubüberfälle in Wohnungen;5116000;Mönchengladbach;W;2;0;0;0;0;0;0;0;0;0;1;1;0;0;0;1;0;0;0;0;1
219000;Raubüberfälle in Wohnungen;5116000;Mönchengladbach;X;14;0;0;0;0;0;0;0;1;1;2;3;1;3;4;3;4;0;0;0;11
219000;Raubüberfälle in Wohnungen;5117000;Mülheim an der Ruhr;M;5;0;0;0;0;0;0;0;0;0;2;2;1;0;1;0;1;1;0;0;3
219000;Raubüberfälle in Wohnungen;5117000;Mülheim an der Ruhr;W;0;0;0;0;0;0;0;0;0;0;0;0;0;0;0;0;0;0;0;0;0
219000;Raubüberfälle in Wohnungen;5117000;Mülheim an der Ruhr;X;5;0;0;0;0;0;0;0;0;0;2;2;1;0;1;0;1;1;0;0;3
219000;Raubüberfälle in Wohnungen;9162000;München;M;26;0;0;0;0;0;0;0;1;1;10;11;1;3;4;1;7;1;1;1;15
219000;Raubüberfälle in Wohnungen;9162000;München;W;5;0;0;0;0;0;0;0;0;0;4;4;0;0;0;0;1;0;0;0;1
219000;Raubüberfälle in Wohnungen;9162000;München;X;31;0;0;0;0;0;0;0;1;1;14;15;1;3;4;1;8;1;1;1;16
219000;Raubüberfälle in Wohnungen;5515000;Münster;M;8;0;0;0;0;0;0;0;0;0;1;1;0;0;0;2;1;3;1;0;7
219000;Raubüberfälle in Wohnungen;5515000;Münster;W;2;0;0;0;0;0;0;0;0;0;1;1;0;0;0;1;0;0;0;0;1
219000;Raubüberfälle in Wohnungen;5515000;Münster;X;10;0;0;0;0;0;0;0;0;0;2;2;0;0;0;3;1;3;1;0;8
219000;Raubüberfälle in Wohnungen;5162024;Neuss;M;3;0;0;0;0;0;0;0;1;1;1;2;0;0;0;1;0;0;0;0;1
219000;Raubüberfälle in Wohnungen;5162024;Neuss;W;0;0;0;0;0;0;0;0;0;0;0;0;0;0;0;0;0;0;0;0;0
219000;Raubüberfälle in Wohnungen;5162024;Neuss;X;3;0;0;0;0;0;0;0;1;1;1;2;0;0;0;1;0;0;0;0;1
219000;Raubüberfälle in Wohnungen;9564000;Nürnberg;M;24;0;0;0;0;0;0;0;0;0;2;2;2;3;5;6;8;2;1;0;22
219000;Raubüberfälle in Wohnungen;9564000;Nürnberg;W;2;0;0;0;0;1;1;0;0;0;0;1;0;0;0;0;1;0;0;0;1
219000;Raubüberfälle in Wohnungen;9564000;Nürnberg;X;26;0;0;0;0;1;1;0;0;0;2;3;2;3;5;6;9;2;1;0;23
219000;Raubüberfälle in Wohnungen;5119000;Oberhausen;M;12;0;0;0;0;0;0;0;0;0;1;1;3;2;5;2;2;2;0;0;11
219000;Raubüberfälle in Wohnungen;5119000;Oberhausen;W;2;0;0;0;0;0;0;0;0;0;0;0;0;0;0;2;0;0;0;0;2
219000;Raubüberfälle in Wohnungen;5119000;Oberhausen;X;14;0;0;0;0;0;0;0;0;0;1;1;3;2;5;4;2;2;0;0;13
219000;Raubüberfälle in Wohnungen;6413000;Offenbach am Main;M;8;0;0;0;0;0;0;0;4;4;3;7;0;1;1;0;0;0;0;0;1
219000;Raubüberfälle in Wohnungen;6413000;Offenbach am Main;W;0;0;0;0;0;0;0;0;0;0;0;0;0;0;0;0;0;0;0;0;0
219000;Raubüberfälle in Wohnungen;6413000;Offenbach am Main;X;8;0;0;0;0;0;0;0;4;4;3;7;0;1;1;0;0;0;0;0;1
219000;Raubüberfälle in Wohnungen;3403000;Oldenburg (Oldenburg);M;8;0;0;0;0;0;0;0;1;1;0;1;0;2;2;2;2;0;1;0;7
219000;Raubüberfälle in Wohnungen;3403000;Oldenburg (Oldenburg);W;0;0;0;0;0;0;0;0;0;0;0;0;0;0;0;0;0;0;0;0;0
219000;Raubüberfälle in Wohnungen;3403000;Oldenburg (Oldenburg);X;8;0;0;0;0;0;0;0;1;1;0;1;0;2;2;2;2;0;1;0;7
219000;Raubüberfälle in Wohnungen;3404000;Osnabrück;M;11;0;0;0;0;0;0;0;0;0;0;0;1;1;2;2;4;1;2;0;11
219000;Raubüberfälle in Wohnungen;3404000;Osnabrück;W;3;0;0;0;0;0;0;0;0;0;0;0;0;0;0;0;2;1;0;0;3
219000;Raubüberfälle in Wohnungen;3404000;Osnabrück;X;14;0;0;0;0;0;0;0;0;0;0;0;1;1;2;2;6;2;2;0;14
219000;Raubüberfälle in Wohnungen;5774032;Paderborn;M;5;0;0;0;0;0;0;0;0;0;0;0;0;0;0;3;0;0;2;0;5
219000;Raubüberfälle in Wohnungen;5774032;Paderborn;W;0;0;0;0;0;0;0;0;0;0;0;0;0;0;0;0;0;0;0;0;0
219000;Raubüberfälle in Wohnungen;5774032;Paderborn;X;5;0;0;0;0;0;0;0;0;0;0;0;0;0;0;3;0;0;2;0;5
219000;Raubüberfälle in Wohnungen;8231000;Pforzheim;M;6;0;0;0;0;0;0;0;0;0;1;1;1;0;1;0;3;1;0;0;5
219000;Raubüberfälle in Wohnungen;8231000;Pforzheim;W;0;0;0;0;0;0;0;0;0;0;0;0;0;0;0;0;0;0;0;0;0
219000;Raubüberfälle in Wohnungen;8231000;Pforzheim;X;6;0;0;0;0;0;0;0;0;0;1;1;1;0;1;0;3;1;0;0;5
219000;Raubüberfälle in Wohnungen;12054000;Potsdam;M;4;0;0;0;0;0;0;0;0;0;2;2;1;0;1;0;0;1;0;0;2
219000;Raubüberfälle in Wohnungen;12054000;Potsdam;W;0;0;0;0;0;0;0;0;0;0;0;0;0;0;0;0;0;0;0;0;0
219000;Raubüberfälle in Wohnungen;12054000;Potsdam;X;4;0;0;0;0;0;0;0;0;0;2;2;1;0;1;0;0;1;0;0;2
219000;Raubüberfälle in Wohnungen;5562032;Recklinghausen;M;15;0;0;0;0;0;0;0;0;0;5;5;2;3;5;0;3;2;0;0;10
219000;Raubüberfälle in Wohnungen;5562032;Recklinghausen;W;0;0;0;0;0;0;0;0;0;0;0;0;0;0;0;0;0;0;0;0;0
219000;Raubüberfälle in Wohnungen;5562032;Recklinghausen;X;15;0;0;0;0;0;0;0;0;0;5;5;2;3;5;0;3;2;0;0;10
219000;Raubüberfälle in Wohnungen;9362000;Regensburg;M;10;0;0;0;0;0;0;0;0;0;0;0;2;1;3;2;4;1;0;0;10
219000;Raubüberfälle in Wohnungen;9362000;Regensburg;W;3;0;0;0;0;0;0;0;1;1;0;1;0;0;0;0;1;0;1;0;2
219000;Raubüberfälle in Wohnungen;9362000;Regensburg;X;13;0;0;0;0;0;0;0;1;1;0;1;2;1;3;2;5;1;1;0;12
219000;Raubüberfälle in Wohnungen;5120000;Remscheid;M;4;0;0;0;0;0;0;0;0;0;1;1;0;0;0;1;0;1;1;0;3
219000;Raubüberfälle in Wohnungen;5120000;Remscheid;W;0;0;0;0;0;0;0;0;0;0;0;0;0;0;0;0;0;0;0;0;0
219000;Raubüberfälle in Wohnungen;5120000;Remscheid;X;4;0;0;0;0;0;0;0;0;0;1;1;0;0;0;1;0;1;1;0;3
219000;Raubüberfälle in Wohnungen;8415061;Reutlingen;M;7;0;0;0;0;0;0;0;1;1;0;1;2;0;2;3;1;0;0;0;6
219000;Raubüberfälle in Wohnungen;8415061;Reutlingen;W;0;0;0;0;0;0;0;0;0;0;0;0;0;0;0;0;0;0;0;0;0
219000;Raubüberfälle in Wohnungen;8415061;Reutlingen;X;7;0;0;0;0;0;0;0;1;1;0;1;2;0;2;3;1;0;0;0;6
219000;Raubüberfälle in Wohnungen;13003000;Rostock;M;28;0;0;0;0;0;0;0;0;0;2;2;0;2;2;9;15;0;0;0;26
219000;Raubüberfälle in Wohnungen;13003000;Rostock;W;3;0;0;0;0;0;0;1;1;2;0;2;0;0;0;1;0;0;0;0;1
219000;Raubüberfälle in Wohnungen;13003000;Rostock;X;31;0;0;0;0;0;0;1;1;2;2;4;0;2;2;10;15;0;0;0;27
219000;Raubüberfälle in Wohnungen;10041100;Saarbrücken;M;10;0;0;0;0;0;0;0;0;0;1;1;0;2;2;3;2;2;0;0;9
219000;Raubüberfälle in Wohnungen;10041100;Saarbrücken;W;2;0;0;0;0;0;0;0;0;0;0;0;0;0;0;1;1;0;0;0;2
219000;Raubüberfälle in Wohnungen;10041100;Saarbrücken;X;12;0;0;0;0;0;0;0;0;0;1;1;0;2;2;4;3;2;0;0;11
219000;Raubüberfälle in Wohnungen;5122000;Solingen;M;0;0;0;0;0;0;0;0;0;0;0;0;0;0;0;0;0;0;0;0;0
219000;Raubüberfälle in Wohnungen;5122000;Solingen;W;1;0;0;0;0;0;0;0;0;0;0;0;0;1;1;0;0;0;0;0;1
219000;Raubüberfälle in Wohnungen;5122000;Solingen;X;1;0;0;0;0;0;0;0;0;0;0;0;0;1;1;0;0;0;0;0;1
219000;Raubüberfälle in Wohnungen;8111000;Stuttgart;M;20;0;0;0;0;0;0;1;1;2;1;3;1;0;1;2;6;8;0;0;17
219000;Raubüberfälle in Wohnungen;8111000;Stuttgart;W;3;0;0;0;0;0;0;0;0;0;0;0;1;0;1;1;0;1;0;0;3
219000;Raubüberfälle in Wohnungen;8111000;Stuttgart;X;23;0;0;0;0;0;0;1;1;2;1;3;2;0;2;3;6;9;0;0;20
219000;Raubüberfälle in Wohnungen;7211000;Trier;M;9;0;0;0;0;0;0;0;0;0;3;3;1;0;1;1;1;2;1;0;6
219000;Raubüberfälle in Wohnungen;7211000;Trier;W;1;0;0;0;0;0;0;0;0;0;0;0;0;0;0;0;1;0;0;0;1
219000;Raubüberfälle in Wohnungen;7211000;Trier;X;10;0;0;0;0;0;0;0;0;0;3;3;1;0;1;1;2;2;1;0;7
219000;Raubüberfälle in Wohnungen;8421000;Ulm;M;6;0;0;0;0;0;0;0;0;0;0;0;2;1;3;0;3;0;0;0;6
219000;Raubüberfälle in Wohnungen;8421000;Ulm;W;4;0;0;0;0;0;0;0;0;0;0;0;1;0;1;1;1;0;1;0;4
219000;Raubüberfälle in Wohnungen;8421000;Ulm;X;10;0;0;0;0;0;0;0;0;0;0;0;3;1;4;1;4;0;1;0;10
219000;Raubüberfälle in Wohnungen;6414000;Wiesbaden;M;19;0;0;0;0;0;0;0;1;1;1;2;1;2;3;6;6;2;0;0;17
219000;Raubüberfälle in Wohnungen;6414000;Wiesbaden;W;0;0;0;0;0;0;0;0;0;0;0;0;0;0;0;0;0;0;0;0;0
219000;Raubüberfälle in Wohnungen;6414000;Wiesbaden;X;19;0;0;0;0;0;0;0;1;1;1;2;1;2;3;6;6;2;0;0;17
219000;Raubüberfälle in Wohnungen;3103000;Wolfsburg;M;4;0;0;0;0;0;0;0;0;0;0;0;0;0;0;1;1;1;1;0;4
219000;Raubüberfälle in Wohnungen;3103000;Wolfsburg;W;0;0;0;0;0;0;0;0;0;0;0;0;0;0;0;0;0;0;0;0;0
219000;Raubüberfälle in Wohnungen;3103000;Wolfsburg;X;4;0;0;0;0;0;0;0;0;0;0;0;0;0;0;1;1;1;1;0;4
219000;Raubüberfälle in Wohnungen;5124000;Wuppertal;M;18;0;0;0;0;0;0;0;0;0;4;4;2;1;3;4;6;1;0;0;14
219000;Raubüberfälle in Wohnungen;5124000;Wuppertal;W;4;0;0;0;0;0;0;0;0;0;0;0;1;0;1;0;2;1;0;0;4
219000;Raubüberfälle in Wohnungen;5124000;Wuppertal;X;22;0;0;0;0;0;0;0;0;0;4;4;3;1;4;4;8;2;0;0;18
219000;Raubüberfälle in Wohnungen;9663000;Würzburg;M;2;0;0;0;0;0;0;0;0;0;1;1;0;0;0;0;0;0;1;0;1
219000;Raubüberfälle in Wohnungen;9663000;Würzburg;W;0;0;0;0;0;0;0;0;0;0;0;0;0;0;0;0;0;0;0;0;0
219000;Raubüberfälle in Wohnungen;9663000;Würzburg;X;2;0;0;0;0;0;0;0;0;0;1;1;0;0;0;0;0;0;1;0;1
222000;Gefährliche und schwere Körperverletzung, Verstümmelung weiblicher Genitalien §§ 224, 226, 226a, 231 StGB;5334002;Aachen;M;617;2;0;0;2;8;12;28;76;104;85;201;58;49;107;75;108;77;32;17;416
222000;Gefährliche und schwere Körperverletzung, Verstümmelung weiblicher Genitalien §§ 224, 226, 226a, 231 StGB;5334002;Aachen;W;100;0;0;0;0;4;4;8;7;15;8;27;7;7;14;15;22;9;7;6;73
222000;Gefährliche und schwere Körperverletzung, Verstümmelung weiblicher Genitalien §§ 224, 226, 226a, 231 StGB;5334002;Aachen;X;717;2;0;0;2;12;16;36;83;119;93;228;65;56;121;90;130;86;39;23;489
222000;Gefährliche und schwere Körperverletzung, Verstümmelung weiblicher Genitalien §§ 224, 226, 226a, 231 StGB;9761000;Augsburg;M;560;0;0;2;5;12;19;29;33;62;84;165;55;54;109;97;90;49;33;17;395
222000;Gefährliche und schwere Körperverletzung, Verstümmelung weiblicher Genitalien §§ 224, 226, 226a, 231 StGB;9761000;Augsburg;W;121;0;0;1;2;3;6;9;8;17;11;34;7;8;15;11;31;17;10;3;87
222000;Gefährliche und schwere Körperverletzung, Verstümmelung weiblicher Genitalien §§ 224, 226, 226a, 231 StGB;9761000;Augsburg;X;681;0;0;3;7;15;25;38;41;79;95;199;62;62;124;108;121;66;43;20;482
222000;Gefährliche und schwere Körperverletzung, Verstümmelung weiblicher Genitalien §§ 224, 226, 226a, 231 StGB;5378004;Bergisch Gladbach;M;121;0;0;0;5;1;6;7;12;19;15;40;5;6;11;21;23;18;6;2;81
222000;Gefährliche und schwere Körperverletzung, Verstümmelung weiblicher Genitalien §§ 224, 226, 226a, 231 StGB;5378004;Bergisch Gladbach;W;38;0;0;0;0;0;0;4;3;7;2;9;2;1;3;6;7;7;6;0;29
222000;Gefährliche und schwere Körperverletzung, Verstümmelung weiblicher Genitalien §§ 224, 226, 226a, 231 StGB;5378004;Bergisch Gladbach;X;159;0;0;0;5;1;6;11;15;26;17;49;7;7;14;27;30;25;12;2;110
222000;Gefährliche und schwere Körperverletzung, Verstümmelung weiblicher Genitalien §§ 224, 226, 226a, 231 StGB;11000000;Berlin;M;7153;6;22;80;129;215;452;328;448;776;765;1993;450;471;921;1044;1560;889;453;293;5160
222000;Gefährliche und schwere Körperverletzung, Verstümmelung weiblicher Genitalien §§ 224, 226, 226a, 231 StGB;11000000;Berlin;W;1620;0;2;6;14;75;97;119;85;204;128;429;75;86;161;200;347;267;130;86;1191
222000;Gefährliche und schwere Körperverletzung, Verstümmelung weiblicher Genitalien §§ 224, 226, 226a, 231 StGB;11000000;Berlin;X;8773;6;24;86;143;290;549;447;533;980;893;2422;525;557;1082;1244;1907;1156;583;379;6351
222000;Gefährliche und schwere Körperverletzung, Verstümmelung weiblicher Genitalien §§ 224, 226, 226a, 231 StGB;5711000;Bielefeld;M;450;0;0;2;7;4;13;9;37;46;80;139;40;28;68;70;84;56;21;12;311
222000;Gefährliche und schwere Körperverletzung, Verstümmelung weiblicher Genitalien §§ 224, 226, 226a, 231 StGB;5711000;Bielefeld;W;74;0;0;0;1;0;1;10;4;14;9;24;8;2;10;9;18;8;4;1;50
222000;Gefährliche und schwere Körperverletzung, Verstümmelung weiblicher Genitalien §§ 224, 226, 226a, 231 StGB;5711000;Bielefeld;X;524;0;0;2;8;4;14;19;41;60;89;163;48;30;78;79;102;64;25;13;361
222000;Gefährliche und schwere Körperverletzung, Verstümmelung weiblicher Genitalien §§ 224, 226, 226a, 231 StGB;5911000;Bochum;M;744;0;1;2;6;15;24;20;54;74;97;195;73;55;128;126;143;97;40;15;549
222000;Gefährliche und schwere Körperverletzung, Verstümmelung weiblicher Genitalien §§ 224, 226, 226a, 231 StGB;5911000;Bochum;W;161;0;0;0;0;6;6;10;16;26;16;48;11;11;22;15;25;34;10;7;113
222000;Gefährliche und schwere Körperverletzung, Verstümmelung weiblicher Genitalien §§ 224, 226, 226a, 231 StGB;5911000;Bochum;X;905;0;1;2;6;21;30;30;70;100;113;243;84;66;150;141;168;131;50;22;662
222000;Gefährliche und schwere Körperverletzung, Verstümmelung weiblicher Genitalien §§ 224, 226, 226a, 231 StGB;5314000;Bonn;M;607;0;1;4;15;13;33;28;36;64;65;162;48;47;95;102;101;84;39;24;445
222000;Gefährliche und schwere Körperverletzung, Verstümmelung weiblicher Genitalien §§ 224, 226, 226a, 231 StGB;5314000;Bonn;W;113;0;0;0;0;3;3;2;10;12;8;23;9;5;14;8;33;20;5;10;90
222000;Gefährliche und schwere Körperverletzung, Verstümmelung weiblicher Genitalien §§ 224, 226, 226a, 231 StGB;5314000;Bonn;X;720;0;1;4;15;16;36;30;46;76;73;185;57;52;109;110;134;104;44;34;535
222000;Gefährliche und schwere Körperverletzung, Verstümmelung weiblicher Genitalien §§ 224, 226, 226a, 231 StGB;5512000;Bottrop;M;176;0;0;0;1;5;6;18;13;31;14;51;15;16;31;14;35;27;8;10;125
222000;Gefährliche und schwere Körperverletzung, Verstümmelung weiblicher Genitalien §§ 224, 226, 226a, 231 StGB;5512000;Bottrop;W;21;0;0;0;0;0;0;3;0;3;2;5;1;0;1;2;3;6;3;1;16
222000;Gefährliche und schwere Körperverletzung, Verstümmelung weiblicher Genitalien §§ 224, 226, 226a, 231 StGB;5512000;Bottrop;X;197;0;0;0;1;5;6;21;13;34;16;56;16;16;32;16;38;33;11;11;141
222000;Gefährliche und schwere Körperverletzung, Verstümmelung weiblicher Genitalien §§ 224, 226, 226a, 231 StGB;3101000;Braunschweig;M;540;0;2;1;3;10;16;19;38;57;79;152;56;44;100;91;112;51;27;7;388
222000;Gefährliche und schwere Körperverletzung, Verstümmelung weiblicher Genitalien §§ 224, 226, 226a, 231 StGB;3101000;Braunschweig;W;97;0;0;1;0;5;6;10;6;16;10;32;4;7;11;18;17;7;7;5;65
222000;Gefährliche und schwere Körperverletzung, Verstümmelung weiblicher Genitalien §§ 224, 226, 226a, 231 StGB;3101000;Braunschweig;X;637;0;2;2;3;15;22;29;44;73;89;184;60;51;111;109;129;58;34;12;453
222000;Gefährliche und schwere Körperverletzung, Verstümmelung weiblicher Genitalien §§ 224, 226, 226a, 231 StGB;4011000;Bremen;M;1356;1;2;5;10;16;34;60;98;158;206;398;121;119;240;191;259;167;62;39;958
222000;Gefährliche und schwere Körperverletzung, Verstümmelung weiblicher Genitalien §§ 224, 226, 226a, 231 StGB;4011000;Bremen;W;207;0;0;1;2;2;5;13;11;24;17;46;14;19;33;26;44;29;18;11;161
222000;Gefährliche und schwere Körperverletzung, Verstümmelung weiblicher Genitalien §§ 224, 226, 226a, 231 StGB;4011000;Bremen;X;1563;1;2;6;12;18;39;73;109;182;223;444;135;138;273;217;303;196;80;50;1119
222000;Gefährliche und schwere Körperverletzung, Verstümmelung weiblicher Genitalien §§ 224, 226, 226a, 231 StGB;4012000;Bremerhaven;M;241;0;1;3;0;2;6;11;13;24;27;57;27;13;40;35;57;28;15;9;184
222000;Gefährliche und schwere Körperverletzung, Verstümmelung weiblicher Genitalien §§ 224, 226, 226a, 231 StGB;4012000;Bremerhaven;W;54;0;0;0;0;2;2;9;4;13;12;27;4;1;5;6;5;5;2;4;27
222000;Gefährliche und schwere Körperverletzung, Verstümmelung weiblicher Genitalien §§ 224, 226, 226a, 231 StGB;4012000;Bremerhaven;X;295;0;1;3;0;4;8;20;17;37;39;84;31;14;45;41;62;33;17;13;211
222000;Gefährliche und schwere Körperverletzung, Verstümmelung weiblicher Genitalien §§ 224, 226, 226a, 231 StGB;14511000;Chemnitz;M;427;0;1;1;1;5;8;13;14;27;61;96;34;37;71;90;105;41;19;5;331
222000;Gefährliche und schwere Körperverletzung, Verstümmelung weiblicher Genitalien §§ 224, 226, 226a, 231 StGB;14511000;Chemnitz;W;59;0;0;0;0;4;4;1;3;4;4;12;1;4;5;11;16;6;6;3;47
222000;Gefährliche und schwere Körperverletzung, Verstümmelung weiblicher Genitalien §§ 224, 226, 226a, 231 StGB;14511000;Chemnitz;X;486;0;1;1;1;9;12;14;17;31;65;108;35;41;76;101;121;47;25;8;378
222000;Gefährliche und schwere Körperverletzung, Verstümmelung weiblicher Genitalien §§ 224, 226, 226a, 231 StGB;6411000;Darmstadt;M;272;0;0;1;2;6;9;6;18;24;55;88;19;13;32;35;60;31;15;11;184
222000;Gefährliche und schwere Körperverletzung, Verstümmelung weiblicher Genitalien §§ 224, 226, 226a, 231 StGB;6411000;Darmstadt;W;61;0;0;0;0;2;2;0;3;3;4;9;5;4;9;5;18;9;7;4;52
222000;Gefährliche und schwere Körperverletzung, Verstümmelung weiblicher Genitalien §§ 224, 226, 226a, 231 StGB;6411000;Darmstadt;X;333;0;0;1;2;8;11;6;21;27;59;97;24;17;41;40;78;40;22;15;236
222000;Gefährliche und schwere Körperverletzung, Verstümmelung weiblicher Genitalien §§ 224, 226, 226a, 231 StGB;5913000;Dortmund;M;1638;0;2;10;18;34;64;47;110;157;192;413;145;135;280;276;335;199;97;38;1225
222000;Gefährliche und schwere Körperverletzung, Verstümmelung weiblicher Genitalien §§ 224, 226, 226a, 231 StGB;5913000;Dortmund;W;262;0;0;0;0;8;8;13;24;37;25;70;21;17;38;34;56;33;18;13;192
222000;Gefährliche und schwere Körperverletzung, Verstümmelung weiblicher Genitalien §§ 224, 226, 226a, 231 StGB;5913000;Dortmund;X;1900;0;2;10;18;42;72;60;134;194;217;483;166;152;318;310;391;232;115;51;1417
222000;Gefährliche und schwere Körperverletzung, Verstümmelung weiblicher Genitalien §§ 224, 226, 226a, 231 StGB;14612000;Dresden;M;522;0;0;1;5;10;16;15;28;43;66;125;50;45;95;109;108;44;20;21;397
222000;Gefährliche und schwere Körperverletzung, Verstümmelung weiblicher Genitalien §§ 224, 226, 226a, 231 StGB;14612000;Dresden;W;79;0;0;0;0;7;7;9;5;14;6;27;2;6;8;11;10;7;8;8;52
222000;Gefährliche und schwere Körperverletzung, Verstümmelung weiblicher Genitalien §§ 224, 226, 226a, 231 StGB;14612000;Dresden;X;601;0;0;1;5;17;23;24;33;57;72;152;52;51;103;120;118;51;28;29;449
222000;Gefährliche und schwere Körperverletzung, Verstümmelung weiblicher Genitalien §§ 224, 226, 226a, 231 StGB;5112000;Duisburg;M;1069;0;9;10;12;49;80;62;75;137;116;333;86;73;159;142;215;125;68;27;736
222000;Gefährliche und schwere Körperverletzung, Verstümmelung weiblicher Genitalien §§ 224, 226, 226a, 231 StGB;5112000;Duisburg;W;192;0;0;2;0;6;8;9;14;23;15;46;9;11;20;23;43;38;14;8;146
222000;Gefährliche und schwere Körperverletzung, Verstümmelung weiblicher Genitalien §§ 224, 226, 226a, 231 StGB;5112000;Duisburg;X;1261;0;9;12;12;55;88;71;89;160;131;379;95;84;179;165;258;163;82;35;882
222000;Gefährliche und schwere Körperverletzung, Verstümmelung weiblicher Genitalien §§ 224, 226, 226a, 231 StGB;5111000;Düsseldorf;M;1469;0;2;8;16;18;44;45;85;130;239;413;151;120;271;225;304;163;60;33;1056
222000;Gefährliche und schwere Körperverletzung, Verstümmelung weiblicher Genitalien §§ 224, 226, 226a, 231 StGB;5111000;Düsseldorf;W;228;1;1;2;5;12;21;17;12;29;22;72;18;10;28;29;40;31;18;10;156
222000;Gefährliche und schwere Körperverletzung, Verstümmelung weiblicher Genitalien §§ 224, 226, 226a, 231 StGB;5111000;Düsseldorf;X;1697;1;3;10;21;30;65;62;97;159;261;485;169;130;299;254;344;194;78;43;1212
222000;Gefährliche und schwere Körperverletzung, Verstümmelung weiblicher Genitalien §§ 224, 226, 226a, 231 StGB;16051000;Erfurt;M;369;0;2;0;7;17;26;20;19;39;39;104;29;27;56;70;78;37;12;12;265
222000;Gefährliche und schwere Körperverletzung, Verstümmelung weiblicher Genitalien §§ 224, 226, 226a, 231 StGB;16051000;Erfurt;W;73;0;0;0;0;1;1;3;2;5;5;11;4;5;9;14;18;12;6;3;62
222000;Gefährliche und schwere Körperverletzung, Verstümmelung weiblicher Genitalien §§ 224, 226, 226a, 231 StGB;16051000;Erfurt;X;442;0;2;0;7;18;27;23;21;44;44;115;33;32;65;84;96;49;18;15;327
222000;Gefährliche und schwere Körperverletzung, Verstümmelung weiblicher Genitalien §§ 224, 226, 226a, 231 StGB;9562000;Erlangen;M;149;0;0;0;1;1;2;7;12;19;24;45;16;12;28;23;29;16;5;3;104
222000;Gefährliche und schwere Körperverletzung, Verstümmelung weiblicher Genitalien §§ 224, 226, 226a, 231 StGB;9562000;Erlangen;W;32;0;0;0;0;1;1;3;5;8;2;11;0;4;4;4;3;6;2;2;21
222000;Gefährliche und schwere Körperverletzung, Verstümmelung weiblicher Genitalien §§ 224, 226, 226a, 231 StGB;9562000;Erlangen;X;181;0;0;0;1;2;3;10;17;27;26;56;16;16;32;27;32;22;7;5;125
222000;Gefährliche und schwere Körperverletzung, Verstümmelung weiblicher Genitalien §§ 224, 226, 226a, 231 StGB;5113000;Essen;M;1013;0;0;2;10;30;42;53;67;120;141;303;78;72;150;135;196;138;62;29;710
222000;Gefährliche und schwere Körperverletzung, Verstümmelung weiblicher Genitalien §§ 224, 226, 226a, 231 StGB;5113000;Essen;W;225;0;0;1;1;11;13;27;19;46;17;76;15;11;26;32;43;27;17;4;149
222000;Gefährliche und schwere Körperverletzung, Verstümmelung weiblicher Genitalien §§ 224, 226, 226a, 231 StGB;5113000;Essen;X;1238;0;0;3;11;41;55;80;86;166;158;379;93;83;176;167;239;165;79;33;859
222000;Gefährliche und schwere Körperverletzung, Verstümmelung weiblicher Genitalien §§ 224, 226, 226a, 231 StGB;6412000;Frankfurt am Main;M;1884;0;1;17;18;34;70;49;106;155;227;452;128;124;252;306;431;273;112;58;1432
222000;Gefährliche und schwere Körperverletzung, Verstümmelung weiblicher Genitalien §§ 224, 226, 226a, 231 StGB;6412000;Frankfurt am Main;W;376;0;0;0;1;7;8;16;18;34;42;84;31;20;51;48;93;48;31;21;292
222000;Gefährliche und schwere Körperverletzung, Verstümmelung weiblicher Genitalien §§ 224, 226, 226a, 231 StGB;6412000;Frankfurt am Main;X;2260;0;1;17;19;41;78;65;124;189;269;536;159;144;303;354;524;321;143;79;1724
222000;Gefährliche und schwere Körperverletzung, Verstümmelung weiblicher Genitalien §§ 224, 226, 226a, 231 StGB;8311000;Freiburg im Breisgau;M;565;0;0;0;1;15;16;30;68;98;91;205;62;51;113;72;71;55;37;12;360
222000;Gefährliche und schwere Körperverletzung, Verstümmelung weiblicher Genitalien §§ 224, 226, 226a, 231 StGB;8311000;Freiburg im Breisgau;W;83;0;0;0;0;0;0;3;10;13;12;25;3;5;8;12;12;11;11;4;58
222000;Gefährliche und schwere Körperverletzung, Verstümmelung weiblicher Genitalien §§ 224, 226, 226a, 231 StGB;8311000;Freiburg im Breisgau;X;648;0;0;0;1;15;16;33;78;111;103;230;65;56;121;84;83;66;48;16;418
222000;Gefährliche und schwere Körperverletzung, Verstümmelung weiblicher Genitalien §§ 224, 226, 226a, 231 StGB;9563000;Fürth;M;156;0;0;1;4;6;11;13;7;20;22;53;7;9;16;26;29;16;8;8;103
222000;Gefährliche und schwere Körperverletzung, Verstümmelung weiblicher Genitalien §§ 224, 226, 226a, 231 StGB;9563000;Fürth;W;36;0;0;0;1;2;3;4;0;4;3;10;1;4;5;4;6;7;3;1;26
222000;Gefährliche und schwere Körperverletzung, Verstümmelung weiblicher Genitalien §§ 224, 226, 226a, 231 StGB;9563000;Fürth;X;192;0;0;1;5;8;14;17;7;24;25;63;8;13;21;30;35;23;11;9;129
222000;Gefährliche und schwere Körperverletzung, Verstümmelung weiblicher Genitalien §§ 224, 226, 226a, 231 StGB;5513000;Gelsenkirchen;M;641;0;0;4;7;20;31;34;41;75;95;201;50;49;99;79;100;101;50;11;440
222000;Gefährliche und schwere Körperverletzung, Verstümmelung weiblicher Genitalien §§ 224, 226, 226a, 231 StGB;5513000;Gelsenkirchen;W;118;0;0;0;1;7;8;16;7;23;7;38;5;6;11;16;21;20;7;5;80
222000;Gefährliche und schwere Körperverletzung, Verstümmelung weiblicher Genitalien §§ 224, 226, 226a, 231 StGB;5513000;Gelsenkirchen;X;759;0;0;4;8;27;39;50;48;98;102;239;55;55;110;95;121;121;57;16;520
222000;Gefährliche und schwere Körperverletzung, Verstümmelung weiblicher Genitalien §§ 224, 226, 226a, 231 StGB;3152012;Göttingen;M;269;0;0;0;1;3;4;20;22;42;40;86;19;31;50;39;44;29;12;9;183
222000;Gefährliche und schwere Körperverletzung, Verstümmelung weiblicher Genitalien §§ 224, 226, 226a, 231 StGB;3152012;Göttingen;W;37;0;0;0;0;0;0;0;4;4;4;8;1;2;3;9;8;7;1;1;29
222000;Gefährliche und schwere Körperverletzung, Verstümmelung weiblicher Genitalien §§ 224, 226, 226a, 231 StGB;3152012;Göttingen;X;306;0;0;0;1;3;4;20;26;46;44;94;20;33;53;48;52;36;13;10;212
222000;Gefährliche und schwere Körperverletzung, Verstümmelung weiblicher Genitalien §§ 224, 226, 226a, 231 StGB;5914000;Hagen;M;315;0;2;5;9;15;31;13;28;41;62;134;27;22;49;31;62;24;12;3;181
222000;Gefährliche und schwere Körperverletzung, Verstümmelung weiblicher Genitalien §§ 224, 226, 226a, 231 StGB;5914000;Hagen;W;51;0;0;0;1;6;7;11;8;19;6;32;1;1;2;6;4;4;2;1;19
222000;Gefährliche und schwere Körperverletzung, Verstümmelung weiblicher Genitalien §§ 224, 226, 226a, 231 StGB;5914000;Hagen;X;366;0;2;5;10;21;38;24;36;60;68;166;28;23;51;37;66;28;14;4;200
222000;Gefährliche und schwere Körperverletzung, Verstümmelung weiblicher Genitalien §§ 224, 226, 226a, 231 StGB;15002000;Halle (Saale);M;438;0;0;4;11;13;28;16;18;34;31;93;38;40;78;81;96;52;24;14;345
222000;Gefährliche und schwere Körperverletzung, Verstümmelung weiblicher Genitalien §§ 224, 226, 226a, 231 StGB;15002000;Halle (Saale);W;99;0;0;0;3;16;19;12;4;16;4;39;9;6;15;9;12;11;8;5;60
222000;Gefährliche und schwere Körperverletzung, Verstümmelung weiblicher Genitalien §§ 224, 226, 226a, 231 StGB;15002000;Halle (Saale);X;537;0;0;4;14;29;47;28;22;50;35;132;47;46;93;90;108;63;32;19;405
222000;Gefährliche und schwere Körperverletzung, Verstümmelung weiblicher Genitalien §§ 224, 226, 226a, 231 StGB;2000000;Hamburg;M;4803;6;29;78;111;144;368;187;327;514;529;1411;372;344;716;735;961;596;244;140;3392
222000;Gefährliche und schwere Körperverletzung, Verstümmelung weiblicher Genitalien §§ 224, 226, 226a, 231 StGB;2000000;Hamburg;W;978;0;6;4;17;49;76;66;49;115;79;270;62;55;117;128;198;159;64;42;708
222000;Gefährliche und schwere Körperverletzung, Verstümmelung weiblicher Genitalien §§ 224, 226, 226a, 231 StGB;2000000;Hamburg;X;5781;6;35;82;128;193;444;253;376;629;608;1681;434;399;833;863;1159;755;308;182;4100
222000;Gefährliche und schwere Körperverletzung, Verstümmelung weiblicher Genitalien §§ 224, 226, 226a, 231 StGB;5915000;Hamm;M;303;0;1;2;2;5;10;10;19;29;45;84;27;23;50;52;66;37;7;7;219
222000;Gefährliche und schwere Körperverletzung, Verstümmelung weiblicher Genitalien §§ 224, 226, 226a, 231 StGB;5915000;Hamm;W;65;0;0;0;0;1;1;8;7;15;10;26;8;2;10;8;6;9;2;4;39
222000;Gefährliche und schwere Körperverletzung, Verstümmelung weiblicher Genitalien §§ 224, 226, 226a, 231 StGB;5915000;Hamm;X;368;0;1;2;2;6;11;18;26;44;55;110;35;25;60;60;72;46;9;11;258
222000;Gefährliche und schwere Körperverletzung, Verstümmelung weiblicher Genitalien §§ 224, 226, 226a, 231 StGB;3241001;Hannover;M;1580;0;0;2;23;41;66;73;121;194;218;478;140;116;256;245;306;172;81;42;1102
222000;Gefährliche und schwere Körperverletzung, Verstümmelung weiblicher Genitalien §§ 224, 226, 226a, 231 StGB;3241001;Hannover;W;268;0;0;1;1;11;13;27;21;48;18;79;19;13;32;45;61;29;12;10;189
222000;Gefährliche und schwere Körperverletzung, Verstümmelung weiblicher Genitalien §§ 224, 226, 226a, 231 StGB;3241001;Hannover;X;1848;0;0;3;24;52;79;100;142;242;236;557;159;129;288;290;367;201;93;52;1291
222000;Gefährliche und schwere Körperverletzung, Verstümmelung weiblicher Genitalien §§ 224, 226, 226a, 231 StGB;8221000;Heidelberg;M;226;0;0;1;0;3;4;10;22;32;37;73;22;24;46;26;39;22;12;8;153
222000;Gefährliche und schwere Körperverletzung, Verstümmelung weiblicher Genitalien §§ 224, 226, 226a, 231 StGB;8221000;Heidelberg;W;32;0;0;0;0;1;1;3;2;5;3;9;1;3;4;8;4;4;3;0;23
222000;Gefährliche und schwere Körperverletzung, Verstümmelung weiblicher Genitalien §§ 224, 226, 226a, 231 StGB;8221000;Heidelberg;X;258;0;0;1;0;4;5;13;24;37;40;82;23;27;50;34;43;26;15;8;176
222000;Gefährliche und schwere Körperverletzung, Verstümmelung weiblicher Genitalien §§ 224, 226, 226a, 231 StGB;8121000;Heilbronn;M;221;0;0;0;1;0;1;6;17;23;27;51;15;15;30;38;53;28;11;10;170
222000;Gefährliche und schwere Körperverletzung, Verstümmelung weiblicher Genitalien §§ 224, 226, 226a, 231 StGB;8121000;Heilbronn;W;25;0;0;0;0;0;0;2;2;4;3;7;0;1;1;6;4;3;1;3;18
222000;Gefährliche und schwere Körperverletzung, Verstümmelung weiblicher Genitalien §§ 224, 226, 226a, 231 StGB;8121000;Heilbronn;X;246;0;0;0;1;0;1;8;19;27;30;58;15;16;31;44;57;31;12;13;188
222000;Gefährliche und schwere Körperverletzung, Verstümmelung weiblicher Genitalien §§ 224, 226, 226a, 231 StGB;5916000;Herne;M;240;0;1;1;5;2;9;9;16;25;20;54;13;14;27;46;43;41;22;7;186
222000;Gefährliche und schwere Körperverletzung, Verstümmelung weiblicher Genitalien §§ 224, 226, 226a, 231 StGB;5916000;Herne;W;43;0;0;0;0;1;1;1;4;5;8;14;2;1;3;7;6;11;0;2;29
222000;Gefährliche und schwere Körperverletzung, Verstümmelung weiblicher Genitalien §§ 224, 226, 226a, 231 StGB;5916000;Herne;X;283;0;1;1;5;3;10;10;20;30;28;68;15;15;30;53;49;52;22;9;215
222000;Gefährliche und schwere Körperverletzung, Verstümmelung weiblicher Genitalien §§ 224, 226, 226a, 231 StGB;9161000;Ingolstadt;M;243;0;0;0;5;3;8;7;13;20;26;54;29;16;45;45;58;20;14;7;189
222000;Gefährliche und schwere Körperverletzung, Verstümmelung weiblicher Genitalien §§ 224, 226, 226a, 231 StGB;9161000;Ingolstadt;W;66;0;0;0;0;2;2;9;2;11;7;20;4;1;5;6;13;9;8;5;46
222000;Gefährliche und schwere Körperverletzung, Verstümmelung weiblicher Genitalien §§ 224, 226, 226a, 231 StGB;9161000;Ingolstadt;X;309;0;0;0;5;5;10;16;15;31;33;74;33;17;50;51;71;29;22;12;235
222000;Gefährliche und schwere Körperverletzung, Verstümmelung weiblicher Genitalien §§ 224, 226, 226a, 231 StGB;16053000;Jena;M;117;0;0;0;1;3;4;10;6;16;8;28;8;12;20;19;29;7;10;4;89
222000;Gefährliche und schwere Körperverletzung, Verstümmelung weiblicher Genitalien §§ 224, 226, 226a, 231 StGB;16053000;Jena;W;21;0;0;0;1;3;4;1;1;2;0;6;3;2;5;2;1;4;1;2;15
222000;Gefährliche und schwere Körperverletzung, Verstümmelung weiblicher Genitalien §§ 224, 226, 226a, 231 StGB;16053000;Jena;X;138;0;0;0;2;6;8;11;7;18;8;34;11;14;25;21;30;11;11;6;104
222000;Gefährliche und schwere Körperverletzung, Verstümmelung weiblicher Genitalien §§ 224, 226, 226a, 231 StGB;8212000;Karlsruhe;M;516;0;0;2;2;6;10;14;32;46;68;124;59;32;91;87;109;66;22;17;392
222000;Gefährliche und schwere Körperverletzung, Verstümmelung weiblicher Genitalien §§ 224, 226, 226a, 231 StGB;8212000;Karlsruhe;W;77;0;0;0;0;3;3;4;3;7;5;15;5;8;13;9;20;10;6;4;62
222000;Gefährliche und schwere Körperverletzung, Verstümmelung weiblicher Genitalien §§ 224, 226, 226a, 231 StGB;8212000;Karlsruhe;X;593;0;0;2;2;9;13;18;35;53;73;139;64;40;104;96;129;76;28;21;454
222000;Gefährliche und schwere Körperverletzung, Verstümmelung weiblicher Genitalien §§ 224, 226, 226a, 231 StGB;6611000;Kassel;M;472;0;4;1;13;6;24;15;25;40;65;129;49;43;92;79;91;40;26;15;343
222000;Gefährliche und schwere Körperverletzung, Verstümmelung weiblicher Genitalien §§ 224, 226, 226a, 231 StGB;6611000;Kassel;W;92;0;0;0;1;2;3;8;8;16;12;31;8;7;15;11;15;9;5;6;61
222000;Gefährliche und schwere Körperverletzung, Verstümmelung weiblicher Genitalien §§ 224, 226, 226a, 231 StGB;6611000;Kassel;X;564;0;4;1;14;8;27;23;33;56;77;160;57;50;107;90;106;49;31;21;404
222000;Gefährliche und schwere Körperverletzung, Verstümmelung weiblicher Genitalien §§ 224, 226, 226a, 231 StGB;1002000;Kiel;M;545;0;0;5;0;2;7;23;30;53;80;140;51;53;104;98;98;57;31;17;405
222000;Gefährliche und schwere Körperverletzung, Verstümmelung weiblicher Genitalien §§ 224, 226, 226a, 231 StGB;1002000;Kiel;W;78;0;0;0;1;3;4;5;2;7;5;16;3;8;11;11;17;14;5;4;62
222000;Gefährliche und schwere Körperverletzung, Verstümmelung weiblicher Genitalien §§ 224, 226, 226a, 231 StGB;1002000;Kiel;X;623;0;0;5;1;5;11;28;32;60;85;156;54;61;115;109;115;71;36;21;467
222000;Gefährliche und schwere Körperverletzung, Verstümmelung weiblicher Genitalien §§ 224, 226, 226a, 231 StGB;7111000;Koblenz;M;270;0;0;3;1;2;6;20;21;41;42;89;35;18;53;38;50;17;17;6;181
222000;Gefährliche und schwere Körperverletzung, Verstümmelung weiblicher Genitalien §§ 224, 226, 226a, 231 StGB;7111000;Koblenz;W;54;0;0;0;0;5;5;7;2;9;7;21;7;2;9;8;6;5;3;2;33
222000;Gefährliche und schwere Körperverletzung, Verstümmelung weiblicher Genitalien §§ 224, 226, 226a, 231 StGB;7111000;Koblenz;X;324;0;0;3;1;7;11;27;23;50;49;110;42;20;62;46;56;22;20;8;214
222000;Gefährliche und schwere Körperverletzung, Verstümmelung weiblicher Genitalien §§ 224, 226, 226a, 231 StGB;5315000;Köln;M;3237;0;4;19;35;70;128;110;215;325;391;844;249;239;488;487;662;463;193;100;2393
222000;Gefährliche und schwere Körperverletzung, Verstümmelung weiblicher Genitalien §§ 224, 226, 226a, 231 StGB;5315000;Köln;W;726;0;3;1;0;31;35;59;50;109;85;229;32;47;79;89;142;108;54;25;497
222000;Gefährliche und schwere Körperverletzung, Verstümmelung weiblicher Genitalien §§ 224, 226, 226a, 231 StGB;5315000;Köln;X;3963;0;7;20;35;101;163;169;265;434;476;1073;281;286;567;576;804;571;247;125;2890
222000;Gefährliche und schwere Körperverletzung, Verstümmelung weiblicher Genitalien §§ 224, 226, 226a, 231 StGB;5114000;Krefeld;M;368;0;0;1;2;6;9;8;23;31;41;81;32;28;60;62;68;51;35;11;287
222000;Gefährliche und schwere Körperverletzung, Verstümmelung weiblicher Genitalien §§ 224, 226, 226a, 231 StGB;5114000;Krefeld;W;82;0;0;1;0;7;8;16;10;26;6;40;4;3;7;10;6;9;7;3;42
222000;Gefährliche und schwere Körperverletzung, Verstümmelung weiblicher Genitalien §§ 224, 226, 226a, 231 StGB;5114000;Krefeld;X;450;0;0;2;2;13;17;24;33;57;47;121;36;31;67;72;74;60;42;14;329
222000;Gefährliche und schwere Körperverletzung, Verstümmelung weiblicher Genitalien §§ 224, 226, 226a, 231 StGB;14713000;Leipzig;M;875;0;1;0;13;30;44;21;39;60;91;195;77;84;161;173;177;109;39;21;680
222000;Gefährliche und schwere Körperverletzung, Verstümmelung weiblicher Genitalien §§ 224, 226, 226a, 231 StGB;14713000;Leipzig;W;154;0;0;1;0;9;10;13;8;21;10;41;5;10;15;26;31;20;13;8;113
222000;Gefährliche und schwere Körperverletzung, Verstümmelung weiblicher Genitalien §§ 224, 226, 226a, 231 StGB;14713000;Leipzig;X;1029;0;1;1;13;39;54;34;47;81;101;236;82;94;176;199;208;129;52;29;793
222000;Gefährliche und schwere Körperverletzung, Verstümmelung weiblicher Genitalien §§ 224, 226, 226a, 231 StGB;5316000;Leverkusen;M;360;0;0;0;2;13;15;12;34;46;38;99;37;32;69;46;66;45;13;22;261
222000;Gefährliche und schwere Körperverletzung, Verstümmelung weiblicher Genitalien §§ 224, 226, 226a, 231 StGB;5316000;Leverkusen;W;84;0;0;0;0;3;3;7;6;13;5;21;6;3;9;11;16;14;8;5;63
222000;Gefährliche und schwere Körperverletzung, Verstümmelung weiblicher Genitalien §§ 224, 226, 226a, 231 StGB;5316000;Leverkusen;X;444;0;0;0;2;16;18;19;40;59;43;120;43;35;78;57;82;59;21;27;324
222000;Gefährliche und schwere Körperverletzung, Verstümmelung weiblicher Genitalien §§ 224, 226, 226a, 231 StGB;1003000;Lübeck;M;537;0;2;1;4;13;20;18;25;43;50;113;53;42;95;87;104;84;40;14;424
222000;Gefährliche und schwere Körperverletzung, Verstümmelung weiblicher Genitalien §§ 224, 226, 226a, 231 StGB;1003000;Lübeck;W;96;0;0;0;0;8;8;6;5;11;6;25;8;12;20;6;20;11;7;7;71
222000;Gefährliche und schwere Körperverletzung, Verstümmelung weiblicher Genitalien §§ 224, 226, 226a, 231 StGB;1003000;Lübeck;X;633;0;2;1;4;21;28;24;30;54;56;138;61;54;115;93;124;95;47;21;495
222000;Gefährliche und schwere Körperverletzung, Verstümmelung weiblicher Genitalien §§ 224, 226, 226a, 231 StGB;7314000;Ludwigshafen am Rhein;M;499;0;0;3;12;13;28;20;28;48;61;137;42;37;79;73;90;67;37;16;362
222000;Gefährliche und schwere Körperverletzung, Verstümmelung weiblicher Genitalien §§ 224, 226, 226a, 231 StGB;7314000;Ludwigshafen am Rhein;W;139;0;0;0;0;8;8;8;1;9;13;30;16;10;26;10;32;24;12;5;109
222000;Gefährliche und schwere Körperverletzung, Verstümmelung weiblicher Genitalien §§ 224, 226, 226a, 231 StGB;7314000;Ludwigshafen am Rhein;X;638;0;0;3;12;21;36;28;29;57;74;167;58;47;105;83;122;91;49;21;471
222000;Gefährliche und schwere Körperverletzung, Verstümmelung weiblicher Genitalien §§ 224, 226, 226a, 231 StGB;15003000;Magdeburg;M;407;0;0;2;8;15;25;26;28;54;50;129;30;29;59;70;74;52;14;9;278
222000;Gefährliche und schwere Körperverletzung, Verstümmelung weiblicher Genitalien §§ 224, 226, 226a, 231 StGB;15003000;Magdeburg;W;72;0;0;0;0;3;3;8;8;16;7;26;3;6;9;7;16;8;3;3;46
222000;Gefährliche und schwere Körperverletzung, Verstümmelung weiblicher Genitalien §§ 224, 226, 226a, 231 StGB;15003000;Magdeburg;X;479;0;0;2;8;18;28;34;36;70;57;155;33;35;68;77;90;60;17;12;324
222000;Gefährliche und schwere Körperverletzung, Verstümmelung weiblicher Genitalien §§ 224, 226, 226a, 231 StGB;7315000;Mainz;M;428;0;0;1;3;5;9;19;40;59;77;145;38;29;67;78;68;48;14;8;283
222000;Gefährliche und schwere Körperverletzung, Verstümmelung weiblicher Genitalien §§ 224, 226, 226a, 231 StGB;7315000;Mainz;W;78;0;0;0;0;2;2;6;6;12;12;26;4;5;9;11;16;8;6;2;52
222000;Gefährliche und schwere Körperverletzung, Verstümmelung weiblicher Genitalien §§ 224, 226, 226a, 231 StGB;7315000;Mainz;X;506;0;0;1;3;7;11;25;46;71;89;171;42;34;76;89;84;56;20;10;335
222000;Gefährliche und schwere Körperverletzung, Verstümmelung weiblicher Genitalien §§ 224, 226, 226a, 231 StGB;8222000;Mannheim;M;610;0;0;2;3;24;29;22;43;65;85;179;49;47;96;77;132;72;38;16;431
222000;Gefährliche und schwere Körperverletzung, Verstümmelung weiblicher Genitalien §§ 224, 226, 226a, 231 StGB;8222000;Mannheim;W;117;0;0;0;0;3;3;9;11;20;12;35;10;9;19;11;18;15;9;10;82
222000;Gefährliche und schwere Körperverletzung, Verstümmelung weiblicher Genitalien §§ 224, 226, 226a, 231 StGB;8222000;Mannheim;X;727;0;0;2;3;27;32;31;54;85;97;214;59;56;115;88;150;87;47;26;513
222000;Gefährliche und schwere Körperverletzung, Verstümmelung weiblicher Genitalien §§ 224, 226, 226a, 231 StGB;5170024;Moers;M;150;0;0;4;5;3;12;6;8;14;19;45;24;8;32;21;24;15;8;5;105
222000;Gefährliche und schwere Körperverletzung, Verstümmelung weiblicher Genitalien §§ 224, 226, 226a, 231 StGB;5170024;Moers;W;27;0;0;0;0;2;2;5;2;7;1;10;1;2;3;2;6;2;0;4;17
222000;Gefährliche und schwere Körperverletzung, Verstümmelung weiblicher Genitalien §§ 224, 226, 226a, 231 StGB;5170024;Moers;X;177;0;0;4;5;5;14;11;10;21;20;55;25;10;35;23;30;17;8;9;122
222000;Gefährliche und schwere Körperverletzung, Verstümmelung weiblicher Genitalien §§ 224, 226, 226a, 231 StGB;5116000;Mönchengladbach;M;508;0;0;0;0;10;10;24;25;49;79;138;40;36;76;100;84;65;34;11;370
222000;Gefährliche und schwere Körperverletzung, Verstümmelung weiblicher Genitalien §§ 224, 226, 226a, 231 StGB;5116000;Mönchengladbach;W;105;0;0;0;0;11;11;15;5;20;7;38;8;6;14;11;21;9;8;4;67
222000;Gefährliche und schwere Körperverletzung, Verstümmelung weiblicher Genitalien §§ 224, 226, 226a, 231 StGB;5116000;Mönchengladbach;X;613;0;0;0;0;21;21;39;30;69;86;176;48;42;90;111;105;74;42;15;437
222000;Gefährliche und schwere Körperverletzung, Verstümmelung weiblicher Genitalien §§ 224, 226, 226a, 231 StGB;5117000;Mülheim an der Ruhr;M;241;0;0;0;5;9;14;12;17;29;30;73;16;15;31;30;49;30;18;10;168
222000;Gefährliche und schwere Körperverletzung, Verstümmelung weiblicher Genitalien §§ 224, 226, 226a, 231 StGB;5117000;Mülheim an der Ruhr;W;56;0;0;0;0;3;3;1;3;4;4;11;4;1;5;7;11;15;4;3;45
222000;Gefährliche und schwere Körperverletzung, Verstümmelung weiblicher Genitalien §§ 224, 226, 226a, 231 StGB;5117000;Mülheim an der Ruhr;X;297;0;0;0;5;12;17;13;20;33;34;84;20;16;36;37;60;45;22;13;213
222000;Gefährliche und schwere Körperverletzung, Verstümmelung weiblicher Genitalien §§ 224, 226, 226a, 231 StGB;9162000;München;M;2778;0;2;9;16;48;75;107;204;311;386;772;254;237;491;409;549;351;129;77;2006
222000;Gefährliche und schwere Körperverletzung, Verstümmelung weiblicher Genitalien §§ 224, 226, 226a, 231 StGB;9162000;München;W;590;0;0;3;1;18;22;47;35;82;54;158;30;33;63;74;128;83;55;29;432
222000;Gefährliche und schwere Körperverletzung, Verstümmelung weiblicher Genitalien §§ 224, 226, 226a, 231 StGB;9162000;München;X;3368;0;2;12;17;66;97;154;239;393;440;930;284;270;554;483;677;434;184;106;2438
222000;Gefährliche und schwere Körperverletzung, Verstümmelung weiblicher Genitalien §§ 224, 226, 226a, 231 StGB;5515000;Münster;M;464;0;2;0;3;13;18;27;39;66;66;150;47;38;85;60;85;47;26;11;314
222000;Gefährliche und schwere Körperverletzung, Verstümmelung weiblicher Genitalien §§ 224, 226, 226a, 231 StGB;5515000;Münster;W;75;0;1;0;0;3;4;13;8;21;12;37;2;4;6;5;15;6;4;2;38
222000;Gefährliche und schwere Körperverletzung, Verstümmelung weiblicher Genitalien §§ 224, 226, 226a, 231 StGB;5515000;Münster;X;539;0;3;0;3;16;22;40;47;87;78;187;49;42;91;65;100;53;30;13;352
222000;Gefährliche und schwere Körperverletzung, Verstümmelung weiblicher Genitalien §§ 224, 226, 226a, 231 StGB;5162024;Neuss;M;217;0;0;3;0;5;8;9;21;30;30;68;18;13;31;34;36;34;10;4;149
222000;Gefährliche und schwere Körperverletzung, Verstümmelung weiblicher Genitalien §§ 224, 226, 226a, 231 StGB;5162024;Neuss;W;34;0;0;0;0;0;0;6;3;9;4;13;4;1;5;0;6;6;2;2;21
222000;Gefährliche und schwere Körperverletzung, Verstümmelung weiblicher Genitalien §§ 224, 226, 226a, 231 StGB;5162024;Neuss;X;251;0;0;3;0;5;8;15;24;39;34;81;22;14;36;34;42;40;12;6;170
222000;Gefährliche und schwere Körperverletzung, Verstümmelung weiblicher Genitalien §§ 224, 226, 226a, 231 StGB;9564000;Nürnberg;M;1118;0;1;0;13;23;37;30;71;101;129;267;127;97;224;175;216;142;54;40;851
222000;Gefährliche und schwere Körperverletzung, Verstümmelung weiblicher Genitalien §§ 224, 226, 226a, 231 StGB;9564000;Nürnberg;W;259;0;0;2;3;7;12;11;16;27;26;65;19;18;37;35;57;36;17;12;194
222000;Gefährliche und schwere Körperverletzung, Verstümmelung weiblicher Genitalien §§ 224, 226, 226a, 231 StGB;9564000;Nürnberg;X;1377;0;1;2;16;30;49;41;87;128;155;332;146;115;261;210;273;178;71;52;1045
222000;Gefährliche und schwere Körperverletzung, Verstümmelung weiblicher Genitalien §§ 224, 226, 226a, 231 StGB;5119000;Oberhausen;M;380;0;0;1;7;8;16;11;16;27;41;84;35;31;66;54;81;56;25;14;296
222000;Gefährliche und schwere Körperverletzung, Verstümmelung weiblicher Genitalien §§ 224, 226, 226a, 231 StGB;5119000;Oberhausen;W;89;0;0;0;2;11;13;8;6;14;9;36;3;6;9;11;11;12;5;5;53
222000;Gefährliche und schwere Körperverletzung, Verstümmelung weiblicher Genitalien §§ 224, 226, 226a, 231 StGB;5119000;Oberhausen;X;469;0;0;1;9;19;29;19;22;41;50;120;38;37;75;65;92;68;30;19;349
222000;Gefährliche und schwere Körperverletzung, Verstümmelung weiblicher Genitalien §§ 224, 226, 226a, 231 StGB;6413000;Offenbach am Main;M;285;0;0;0;0;1;1;16;19;35;19;55;16;22;38;58;66;37;18;13;230
222000;Gefährliche und schwere Körperverletzung, Verstümmelung weiblicher Genitalien §§ 224, 226, 226a, 231 StGB;6413000;Offenbach am Main;W;57;0;0;0;1;1;2;9;4;13;6;21;2;1;3;9;15;4;4;1;36
222000;Gefährliche und schwere Körperverletzung, Verstümmelung weiblicher Genitalien §§ 224, 226, 226a, 231 StGB;6413000;Offenbach am Main;X;342;0;0;0;1;2;3;25;23;48;25;76;18;23;41;67;81;41;22;14;266
222000;Gefährliche und schwere Körperverletzung, Verstümmelung weiblicher Genitalien §§ 224, 226, 226a, 231 StGB;3403000;Oldenburg (Oldenburg);M;299;0;0;4;2;4;10;18;23;41;41;92;18;23;41;58;46;36;21;5;207
222000;Gefährliche und schwere Körperverletzung, Verstümmelung weiblicher Genitalien §§ 224, 226, 226a, 231 StGB;3403000;Oldenburg (Oldenburg);W;53;0;0;0;0;1;1;4;6;10;8;19;4;3;7;4;6;12;2;3;34
222000;Gefährliche und schwere Körperverletzung, Verstümmelung weiblicher Genitalien §§ 224, 226, 226a, 231 StGB;3403000;Oldenburg (Oldenburg);X;352;0;0;4;2;5;11;22;29;51;49;111;22;26;48;62;52;48;23;8;241
222000;Gefährliche und schwere Körperverletzung, Verstümmelung weiblicher Genitalien §§ 224, 226, 226a, 231 StGB;3404000;Osnabrück;M;476;0;1;2;9;8;20;18;21;39;84;143;30;51;81;77;105;40;23;7;333
222000;Gefährliche und schwere Körperverletzung, Verstümmelung weiblicher Genitalien §§ 224, 226, 226a, 231 StGB;3404000;Osnabrück;W;78;0;0;0;2;3;5;12;8;20;8;33;3;3;6;9;11;10;7;2;45
222000;Gefährliche und schwere Körperverletzung, Verstümmelung weiblicher Genitalien §§ 224, 226, 226a, 231 StGB;3404000;Osnabrück;X;554;0;1;2;11;11;25;30;29;59;92;176;33;54;87;86;116;50;30;9;378
222000;Gefährliche und schwere Körperverletzung, Verstümmelung weiblicher Genitalien §§ 224, 226, 226a, 231 StGB;5774032;Paderborn;M;245;0;0;2;1;6;9;9;21;30;41;80;21;18;39;32;52;20;15;7;165
222000;Gefährliche und schwere Körperverletzung, Verstümmelung weiblicher Genitalien §§ 224, 226, 226a, 231 StGB;5774032;Paderborn;W;32;0;0;0;0;0;0;0;2;2;5;7;0;1;1;6;13;4;1;0;25
222000;Gefährliche und schwere Körperverletzung, Verstümmelung weiblicher Genitalien §§ 224, 226, 226a, 231 StGB;5774032;Paderborn;X;277;0;0;2;1;6;9;9;23;32;46;87;21;19;40;38;65;24;16;7;190
222000;Gefährliche und schwere Körperverletzung, Verstümmelung weiblicher Genitalien §§ 224, 226, 226a, 231 StGB;8231000;Pforzheim;M;257;0;0;0;5;5;10;13;24;37;22;69;20;21;41;47;54;22;17;7;188
222000;Gefährliche und schwere Körperverletzung, Verstümmelung weiblicher Genitalien §§ 224, 226, 226a, 231 StGB;8231000;Pforzheim;W;41;0;0;0;0;0;0;4;0;4;5;9;3;1;4;7;9;9;2;1;32
222000;Gefährliche und schwere Körperverletzung, Verstümmelung weiblicher Genitalien §§ 224, 226, 226a, 231 StGB;8231000;Pforzheim;X;298;0;0;0;5;5;10;17;24;41;27;78;23;22;45;54;63;31;19;8;220
222000;Gefährliche und schwere Körperverletzung, Verstümmelung weiblicher Genitalien §§ 224, 226, 226a, 231 StGB;12054000;Potsdam;M;149;1;0;0;2;3;6;9;9;18;13;37;16;12;28;26;32;16;5;5;112
222000;Gefährliche und schwere Körperverletzung, Verstümmelung weiblicher Genitalien §§ 224, 226, 226a, 231 StGB;12054000;Potsdam;W;26;0;0;0;0;0;0;2;0;2;4;6;0;3;3;3;6;4;3;1;20
222000;Gefährliche und schwere Körperverletzung, Verstümmelung weiblicher Genitalien §§ 224, 226, 226a, 231 StGB;12054000;Potsdam;X;175;1;0;0;2;3;6;11;9;20;17;43;16;15;31;29;38;20;8;6;132
222000;Gefährliche und schwere Körperverletzung, Verstümmelung weiblicher Genitalien §§ 224, 226, 226a, 231 StGB;5562032;Recklinghausen;M;240;0;0;1;6;8;15;16;22;38;29;82;19;17;36;38;33;23;14;14;158
222000;Gefährliche und schwere Körperverletzung, Verstümmelung weiblicher Genitalien §§ 224, 226, 226a, 231 StGB;5562032;Recklinghausen;W;63;0;0;0;1;4;5;9;5;14;12;31;4;3;7;4;10;7;3;1;32
222000;Gefährliche und schwere Körperverletzung, Verstümmelung weiblicher Genitalien §§ 224, 226, 226a, 231 StGB;5562032;Recklinghausen;X;303;0;0;1;7;12;20;25;27;52;41;113;23;20;43;42;43;30;17;15;190
222000;Gefährliche und schwere Körperverletzung, Verstümmelung weiblicher Genitalien §§ 224, 226, 226a, 231 StGB;9362000;Regensburg;M;254;0;2;0;0;1;3;6;17;23;41;67;27;27;54;56;51;18;6;2;187
222000;Gefährliche und schwere Körperverletzung, Verstümmelung weiblicher Genitalien §§ 224, 226, 226a, 231 StGB;9362000;Regensburg;W;40;0;0;0;0;0;0;3;2;5;5;10;3;4;7;6;7;5;4;1;30
222000;Gefährliche und schwere Körperverletzung, Verstümmelung weiblicher Genitalien §§ 224, 226, 226a, 231 StGB;9362000;Regensburg;X;294;0;2;0;0;1;3;9;19;28;46;77;30;31;61;62;58;23;10;3;217
222000;Gefährliche und schwere Körperverletzung, Verstümmelung weiblicher Genitalien §§ 224, 226, 226a, 231 StGB;5120000;Remscheid;M;160;0;0;3;3;4;10;4;5;9;28;47;7;11;18;24;36;16;13;6;113
222000;Gefährliche und schwere Körperverletzung, Verstümmelung weiblicher Genitalien §§ 224, 226, 226a, 231 StGB;5120000;Remscheid;W;34;0;0;0;0;0;0;2;3;5;3;8;2;4;6;3;6;6;3;2;26
222000;Gefährliche und schwere Körperverletzung, Verstümmelung weiblicher Genitalien §§ 224, 226, 226a, 231 StGB;5120000;Remscheid;X;194;0;0;3;3;4;10;6;8;14;31;55;9;15;24;27;42;22;16;8;139
222000;Gefährliche und schwere Körperverletzung, Verstümmelung weiblicher Genitalien §§ 224, 226, 226a, 231 StGB;8415061;Reutlingen;M;197;0;0;0;0;1;1;4;13;17;38;56;22;14;36;35;32;25;12;1;141
222000;Gefährliche und schwere Körperverletzung, Verstümmelung weiblicher Genitalien §§ 224, 226, 226a, 231 StGB;8415061;Reutlingen;W;27;0;0;0;0;1;1;1;5;6;3;10;1;2;3;6;4;3;1;0;17
222000;Gefährliche und schwere Körperverletzung, Verstümmelung weiblicher Genitalien §§ 224, 226, 226a, 231 StGB;8415061;Reutlingen;X;224;0;0;0;0;2;2;5;18;23;41;66;23;16;39;41;36;28;13;1;158
222000;Gefährliche und schwere Körperverletzung, Verstümmelung weiblicher Genitalien §§ 224, 226, 226a, 231 StGB;13003000;Rostock;M;324;0;0;1;10;11;22;16;17;33;35;90;22;29;51;64;70;27;16;6;234
222000;Gefährliche und schwere Körperverletzung, Verstümmelung weiblicher Genitalien §§ 224, 226, 226a, 231 StGB;13003000;Rostock;W;49;0;0;0;0;2;2;3;6;9;4;15;6;1;7;10;7;5;3;2;34
222000;Gefährliche und schwere Körperverletzung, Verstümmelung weiblicher Genitalien §§ 224, 226, 226a, 231 StGB;13003000;Rostock;X;373;0;0;1;10;13;24;19;23;42;39;105;28;30;58;74;77;32;19;8;268
222000;Gefährliche und schwere Körperverletzung, Verstümmelung weiblicher Genitalien §§ 224, 226, 226a, 231 StGB;10041100;Saarbrücken;M;529;0;0;3;3;8;14;22;42;64;78;156;39;46;85;88;110;53;22;15;373
222000;Gefährliche und schwere Körperverletzung, Verstümmelung weiblicher Genitalien §§ 224, 226, 226a, 231 StGB;10041100;Saarbrücken;W;110;0;0;0;1;1;2;5;8;13;11;26;6;9;15;13;24;18;10;4;84
222000;Gefährliche und schwere Körperverletzung, Verstümmelung weiblicher Genitalien §§ 224, 226, 226a, 231 StGB;10041100;Saarbrücken;X;639;0;0;3;4;9;16;27;50;77;89;182;45;55;100;101;134;71;32;19;457
222000;Gefährliche und schwere Körperverletzung, Verstümmelung weiblicher Genitalien §§ 224, 226, 226a, 231 StGB;5122000;Solingen;M;236;0;0;1;6;7;14;17;24;41;30;85;15;21;36;26;38;32;13;6;151
222000;Gefährliche und schwere Körperverletzung, Verstümmelung weiblicher Genitalien §§ 224, 226, 226a, 231 StGB;5122000;Solingen;W;50;0;0;1;1;3;5;3;3;6;6;17;6;2;8;4;7;11;2;1;33
222000;Gefährliche und schwere Körperverletzung, Verstümmelung weiblicher Genitalien §§ 224, 226, 226a, 231 StGB;5122000;Solingen;X;286;0;0;2;7;10;19;20;27;47;36;102;21;23;44;30;45;43;15;7;184
222000;Gefährliche und schwere Körperverletzung, Verstümmelung weiblicher Genitalien §§ 224, 226, 226a, 231 StGB;8111000;Stuttgart;M;1615;1;5;10;10;30;56;50;99;149;212;417;145;145;290;291;328;181;65;43;1198
222000;Gefährliche und schwere Körperverletzung, Verstümmelung weiblicher Genitalien §§ 224, 226, 226a, 231 StGB;8111000;Stuttgart;W;254;0;0;4;7;12;23;18;16;34;25;82;14;11;25;36;46;38;13;14;172
222000;Gefährliche und schwere Körperverletzung, Verstümmelung weiblicher Genitalien §§ 224, 226, 226a, 231 StGB;8111000;Stuttgart;X;1869;1;5;14;17;42;79;68;115;183;237;499;159;156;315;327;374;219;78;57;1370
222000;Gefährliche und schwere Körperverletzung, Verstümmelung weiblicher Genitalien §§ 224, 226, 226a, 231 StGB;7211000;Trier;M;241;0;0;0;4;5;9;6;18;24;37;70;26;29;55;36;45;25;6;4;171
222000;Gefährliche und schwere Körperverletzung, Verstümmelung weiblicher Genitalien §§ 224, 226, 226a, 231 StGB;7211000;Trier;W;46;0;0;0;1;0;1;4;4;8;3;12;2;7;9;7;6;6;4;2;34
222000;Gefährliche und schwere Körperverletzung, Verstümmelung weiblicher Genitalien §§ 224, 226, 226a, 231 StGB;7211000;Trier;X;287;0;0;0;5;5;10;10;22;32;40;82;28;36;64;43;51;31;10;6;205
222000;Gefährliche und schwere Körperverletzung, Verstümmelung weiblicher Genitalien §§ 224, 226, 226a, 231 StGB;8421000;Ulm;M;241;0;1;2;2;2;7;13;27;40;28;75;26;19;45;35;36;28;11;11;166
222000;Gefährliche und schwere Körperverletzung, Verstümmelung weiblicher Genitalien §§ 224, 226, 226a, 231 StGB;8421000;Ulm;W;40;0;0;0;0;4;4;0;3;3;8;15;1;0;1;7;5;8;3;1;25
222000;Gefährliche und schwere Körperverletzung, Verstümmelung weiblicher Genitalien §§ 224, 226, 226a, 231 StGB;8421000;Ulm;X;281;0;1;2;2;6;11;13;30;43;36;90;27;19;46;42;41;36;14;12;191
222000;Gefährliche und schwere Körperverletzung, Verstümmelung weiblicher Genitalien §§ 224, 226, 226a, 231 StGB;6414000;Wiesbaden;M;689;0;2;5;11;24;42;28;47;75;114;231;63;45;108;98;104;85;39;24;458
222000;Gefährliche und schwere Körperverletzung, Verstümmelung weiblicher Genitalien §§ 224, 226, 226a, 231 StGB;6414000;Wiesbaden;W;133;0;0;0;4;9;13;18;14;32;10;55;3;7;10;17;18;12;13;8;78
222000;Gefährliche und schwere Körperverletzung, Verstümmelung weiblicher Genitalien §§ 224, 226, 226a, 231 StGB;6414000;Wiesbaden;X;822;0;2;5;15;33;55;46;61;107;124;286;66;52;118;115;122;97;52;32;536
222000;Gefährliche und schwere Körperverletzung, Verstümmelung weiblicher Genitalien §§ 224, 226, 226a, 231 StGB;3103000;Wolfsburg;M;211;0;0;1;2;3;6;11;21;32;36;74;23;25;48;39;31;8;6;5;137
222000;Gefährliche und schwere Körperverletzung, Verstümmelung weiblicher Genitalien §§ 224, 226, 226a, 231 StGB;3103000;Wolfsburg;W;40;0;0;0;0;3;3;9;3;12;3;18;3;1;4;4;8;2;1;3;22
222000;Gefährliche und schwere Körperverletzung, Verstümmelung weiblicher Genitalien §§ 224, 226, 226a, 231 StGB;3103000;Wolfsburg;X;251;0;0;1;2;6;9;20;24;44;39;92;26;26;52;43;39;10;7;8;159
222000;Gefährliche und schwere Körperverletzung, Verstümmelung weiblicher Genitalien §§ 224, 226, 226a, 231 StGB;5124000;Wuppertal;M;682;0;1;3;6;20;30;36;56;92;75;197;52;48;100;100;143;90;41;11;485
222000;Gefährliche und schwere Körperverletzung, Verstümmelung weiblicher Genitalien §§ 224, 226, 226a, 231 StGB;5124000;Wuppertal;W;149;0;0;0;0;4;4;16;15;31;10;45;14;10;24;13;28;17;13;9;104
222000;Gefährliche und schwere Körperverletzung, Verstümmelung weiblicher Genitalien §§ 224, 226, 226a, 231 StGB;5124000;Wuppertal;X;831;0;1;3;6;24;34;52;71;123;85;242;66;58;124;113;171;107;54;20;589
222000;Gefährliche und schwere Körperverletzung, Verstümmelung weiblicher Genitalien §§ 224, 226, 226a, 231 StGB;9663000;Würzburg;M;236;0;0;0;1;0;1;7;20;27;42;70;38;18;56;42;37;18;9;4;166
222000;Gefährliche und schwere Körperverletzung, Verstümmelung weiblicher Genitalien §§ 224, 226, 226a, 231 StGB;9663000;Würzburg;W;43;0;0;0;0;0;0;1;8;9;2;11;6;2;8;4;7;9;1;3;32
222000;Gefährliche und schwere Körperverletzung, Verstümmelung weiblicher Genitalien §§ 224, 226, 226a, 231 StGB;9663000;Würzburg;X;279;0;0;0;1;0;1;8;28;36;44;81;44;20;64;46;44;27;10;7;198
224000;Vorsätzliche einfache Körperverletzung § 223 StGB;5334002;Aachen;M;1033;0;0;0;5;7;12;22;56;78;106;196;58;75;133;136;219;189;104;56;837
224000;Vorsätzliche einfache Körperverletzung § 223 StGB;5334002;Aachen;W;230;0;0;1;2;4;7;7;14;21;26;54;24;16;40;34;35;47;10;10;176
224000;Vorsätzliche einfache Körperverletzung § 223 StGB;5334002;Aachen;X;1263;0;0;1;7;11;19;29;70;99;132;250;82;91;173;170;254;236;114;66;1013
224000;Vorsätzliche einfache Körperverletzung § 223 StGB;9761000;Augsburg;M;1607;0;0;4;6;12;22;41;52;93;171;286;141;122;263;250;341;266;138;63;1321
224000;Vorsätzliche einfache Körperverletzung § 223 StGB;9761000;Augsburg;W;368;0;1;0;2;5;8;14;16;30;36;74;26;28;54;44;79;61;38;18;294
224000;Vorsätzliche einfache Körperverletzung § 223 StGB;9761000;Augsburg;X;1975;0;1;4;8;17;30;55;68;123;207;360;167;150;317;294;420;327;176;81;1615
224000;Vorsätzliche einfache Körperverletzung § 223 StGB;5378004;Bergisch Gladbach;M;283;0;0;0;3;7;10;11;10;21;22;53;17;16;33;36;61;52;32;16;230
224000;Vorsätzliche einfache Körperverletzung § 223 StGB;5378004;Bergisch Gladbach;W;80;0;0;0;0;1;1;9;2;11;9;21;2;6;8;10;17;15;8;1;59
224000;Vorsätzliche einfache Körperverletzung § 223 StGB;5378004;Bergisch Gladbach;X;363;0;0;0;3;8;11;20;12;32;31;74;19;22;41;46;78;67;40;17;289
224000;Vorsätzliche einfache Körperverletzung § 223 StGB;11000000;Berlin;M;16240;1;35;91;161;281;569;421;487;908;905;2382;742;876;1618;2289;4241;3140;1760;810;13858
224000;Vorsätzliche einfache Körperverletzung § 223 StGB;11000000;Berlin;W;4123;0;6;12;28;88;134;164;164;328;251;713;207;229;436;584;1075;742;367;206;3410
224000;Vorsätzliche einfache Körperverletzung § 223 StGB;11000000;Berlin;X;20363;1;41;103;189;369;703;585;651;1236;1156;3095;949;1105;2054;2873;5316;3882;2127;1016;17268
224000;Vorsätzliche einfache Körperverletzung § 223 StGB;5711000;Bielefeld;M;1183;0;1;1;3;15;20;25;50;75;89;184;85;78;163;188;287;217;92;52;999
224000;Vorsätzliche einfache Körperverletzung § 223 StGB;5711000;Bielefeld;W;239;0;0;0;0;5;5;6;9;15;23;43;15;9;24;37;56;43;21;15;196
224000;Vorsätzliche einfache Körperverletzung § 223 StGB;5711000;Bielefeld;X;1422;0;1;1;3;20;25;31;59;90;112;227;100;87;187;225;343;260;113;67;1195
224000;Vorsätzliche einfache Körperverletzung § 223 StGB;5911000;Bochum;M;1696;0;3;2;8;25;38;48;59;107;138;283;114;118;232;257;366;320;162;76;1413
224000;Vorsätzliche einfache Körperverletzung § 223 StGB;5911000;Bochum;W;393;0;0;0;1;1;2;16;18;34;35;71;26;25;51;49;96;79;32;15;322
224000;Vorsätzliche einfache Körperverletzung § 223 StGB;5911000;Bochum;X;2089;0;3;2;9;26;40;64;77;141;173;354;140;143;283;306;462;399;194;91;1735
224000;Vorsätzliche einfache Körperverletzung § 223 StGB;5314000;Bonn;M;1271;0;4;4;4;10;22;42;60;102;96;220;65;63;128;163;301;254;125;80;1051
224000;Vorsätzliche einfache Körperverletzung § 223 StGB;5314000;Bonn;W;317;0;0;0;0;5;5;21;21;42;17;64;18;18;36;43;74;65;22;13;253
224000;Vorsätzliche einfache Körperverletzung § 223 StGB;5314000;Bonn;X;1588;0;4;4;4;15;27;63;81;144;113;284;83;81;164;206;375;319;147;93;1304
224000;Vorsätzliche einfache Körperverletzung § 223 StGB;5512000;Bottrop;M;319;0;0;2;0;2;4;10;9;19;28;51;25;22;47;40;69;66;26;20;268
224000;Vorsätzliche einfache Körperverletzung § 223 StGB;5512000;Bottrop;W;84;0;0;0;1;1;2;5;6;11;9;22;4;6;10;8;21;11;10;2;62
224000;Vorsätzliche einfache Körperverletzung § 223 StGB;5512000;Bottrop;X;403;0;0;2;1;3;6;15;15;30;37;73;29;28;57;48;90;77;36;22;330
224000;Vorsätzliche einfache Körperverletzung § 223 StGB;3101000;Braunschweig;M;1153;0;1;1;6;11;19;33;42;75;107;201;90;110;200;148;265;171;113;55;952
224000;Vorsätzliche einfache Körperverletzung § 223 StGB;3101000;Braunschweig;W;268;0;1;1;4;7;13;16;12;28;28;69;11;18;29;37;51;50;25;7;199
224000;Vorsätzliche einfache Körperverletzung § 223 StGB;3101000;Braunschweig;X;1421;0;2;2;10;18;32;49;54;103;135;270;101;128;229;185;316;221;138;62;1151
224000;Vorsätzliche einfache Körperverletzung § 223 StGB;4011000;Bremen;M;2508;3;2;1;17;19;42;49;89;138;199;379;172;210;382;393;603;426;211;114;2129
224000;Vorsätzliche einfache Körperverletzung § 223 StGB;4011000;Bremen;W;528;0;0;1;5;10;16;23;29;52;45;113;36;43;79;69;120;81;48;18;415
224000;Vorsätzliche einfache Körperverletzung § 223 StGB;4011000;Bremen;X;3036;3;2;2;22;29;58;72;118;190;244;492;208;253;461;462;723;507;259;132;2544
224000;Vorsätzliche einfache Körperverletzung § 223 StGB;4012000;Bremerhaven;M;611;1;0;2;5;8;16;32;14;46;43;105;38;37;75;106;146;120;39;20;506
224000;Vorsätzliche einfache Körperverletzung § 223 StGB;4012000;Bremerhaven;W;117;0;0;0;1;1;2;15;2;17;16;35;8;5;13;22;17;15;11;4;82
224000;Vorsätzliche einfache Körperverletzung § 223 StGB;4012000;Bremerhaven;X;728;1;0;2;6;9;18;47;16;63;59;140;46;42;88;128;163;135;50;24;588
224000;Vorsätzliche einfache Körperverletzung § 223 StGB;14511000;Chemnitz;M;590;0;0;5;8;8;21;10;14;24;42;87;31;38;69;112;156;88;51;27;503
224000;Vorsätzliche einfache Körperverletzung § 223 StGB;14511000;Chemnitz;W;132;0;0;0;0;2;2;8;4;12;11;25;8;10;18;24;28;12;11;14;107
224000;Vorsätzliche einfache Körperverletzung § 223 StGB;14511000;Chemnitz;X;722;0;0;5;8;10;23;18;18;36;53;112;39;48;87;136;184;100;62;41;610
224000;Vorsätzliche einfache Körperverletzung § 223 StGB;6411000;Darmstadt;M;383;0;0;0;0;0;0;3;14;17;36;53;28;30;58;53;89;74;41;15;330
224000;Vorsätzliche einfache Körperverletzung § 223 StGB;6411000;Darmstadt;W;75;0;0;0;0;1;1;3;4;7;7;15;1;4;5;8;17;19;7;4;60
224000;Vorsätzliche einfache Körperverletzung § 223 StGB;6411000;Darmstadt;X;458;0;0;0;0;1;1;6;18;24;43;68;29;34;63;61;106;93;48;19;390
224000;Vorsätzliche einfache Körperverletzung § 223 StGB;5913000;Dortmund;M;2782;1;2;17;20;39;79;50;99;149;258;486;176;197;373;436;650;468;248;121;2296
224000;Vorsätzliche einfache Körperverletzung § 223 StGB;5913000;Dortmund;W;661;0;1;1;0;13;15;34;40;74;58;147;48;36;84;93;158;95;50;34;514
224000;Vorsätzliche einfache Körperverletzung § 223 StGB;5913000;Dortmund;X;3443;1;3;18;20;52;94;84;139;223;316;633;224;233;457;529;808;563;298;155;2810
224000;Vorsätzliche einfache Körperverletzung § 223 StGB;14612000;Dresden;M;1246;0;1;2;9;25;37;17;36;53;65;155;62;96;158;211;346;228;100;48;1091
224000;Vorsätzliche einfache Körperverletzung § 223 StGB;14612000;Dresden;W;240;0;0;0;0;8;8;7;8;15;13;36;15;13;28;37;61;33;33;12;204
224000;Vorsätzliche einfache Körperverletzung § 223 StGB;14612000;Dresden;X;1486;0;1;2;9;33;45;24;44;68;78;191;77;109;186;248;407;261;133;60;1295
224000;Vorsätzliche einfache Körperverletzung § 223 StGB;5112000;Duisburg;M;2141;0;2;6;18;43;69;63;68;131;157;357;107;110;217;273;543;444;201;106;1784
224000;Vorsätzliche einfache Körperverletzung § 223 StGB;5112000;Duisburg;W;519;0;0;1;6;15;22;29;27;56;36;114;31;34;65;72;99;101;43;25;405
224000;Vorsätzliche einfache Körperverletzung § 223 StGB;5112000;Duisburg;X;2660;0;2;7;24;58;91;92;95;187;193;471;138;144;282;345;642;545;244;131;2189
224000;Vorsätzliche einfache Körperverletzung § 223 StGB;5111000;Düsseldorf;M;2906;0;1;4;20;31;56;72;107;179;271;506;203;215;418;408;685;517;247;125;2400
224000;Vorsätzliche einfache Körperverletzung § 223 StGB;5111000;Düsseldorf;W;614;0;0;0;2;10;12;36;28;64;60;136;49;40;89;92;122;92;56;27;478
224000;Vorsätzliche einfache Körperverletzung § 223 StGB;5111000;Düsseldorf;X;3520;0;1;4;22;41;68;108;135;243;331;642;252;255;507;500;807;609;303;152;2878
224000;Vorsätzliche einfache Körperverletzung § 223 StGB;16051000;Erfurt;M;1032;0;8;5;14;35;62;23;36;59;58;179;63;62;125;170;254;158;90;56;853
224000;Vorsätzliche einfache Körperverletzung § 223 StGB;16051000;Erfurt;W;284;0;0;0;3;15;18;8;16;24;23;65;19;12;31;34;79;40;19;16;219
224000;Vorsätzliche einfache Körperverletzung § 223 StGB;16051000;Erfurt;X;1316;0;8;5;17;50;80;31;52;83;81;244;82;74;156;204;333;198;109;72;1072
224000;Vorsätzliche einfache Körperverletzung § 223 StGB;9562000;Erlangen;M;399;0;0;0;2;2;4;13;21;34;54;92;32;36;68;67;76;56;30;10;307
224000;Vorsätzliche einfache Körperverletzung § 223 StGB;9562000;Erlangen;W;90;0;0;0;0;1;1;8;4;12;9;22;7;2;9;15;13;22;6;3;68
224000;Vorsätzliche einfache Körperverletzung § 223 StGB;9562000;Erlangen;X;489;0;0;0;2;3;5;21;25;46;63;114;39;38;77;82;89;78;36;13;375
224000;Vorsätzliche einfache Körperverletzung § 223 StGB;5113000;Essen;M;1901;0;1;6;15;32;54;68;82;150;138;342;115;95;210;259;455;369;184;82;1559
224000;Vorsätzliche einfache Körperverletzung § 223 StGB;5113000;Essen;W;455;0;0;0;2;19;21;26;19;45;28;94;24;20;44;56;105;89;41;26;361
224000;Vorsätzliche einfache Körperverletzung § 223 StGB;5113000;Essen;X;2356;0;1;6;17;51;75;94;101;195;166;436;139;115;254;315;560;458;225;108;1920
224000;Vorsätzliche einfache Körperverletzung § 223 StGB;6412000;Frankfurt am Main;M;2799;1;0;2;4;20;27;29;81;110;144;281;140;185;325;421;784;561;276;151;2518
224000;Vorsätzliche einfache Körperverletzung § 223 StGB;6412000;Frankfurt am Main;W;564;0;0;0;0;1;1;10;18;28;33;62;27;34;61;65;172;128;48;28;502
224000;Vorsätzliche einfache Körperverletzung § 223 StGB;6412000;Frankfurt am Main;X;3363;1;0;2;4;21;28;39;99;138;177;343;167;219;386;486;956;689;324;179;3020
224000;Vorsätzliche einfache Körperverletzung § 223 StGB;8311000;Freiburg im Breisgau;M;1235;0;1;4;7;9;21;35;65;100;110;231;86;91;177;169;286;196;127;49;1004
224000;Vorsätzliche einfache Körperverletzung § 223 StGB;8311000;Freiburg im Breisgau;W;294;0;0;0;1;8;9;12;12;24;34;67;15;16;31;39;61;58;22;16;227
224000;Vorsätzliche einfache Körperverletzung § 223 StGB;8311000;Freiburg im Breisgau;X;1529;0;1;4;8;17;30;47;77;124;144;298;101;107;208;208;347;254;149;65;1231
224000;Vorsätzliche einfache Körperverletzung § 223 StGB;9563000;Fürth;M;337;0;0;3;2;7;12;12;19;31;24;67;21;25;46;44;56;82;29;13;270
224000;Vorsätzliche einfache Körperverletzung § 223 StGB;9563000;Fürth;W;91;0;0;0;0;2;2;6;4;10;6;18;5;3;8;10;22;21;9;3;73
224000;Vorsätzliche einfache Körperverletzung § 223 StGB;9563000;Fürth;X;428;0;0;3;2;9;14;18;23;41;30;85;26;28;54;54;78;103;38;16;343
224000;Vorsätzliche einfache Körperverletzung § 223 StGB;5513000;Gelsenkirchen;M;1251;0;2;3;10;25;40;53;54;107;83;230;66;74;140;167;283;273;118;40;1021
224000;Vorsätzliche einfache Körperverletzung § 223 StGB;5513000;Gelsenkirchen;W;322;0;0;1;3;11;15;18;23;41;17;73;16;22;38;31;77;61;29;13;249
224000;Vorsätzliche einfache Körperverletzung § 223 StGB;5513000;Gelsenkirchen;X;1573;0;2;4;13;36;55;71;77;148;100;303;82;96;178;198;360;334;147;53;1270
224000;Vorsätzliche einfache Körperverletzung § 223 StGB;3152012;Göttingen;M;577;0;1;2;3;9;15;28;21;49;51;115;50;52;102;88;113;98;37;24;462
224000;Vorsätzliche einfache Körperverletzung § 223 StGB;3152012;Göttingen;W;101;0;0;0;0;0;0;4;8;12;10;22;8;3;11;14;28;15;7;4;79
224000;Vorsätzliche einfache Körperverletzung § 223 StGB;3152012;Göttingen;X;678;0;1;2;3;9;15;32;29;61;61;137;58;55;113;102;141;113;44;28;541
224000;Vorsätzliche einfache Körperverletzung § 223 StGB;5914000;Hagen;M;794;1;0;4;18;26;49;27;30;57;67;173;45;52;97;100;150;162;66;46;621
224000;Vorsätzliche einfache Körperverletzung § 223 StGB;5914000;Hagen;W;195;0;2;0;3;10;15;15;18;33;22;70;14;8;22;13;32;36;9;13;125
224000;Vorsätzliche einfache Körperverletzung § 223 StGB;5914000;Hagen;X;989;1;2;4;21;36;64;42;48;90;89;243;59;60;119;113;182;198;75;59;746
224000;Vorsätzliche einfache Körperverletzung § 223 StGB;15002000;Halle (Saale);M;1036;0;0;5;9;24;38;21;36;57;62;157;55;59;114;168;255;187;107;48;879
224000;Vorsätzliche einfache Körperverletzung § 223 StGB;15002000;Halle (Saale);W;272;0;0;2;1;11;14;11;15;26;21;61;15;16;31;38;72;34;22;14;211
224000;Vorsätzliche einfache Körperverletzung § 223 StGB;15002000;Halle (Saale);X;1308;0;0;7;10;35;52;32;51;83;83;218;70;75;145;206;327;221;129;62;1090
224000;Vorsätzliche einfache Körperverletzung § 223 StGB;2000000;Hamburg;M;9942;3;44;87;140;210;484;267;339;606;655;1745;506;568;1074;1433;2475;1868;928;419;8197
224000;Vorsätzliche einfache Körperverletzung § 223 StGB;2000000;Hamburg;W;2202;0;1;15;18;57;91;88;89;177;142;410;116;111;227;306;575;387;191;106;1792
224000;Vorsätzliche einfache Körperverletzung § 223 StGB;2000000;Hamburg;X;12144;3;45;102;158;267;575;355;428;783;797;2155;622;679;1301;1739;3050;2255;1119;525;9989
224000;Vorsätzliche einfache Körperverletzung § 223 StGB;5915000;Hamm;M;595;0;0;3;2;6;11;30;20;50;51;112;39;37;76;84;147;108;48;20;483
224000;Vorsätzliche einfache Körperverletzung § 223 StGB;5915000;Hamm;W;154;0;0;0;0;2;2;12;12;24;9;35;13;9;22;19;39;27;8;4;119
224000;Vorsätzliche einfache Körperverletzung § 223 StGB;5915000;Hamm;X;749;0;0;3;2;8;13;42;32;74;60;147;52;46;98;103;186;135;56;24;602
224000;Vorsätzliche einfache Körperverletzung § 223 StGB;3241001;Hannover;M;3356;0;0;10;16;39;65;81;107;188;343;596;245;218;463;513;806;566;276;136;2760
224000;Vorsätzliche einfache Körperverletzung § 223 StGB;3241001;Hannover;W;740;0;1;0;2;7;10;31;44;75;65;150;37;48;85;106;190;117;63;29;590
224000;Vorsätzliche einfache Körperverletzung § 223 StGB;3241001;Hannover;X;4096;0;1;10;18;46;75;112;151;263;408;746;282;266;548;619;996;683;339;165;3350
224000;Vorsätzliche einfache Körperverletzung § 223 StGB;8221000;Heidelberg;M;464;0;0;1;3;8;12;9;24;33;38;83;33;37;70;66;92;77;53;23;381
224000;Vorsätzliche einfache Körperverletzung § 223 StGB;8221000;Heidelberg;W;101;0;0;0;0;2;2;3;3;6;10;18;7;3;10;15;26;13;10;9;83
224000;Vorsätzliche einfache Körperverletzung § 223 StGB;8221000;Heidelberg;X;565;0;0;1;3;10;14;12;27;39;48;101;40;40;80;81;118;90;63;32;464
224000;Vorsätzliche einfache Körperverletzung § 223 StGB;8121000;Heilbronn;M;440;0;0;3;1;3;7;12;12;24;41;72;28;21;49;75;104;79;37;24;368
224000;Vorsätzliche einfache Körperverletzung § 223 StGB;8121000;Heilbronn;W;89;0;0;0;0;4;4;2;7;9;7;20;5;8;13;6;22;13;8;7;69
224000;Vorsätzliche einfache Körperverletzung § 223 StGB;8121000;Heilbronn;X;529;0;0;3;1;7;11;14;19;33;48;92;33;29;62;81;126;92;45;31;437
224000;Vorsätzliche einfache Körperverletzung § 223 StGB;5916000;Herne;M;736;0;1;2;8;7;18;32;29;61;58;137;37;40;77;99;162;146;69;46;599
224000;Vorsätzliche einfache Körperverletzung § 223 StGB;5916000;Herne;W;168;0;0;0;1;4;5;8;7;15;13;33;13;8;21;20;32;33;21;8;135
224000;Vorsätzliche einfache Körperverletzung § 223 StGB;5916000;Herne;X;904;0;1;2;9;11;23;40;36;76;71;170;50;48;98;119;194;179;90;54;734
224000;Vorsätzliche einfache Körperverletzung § 223 StGB;9161000;Ingolstadt;M;631;0;0;4;6;9;19;15;24;39;53;111;47;37;84;97;157;90;55;37;520
224000;Vorsätzliche einfache Körperverletzung § 223 StGB;9161000;Ingolstadt;W;155;0;0;0;0;3;3;1;12;13;9;25;4;10;14;23;39;29;17;8;130
224000;Vorsätzliche einfache Körperverletzung § 223 StGB;9161000;Ingolstadt;X;786;0;0;4;6;12;22;16;36;52;62;136;51;47;98;120;196;119;72;45;650
224000;Vorsätzliche einfache Körperverletzung § 223 StGB;16053000;Jena;M;291;0;0;1;0;6;7;6;7;13;21;41;14;20;34;61;77;46;25;7;250
224000;Vorsätzliche einfache Körperverletzung § 223 StGB;16053000;Jena;W;43;0;0;0;0;3;3;0;1;1;1;5;1;2;3;4;16;12;2;1;38
224000;Vorsätzliche einfache Körperverletzung § 223 StGB;16053000;Jena;X;334;0;0;1;0;9;10;6;8;14;22;46;15;22;37;65;93;58;27;8;288
224000;Vorsätzliche einfache Körperverletzung § 223 StGB;8212000;Karlsruhe;M;922;0;0;2;5;11;18;14;44;58;84;160;68;69;137;132;206;172;78;37;762
224000;Vorsätzliche einfache Körperverletzung § 223 StGB;8212000;Karlsruhe;W;200;0;0;1;0;2;3;8;8;16;17;36;11;12;23;22;51;29;27;12;164
224000;Vorsätzliche einfache Körperverletzung § 223 StGB;8212000;Karlsruhe;X;1122;0;0;3;5;13;21;22;52;74;101;196;79;81;160;154;257;201;105;49;926
224000;Vorsätzliche einfache Körperverletzung § 223 StGB;6611000;Kassel;M;661;0;0;1;1;3;5;11;19;30;59;94;45;46;91;99;177;122;47;31;567
224000;Vorsätzliche einfache Körperverletzung § 223 StGB;6611000;Kassel;W;149;0;0;0;1;3;4;8;5;13;13;30;13;9;22;19;36;24;11;7;119
224000;Vorsätzliche einfache Körperverletzung § 223 StGB;6611000;Kassel;X;810;0;0;1;2;6;9;19;24;43;72;124;58;55;113;118;213;146;58;38;686
224000;Vorsätzliche einfache Körperverletzung § 223 StGB;1002000;Kiel;M;1253;0;0;1;9;12;22;33;48;81;95;198;108;89;197;209;246;247;104;52;1055
224000;Vorsätzliche einfache Körperverletzung § 223 StGB;1002000;Kiel;W;295;0;0;0;0;3;3;22;19;41;27;71;25;26;51;45;58;37;22;11;224
224000;Vorsätzliche einfache Körperverletzung § 223 StGB;1002000;Kiel;X;1548;0;0;1;9;15;25;55;67;122;122;269;133;115;248;254;304;284;126;63;1279
224000;Vorsätzliche einfache Körperverletzung § 223 StGB;7111000;Koblenz;M;662;0;2;0;6;6;14;28;17;45;71;130;54;42;96;111;142;98;62;23;532
224000;Vorsätzliche einfache Körperverletzung § 223 StGB;7111000;Koblenz;W;165;0;0;0;0;7;7;9;6;15;16;38;10;8;18;29;35;28;10;7;127
224000;Vorsätzliche einfache Körperverletzung § 223 StGB;7111000;Koblenz;X;827;0;2;0;6;13;21;37;23;60;87;168;64;50;114;140;177;126;72;30;659
224000;Vorsätzliche einfache Körperverletzung § 223 StGB;5315000;Köln;M;6797;0;8;20;37;95;160;166;233;399;598;1157;440;466;906;976;1592;1209;651;306;5640
224000;Vorsätzliche einfache Körperverletzung § 223 StGB;5315000;Köln;W;1893;0;0;1;7;29;37;91;69;160;158;355;94;113;207;268;464;348;159;92;1538
224000;Vorsätzliche einfache Körperverletzung § 223 StGB;5315000;Köln;X;8690;0;8;21;44;124;197;257;302;559;756;1512;534;579;1113;1244;2056;1557;810;398;7178
224000;Vorsätzliche einfache Körperverletzung § 223 StGB;5114000;Krefeld;M;1112;0;2;3;6;18;29;29;41;70;93;192;72;69;141;157;254;205;104;59;920
224000;Vorsätzliche einfache Körperverletzung § 223 StGB;5114000;Krefeld;W;287;0;1;1;4;9;15;14;14;28;24;67;18;15;33;43;61;43;25;15;220
224000;Vorsätzliche einfache Körperverletzung § 223 StGB;5114000;Krefeld;X;1399;0;3;4;10;27;44;43;55;98;117;259;90;84;174;200;315;248;129;74;1140
224000;Vorsätzliche einfache Körperverletzung § 223 StGB;14713000;Leipzig;M;1910;1;1;7;19;40;68;43;50;93;108;269;100;137;237;318;512;331;170;73;1641
224000;Vorsätzliche einfache Körperverletzung § 223 StGB;14713000;Leipzig;W;399;0;0;0;5;10;15;17;19;36;27;78;15;30;45;56;101;66;34;19;321
224000;Vorsätzliche einfache Körperverletzung § 223 StGB;14713000;Leipzig;X;2309;1;1;7;24;50;83;60;69;129;135;347;115;167;282;374;613;397;204;92;1962
224000;Vorsätzliche einfache Körperverletzung § 223 StGB;5316000;Leverkusen;M;721;0;1;3;2;11;17;12;31;43;66;126;44;39;83;82;170;136;82;42;595
224000;Vorsätzliche einfache Körperverletzung § 223 StGB;5316000;Leverkusen;W;215;0;0;1;3;1;5;11;4;15;19;39;12;12;24;34;45;44;21;8;176
224000;Vorsätzliche einfache Körperverletzung § 223 StGB;5316000;Leverkusen;X;936;0;1;4;5;12;22;23;35;58;85;165;56;51;107;116;215;180;103;50;771
224000;Vorsätzliche einfache Körperverletzung § 223 StGB;1003000;Lübeck;M;1358;0;2;3;11;24;40;40;45;85;87;212;89;83;172;216;300;253;137;68;1146
224000;Vorsätzliche einfache Körperverletzung § 223 StGB;1003000;Lübeck;W;378;0;0;0;2;12;14;13;21;34;33;81;23;23;46;43;90;66;27;25;297
224000;Vorsätzliche einfache Körperverletzung § 223 StGB;1003000;Lübeck;X;1736;0;2;3;13;36;54;53;66;119;120;293;112;106;218;259;390;319;164;93;1443
224000;Vorsätzliche einfache Körperverletzung § 223 StGB;7314000;Ludwigshafen am Rhein;M;1078;0;3;6;18;24;51;34;47;81;84;216;71;72;143;143;251;188;92;45;862
224000;Vorsätzliche einfache Körperverletzung § 223 StGB;7314000;Ludwigshafen am Rhein;W;329;0;0;0;1;7;8;17;19;36;30;74;25;19;44;52;60;53;28;18;255
224000;Vorsätzliche einfache Körperverletzung § 223 StGB;7314000;Ludwigshafen am Rhein;X;1407;0;3;6;19;31;59;51;66;117;114;290;96;91;187;195;311;241;120;63;1117
224000;Vorsätzliche einfache Körperverletzung § 223 StGB;15003000;Magdeburg;M;887;0;0;5;6;19;30;26;27;53;55;138;46;48;94;134;220;170;73;58;749
224000;Vorsätzliche einfache Körperverletzung § 223 StGB;15003000;Magdeburg;W;221;0;0;1;0;8;9;14;17;31;16;56;15;12;27;35;43;36;15;9;165
224000;Vorsätzliche einfache Körperverletzung § 223 StGB;15003000;Magdeburg;X;1108;0;0;6;6;27;39;40;44;84;71;194;61;60;121;169;263;206;88;67;914
224000;Vorsätzliche einfache Körperverletzung § 223 StGB;7315000;Mainz;M;1046;0;0;3;8;5;16;21;47;68;105;189;66;87;153;184;216;176;84;44;857
224000;Vorsätzliche einfache Körperverletzung § 223 StGB;7315000;Mainz;W;242;0;0;0;0;1;1;6;14;20;16;37;17;15;32;42;50;44;19;18;205
224000;Vorsätzliche einfache Körperverletzung § 223 StGB;7315000;Mainz;X;1288;0;0;3;8;6;17;27;61;88;121;226;83;102;185;226;266;220;103;62;1062
224000;Vorsätzliche einfache Körperverletzung § 223 StGB;8222000;Mannheim;M;1108;0;1;3;4;16;24;26;39;65;72;161;65;59;124;138;298;209;117;61;947
224000;Vorsätzliche einfache Körperverletzung § 223 StGB;8222000;Mannheim;W;259;0;0;2;2;7;11;11;7;18;21;50;10;10;20;42;55;49;26;17;209
224000;Vorsätzliche einfache Körperverletzung § 223 StGB;8222000;Mannheim;X;1367;0;1;5;6;23;35;37;46;83;93;211;75;69;144;180;353;258;143;78;1156
224000;Vorsätzliche einfache Körperverletzung § 223 StGB;5170024;Moers;M;424;0;1;4;4;18;27;14;19;33;39;99;26;29;55;65;93;58;34;20;325
224000;Vorsätzliche einfache Körperverletzung § 223 StGB;5170024;Moers;W;111;0;0;0;0;8;8;13;3;16;11;35;6;5;11;12;11;21;14;7;76
224000;Vorsätzliche einfache Körperverletzung § 223 StGB;5170024;Moers;X;535;0;1;4;4;26;35;27;22;49;50;134;32;34;66;77;104;79;48;27;401
224000;Vorsätzliche einfache Körperverletzung § 223 StGB;5116000;Mönchengladbach;M;1000;1;0;0;12;18;31;30;35;65;99;195;55;70;125;148;229;172;81;50;805
224000;Vorsätzliche einfache Körperverletzung § 223 StGB;5116000;Mönchengladbach;W;217;0;1;1;0;14;16;12;14;26;21;63;7;11;18;23;44;42;16;11;154
224000;Vorsätzliche einfache Körperverletzung § 223 StGB;5116000;Mönchengladbach;X;1217;1;1;1;12;32;47;42;49;91;120;258;62;81;143;171;273;214;97;61;959
224000;Vorsätzliche einfache Körperverletzung § 223 StGB;5117000;Mülheim an der Ruhr;M;453;0;0;2;5;8;15;15;30;45;38;98;16;18;34;47;105;88;54;27;355
224000;Vorsätzliche einfache Körperverletzung § 223 StGB;5117000;Mülheim an der Ruhr;W;148;0;0;1;0;2;3;7;10;17;13;33;12;6;18;11;38;24;16;8;115
224000;Vorsätzliche einfache Körperverletzung § 223 StGB;5117000;Mülheim an der Ruhr;X;601;0;0;3;5;10;18;22;40;62;51;131;28;24;52;58;143;112;70;35;470
224000;Vorsätzliche einfache Körperverletzung § 223 StGB;9162000;München;M;5169;0;0;9;28;52;89;84;167;251;475;815;341;362;703;739;1251;957;462;242;4354
224000;Vorsätzliche einfache Körperverletzung § 223 StGB;9162000;München;W;1166;0;0;0;1;12;13;54;40;94;86;193;72;61;133;159;315;196;105;65;973
224000;Vorsätzliche einfache Körperverletzung § 223 StGB;9162000;München;X;6335;0;0;9;29;64;102;138;207;345;561;1008;413;423;836;898;1566;1153;567;307;5327
224000;Vorsätzliche einfache Körperverletzung § 223 StGB;5515000;Münster;M;1206;0;0;1;5;24;30;37;43;80;113;223;100;106;206;200;250;193;84;50;983
224000;Vorsätzliche einfache Körperverletzung § 223 StGB;5515000;Münster;W;261;0;0;0;0;11;11;19;10;29;23;63;13;9;22;32;60;49;26;9;198
224000;Vorsätzliche einfache Körperverletzung § 223 StGB;5515000;Münster;X;1467;0;0;1;5;35;41;56;53;109;136;286;113;115;228;232;310;242;110;59;1181
224000;Vorsätzliche einfache Körperverletzung § 223 StGB;5162024;Neuss;M;589;0;0;4;7;9;20;10;21;31;52;103;34;35;69;88;155;97;54;23;486
224000;Vorsätzliche einfache Körperverletzung § 223 StGB;5162024;Neuss;W;129;0;0;0;0;1;1;6;13;19;12;32;10;5;15;17;25;20;13;7;97
224000;Vorsätzliche einfache Körperverletzung § 223 StGB;5162024;Neuss;X;718;0;0;4;7;10;21;16;34;50;64;135;44;40;84;105;180;117;67;30;583
224000;Vorsätzliche einfache Körperverletzung § 223 StGB;9564000;Nürnberg;M;2373;0;2;8;22;27;59;47;84;131;245;435;191;191;382;367;534;370;196;89;1938
224000;Vorsätzliche einfache Körperverletzung § 223 StGB;9564000;Nürnberg;W;586;0;0;1;5;10;16;22;32;54;61;131;54;39;93;93;126;84;34;25;455
224000;Vorsätzliche einfache Körperverletzung § 223 StGB;9564000;Nürnberg;X;2959;0;2;9;27;37;75;69;116;185;306;566;245;230;475;460;660;454;230;114;2393
224000;Vorsätzliche einfache Körperverletzung § 223 StGB;5119000;Oberhausen;M;1070;0;1;6;15;18;40;25;42;67;87;194;72;77;149;147;222;208;106;44;876
224000;Vorsätzliche einfache Körperverletzung § 223 StGB;5119000;Oberhausen;W;289;0;0;1;0;5;6;22;14;36;24;66;16;16;32;34;66;53;23;15;223
224000;Vorsätzliche einfache Körperverletzung § 223 StGB;5119000;Oberhausen;X;1359;0;1;7;15;23;46;47;56;103;111;260;88;93;181;181;288;261;129;59;1099
224000;Vorsätzliche einfache Körperverletzung § 223 StGB;6413000;Offenbach am Main;M;475;0;0;0;1;10;11;8;13;21;29;61;24;16;40;55;129;117;48;25;414
224000;Vorsätzliche einfache Körperverletzung § 223 StGB;6413000;Offenbach am Main;W;103;0;0;0;2;3;5;4;5;9;8;22;6;6;12;15;24;11;15;4;81
224000;Vorsätzliche einfache Körperverletzung § 223 StGB;6413000;Offenbach am Main;X;578;0;0;0;3;13;16;12;18;30;37;83;30;22;52;70;153;128;63;29;495
224000;Vorsätzliche einfache Körperverletzung § 223 StGB;3403000;Oldenburg (Oldenburg);M;580;0;0;0;3;16;19;14;22;36;55;110;48;35;83;83;135;107;39;23;470
224000;Vorsätzliche einfache Körperverletzung § 223 StGB;3403000;Oldenburg (Oldenburg);W;155;0;0;0;0;3;3;10;14;24;18;45;11;6;17;18;29;28;10;8;110
224000;Vorsätzliche einfache Körperverletzung § 223 StGB;3403000;Oldenburg (Oldenburg);X;735;0;0;0;3;19;22;24;36;60;73;155;59;41;100;101;164;135;49;31;580
224000;Vorsätzliche einfache Körperverletzung § 223 StGB;3404000;Osnabrück;M;718;0;3;2;5;9;19;20;33;53;77;149;54;52;106;113;148;123;58;21;569
224000;Vorsätzliche einfache Körperverletzung § 223 StGB;3404000;Osnabrück;W;157;0;0;1;0;6;7;12;10;22;12;41;7;7;14;18;42;23;10;9;116
224000;Vorsätzliche einfache Körperverletzung § 223 StGB;3404000;Osnabrück;X;875;0;3;3;5;15;26;32;43;75;89;190;61;59;120;131;190;146;68;30;685
224000;Vorsätzliche einfache Körperverletzung § 223 StGB;5774032;Paderborn;M;552;0;2;1;0;10;13;13;15;28;54;95;44;41;85;99;127;87;44;15;457
224000;Vorsätzliche einfache Körperverletzung § 223 StGB;5774032;Paderborn;W;117;0;0;0;1;1;2;2;8;10;8;20;10;9;19;16;29;17;10;6;97
224000;Vorsätzliche einfache Körperverletzung § 223 StGB;5774032;Paderborn;X;669;0;2;1;1;11;15;15;23;38;62;115;54;50;104;115;156;104;54;21;554
224000;Vorsätzliche einfache Körperverletzung § 223 StGB;8231000;Pforzheim;M;534;0;0;2;5;13;20;9;19;28;58;106;37;36;73;82;116;79;50;28;428
224000;Vorsätzliche einfache Körperverletzung § 223 StGB;8231000;Pforzheim;W;141;0;0;0;0;4;4;8;6;14;19;37;8;8;16;17;30;23;14;4;104
224000;Vorsätzliche einfache Körperverletzung § 223 StGB;8231000;Pforzheim;X;675;0;0;2;5;17;24;17;25;42;77;143;45;44;89;99;146;102;64;32;532
224000;Vorsätzliche einfache Körperverletzung § 223 StGB;12054000;Potsdam;M;411;0;1;2;4;1;8;12;17;29;20;57;22;37;59;57;108;71;43;16;354
224000;Vorsätzliche einfache Körperverletzung § 223 StGB;12054000;Potsdam;W;107;0;0;0;2;2;4;4;7;11;2;17;7;8;15;12;35;17;6;5;90
224000;Vorsätzliche einfache Körperverletzung § 223 StGB;12054000;Potsdam;X;518;0;1;2;6;3;12;16;24;40;22;74;29;45;74;69;143;88;49;21;444
224000;Vorsätzliche einfache Körperverletzung § 223 StGB;5562032;Recklinghausen;M;518;0;0;6;12;18;36;15;18;33;55;124;20;27;47;66;112;93;51;25;394
224000;Vorsätzliche einfache Körperverletzung § 223 StGB;5562032;Recklinghausen;W;135;0;1;3;1;4;9;11;13;24;9;42;8;6;14;15;28;16;13;7;93
224000;Vorsätzliche einfache Körperverletzung § 223 StGB;5562032;Recklinghausen;X;653;0;1;9;13;22;45;26;31;57;64;166;28;33;61;81;140;109;64;32;487
224000;Vorsätzliche einfache Körperverletzung § 223 StGB;9362000;Regensburg;M;685;0;0;0;3;6;9;18;32;50;83;142;77;54;131;87;154;97;54;20;543
224000;Vorsätzliche einfache Körperverletzung § 223 StGB;9362000;Regensburg;W;152;0;0;0;0;3;3;8;7;15;14;32;12;7;19;26;30;19;13;13;120
224000;Vorsätzliche einfache Körperverletzung § 223 StGB;9362000;Regensburg;X;837;0;0;0;3;9;12;26;39;65;97;174;89;61;150;113;184;116;67;33;663
224000;Vorsätzliche einfache Körperverletzung § 223 StGB;5120000;Remscheid;M;491;0;0;0;7;15;22;18;18;36;45;103;22;31;53;68;96;96;50;25;388
224000;Vorsätzliche einfache Körperverletzung § 223 StGB;5120000;Remscheid;W;132;0;0;0;0;3;3;7;10;17;15;35;7;12;19;13;26;23;14;2;97
224000;Vorsätzliche einfache Körperverletzung § 223 StGB;5120000;Remscheid;X;623;0;0;0;7;18;25;25;28;53;60;138;29;43;72;81;122;119;64;27;485
224000;Vorsätzliche einfache Körperverletzung § 223 StGB;8415061;Reutlingen;M;384;0;0;3;5;6;14;7;24;31;40;85;21;25;46;56;76;69;34;18;299
224000;Vorsätzliche einfache Körperverletzung § 223 StGB;8415061;Reutlingen;W;69;0;0;0;0;2;2;6;3;9;9;20;5;2;7;4;22;6;8;2;49
224000;Vorsätzliche einfache Körperverletzung § 223 StGB;8415061;Reutlingen;X;453;0;0;3;5;8;16;13;27;40;49;105;26;27;53;60;98;75;42;20;348
224000;Vorsätzliche einfache Körperverletzung § 223 StGB;13003000;Rostock;M;668;0;0;3;5;10;18;13;13;26;38;82;29;40;69;137;164;110;67;39;586
224000;Vorsätzliche einfache Körperverletzung § 223 StGB;13003000;Rostock;W;138;0;0;0;0;0;0;11;7;18;16;34;6;8;14;21;28;20;12;9;104
224000;Vorsätzliche einfache Körperverletzung § 223 StGB;13003000;Rostock;X;806;0;0;3;5;10;18;24;20;44;54;116;35;48;83;158;192;130;79;48;690
224000;Vorsätzliche einfache Körperverletzung § 223 StGB;10041100;Saarbrücken;M;1021;0;0;1;7;10;18;21;38;59;90;167;60;77;137;144;242;164;117;50;854
224000;Vorsätzliche einfache Körperverletzung § 223 StGB;10041100;Saarbrücken;W;309;0;0;0;7;13;20;14;19;33;29;82;18;15;33;35;68;46;30;15;227
224000;Vorsätzliche einfache Körperverletzung § 223 StGB;10041100;Saarbrücken;X;1330;0;0;1;14;23;38;35;57;92;119;249;78;92;170;179;310;210;147;65;1081
224000;Vorsätzliche einfache Körperverletzung § 223 StGB;5122000;Solingen;M;571;0;0;0;7;6;13;22;32;54;49;116;37;36;73;67;131;110;57;17;455
224000;Vorsätzliche einfache Körperverletzung § 223 StGB;5122000;Solingen;W;126;0;0;0;0;10;10;5;9;14;11;35;13;6;19;13;25;17;13;4;91
224000;Vorsätzliche einfache Körperverletzung § 223 StGB;5122000;Solingen;X;697;0;0;0;7;16;23;27;41;68;60;151;50;42;92;80;156;127;70;21;546
224000;Vorsätzliche einfache Körperverletzung § 223 StGB;8111000;Stuttgart;M;3171;0;10;7;10;36;63;64;110;174;298;535;245;245;490;491;730;512;262;151;2636
224000;Vorsätzliche einfache Körperverletzung § 223 StGB;8111000;Stuttgart;W;711;0;0;0;7;13;20;25;46;71;76;167;53;39;92;105;147;106;50;44;544
224000;Vorsätzliche einfache Körperverletzung § 223 StGB;8111000;Stuttgart;X;3882;0;10;7;17;49;83;89;156;245;374;702;298;284;582;596;877;618;312;195;3180
224000;Vorsätzliche einfache Körperverletzung § 223 StGB;7211000;Trier;M;520;0;0;0;1;4;5;17;20;37;55;97;53;43;96;81;112;80;36;18;423
224000;Vorsätzliche einfache Körperverletzung § 223 StGB;7211000;Trier;W;116;0;0;0;0;1;1;2;4;6;15;22;6;6;12;18;25;17;14;8;94
224000;Vorsätzliche einfache Körperverletzung § 223 StGB;7211000;Trier;X;636;0;0;0;1;5;6;19;24;43;70;119;59;49;108;99;137;97;50;26;517
224000;Vorsätzliche einfache Körperverletzung § 223 StGB;8421000;Ulm;M;448;0;0;0;2;6;8;11;24;35;40;83;35;37;72;58;98;76;47;14;365
224000;Vorsätzliche einfache Körperverletzung § 223 StGB;8421000;Ulm;W;106;0;0;3;0;4;7;3;3;6;19;32;8;7;15;15;23;9;5;7;74
224000;Vorsätzliche einfache Körperverletzung § 223 StGB;8421000;Ulm;X;554;0;0;3;2;10;15;14;27;41;59;115;43;44;87;73;121;85;52;21;439
224000;Vorsätzliche einfache Körperverletzung § 223 StGB;6414000;Wiesbaden;M;1098;0;2;2;2;18;24;38;44;82;115;221;81;69;150;152;242;177;108;48;877
224000;Vorsätzliche einfache Körperverletzung § 223 StGB;6414000;Wiesbaden;W;241;0;0;1;0;2;3;14;8;22;19;44;12;15;27;31;69;36;24;10;197
224000;Vorsätzliche einfache Körperverletzung § 223 StGB;6414000;Wiesbaden;X;1339;0;2;3;2;20;27;52;52;104;134;265;93;84;177;183;311;213;132;58;1074
224000;Vorsätzliche einfache Körperverletzung § 223 StGB;3103000;Wolfsburg;M;456;0;0;0;6;8;14;17;23;40;38;92;40;31;71;62;85;76;46;24;364
224000;Vorsätzliche einfache Körperverletzung § 223 StGB;3103000;Wolfsburg;W;97;0;0;0;0;4;4;9;7;16;12;32;3;4;7;13;11;15;13;6;65
224000;Vorsätzliche einfache Körperverletzung § 223 StGB;3103000;Wolfsburg;X;553;0;0;0;6;12;18;26;30;56;50;124;43;35;78;75;96;91;59;30;429
224000;Vorsätzliche einfache Körperverletzung § 223 StGB;5124000;Wuppertal;M;1829;0;2;5;18;34;59;72;114;186;195;440;106;109;215;204;403;336;165;66;1389
224000;Vorsätzliche einfache Körperverletzung § 223 StGB;5124000;Wuppertal;W;472;0;0;0;0;3;3;36;26;62;34;99;38;31;69;57;109;92;27;19;373
224000;Vorsätzliche einfache Körperverletzung § 223 StGB;5124000;Wuppertal;X;2301;0;2;5;18;37;62;108;140;248;229;539;144;140;284;261;512;428;192;85;1762
224000;Vorsätzliche einfache Körperverletzung § 223 StGB;9663000;Würzburg;M;555;0;0;0;1;2;3;5;21;26;69;98;61;42;103;91;114;82;46;21;457
224000;Vorsätzliche einfache Körperverletzung § 223 StGB;9663000;Würzburg;W;119;0;0;0;1;0;1;7;10;17;15;33;8;7;15;14;21;19;10;7;86
224000;Vorsätzliche einfache Körperverletzung § 223 StGB;9663000;Würzburg;X;674;0;0;0;2;2;4;12;31;43;84;131;69;49;118;105;135;101;56;28;543
3***00;Diebstahl ohne erschwerende Umstände §§ 242, 247, 248a-c StGB und zwar:;5334002;Aachen;M;1310;0;1;5;29;34;69;96;99;195;124;388;75;67;142;171;238;170;134;67;922
3***00;Diebstahl ohne erschwerende Umstände §§ 242, 247, 248a-c StGB und zwar:;5334002;Aachen;W;611;0;0;2;5;19;26;59;54;113;54;193;31;32;63;58;80;85;71;61;418
3***00;Diebstahl ohne erschwerende Umstände §§ 242, 247, 248a-c StGB und zwar:;5334002;Aachen;X;1921;0;1;7;34;53;95;155;153;308;178;581;106;99;205;229;318;255;205;128;1340
3***00;Diebstahl ohne erschwerende Umstände §§ 242, 247, 248a-c StGB und zwar:;9761000;Augsburg;M;1178;0;4;13;19;46;82;93;75;168;87;337;58;61;119;147;242;152;97;84;841
3***00;Diebstahl ohne erschwerende Umstände §§ 242, 247, 248a-c StGB und zwar:;9761000;Augsburg;W;661;0;1;1;9;46;57;71;46;117;52;226;24;30;54;56;89;79;73;84;435
3***00;Diebstahl ohne erschwerende Umstände §§ 242, 247, 248a-c StGB und zwar:;9761000;Augsburg;X;1839;0;5;14;28;92;139;164;121;285;139;563;82;91;173;203;331;231;170;168;1276
3***00;Diebstahl ohne erschwerende Umstände §§ 242, 247, 248a-c StGB und zwar:;5378004;Bergisch Gladbach;M;399;0;0;0;5;13;18;13;22;35;44;97;21;15;36;57;75;63;30;41;302
3***00;Diebstahl ohne erschwerende Umstände §§ 242, 247, 248a-c StGB und zwar:;5378004;Bergisch Gladbach;W;181;0;0;0;0;4;4;19;15;34;10;48;9;10;19;9;34;27;23;21;133
3***00;Diebstahl ohne erschwerende Umstände §§ 242, 247, 248a-c StGB und zwar:;5378004;Bergisch Gladbach;X;580;0;0;0;5;17;22;32;37;69;54;145;30;25;55;66;109;90;53;62;435
3***00;Diebstahl ohne erschwerende Umstände §§ 242, 247, 248a-c StGB und zwar:;11000000;Berlin;M;18658;7;30;148;264;537;986;856;945;1801;1588;4375;993;1087;2080;2534;3841;2604;1684;1540;14283
3***00;Diebstahl ohne erschwerende Umstände §§ 242, 247, 248a-c StGB und zwar:;11000000;Berlin;W;9054;6;26;61;149;499;741;855;600;1455;705;2901;415;448;863;984;1360;992;831;1123;6153
3***00;Diebstahl ohne erschwerende Umstände §§ 242, 247, 248a-c StGB und zwar:;11000000;Berlin;X;27712;13;56;209;413;1036;1727;1711;1545;3256;2293;7276;1408;1535;2943;3518;5201;3596;2515;2663;20436
3***00;Diebstahl ohne erschwerende Umstände §§ 242, 247, 248a-c StGB und zwar:;5711000;Bielefeld;M;1690;0;0;10;24;38;72;61;124;185;136;393;95;107;202;259;370;218;129;119;1297
3***00;Diebstahl ohne erschwerende Umstände §§ 242, 247, 248a-c StGB und zwar:;5711000;Bielefeld;W;708;0;0;7;4;21;32;86;73;159;55;246;33;35;68;63;99;88;74;70;462
3***00;Diebstahl ohne erschwerende Umstände §§ 242, 247, 248a-c StGB und zwar:;5711000;Bielefeld;X;2398;0;0;17;28;59;104;147;197;344;191;639;128;142;270;322;469;306;203;189;1759
3***00;Diebstahl ohne erschwerende Umstände §§ 242, 247, 248a-c StGB und zwar:;5911000;Bochum;M;1726;0;5;12;26;54;97;74;103;177;122;396;93;113;206;216;360;261;157;130;1330
3***00;Diebstahl ohne erschwerende Umstände §§ 242, 247, 248a-c StGB und zwar:;5911000;Bochum;W;853;3;2;5;10;35;55;55;59;114;68;237;40;52;92;74;140;108;86;116;616
3***00;Diebstahl ohne erschwerende Umstände §§ 242, 247, 248a-c StGB und zwar:;5911000;Bochum;X;2579;3;7;17;36;89;152;129;162;291;190;633;133;165;298;290;500;369;243;246;1946
3***00;Diebstahl ohne erschwerende Umstände §§ 242, 247, 248a-c StGB und zwar:;5314000;Bonn;M;1356;0;3;7;16;57;83;96;100;196;113;392;71;51;122;147;291;205;119;80;964
3***00;Diebstahl ohne erschwerende Umstände §§ 242, 247, 248a-c StGB und zwar:;5314000;Bonn;W;690;0;0;0;5;41;46;101;67;168;39;253;22;30;52;65;107;80;61;72;437
3***00;Diebstahl ohne erschwerende Umstände §§ 242, 247, 248a-c StGB und zwar:;5314000;Bonn;X;2046;0;3;7;21;98;129;197;167;364;152;645;93;81;174;212;398;285;180;152;1401
3***00;Diebstahl ohne erschwerende Umstände §§ 242, 247, 248a-c StGB und zwar:;5512000;Bottrop;M;416;0;1;6;5;15;27;22;16;38;29;94;17;28;45;61;99;60;33;24;322
3***00;Diebstahl ohne erschwerende Umstände §§ 242, 247, 248a-c StGB und zwar:;5512000;Bottrop;W;243;0;1;2;2;20;25;30;9;39;18;82;11;8;19;17;44;26;29;26;161
3***00;Diebstahl ohne erschwerende Umstände §§ 242, 247, 248a-c StGB und zwar:;5512000;Bottrop;X;659;0;2;8;7;35;52;52;25;77;47;176;28;36;64;78;143;86;62;50;483
3***00;Diebstahl ohne erschwerende Umstände §§ 242, 247, 248a-c StGB und zwar:;3101000;Braunschweig;M;1466;0;0;2;15;28;45;51;77;128;185;358;95;117;212;240;304;157;109;86;1108
3***00;Diebstahl ohne erschwerende Umstände §§ 242, 247, 248a-c StGB und zwar:;3101000;Braunschweig;W;533;0;0;2;8;38;48;61;58;119;38;205;19;24;43;42;68;51;59;65;328
3***00;Diebstahl ohne erschwerende Umstände §§ 242, 247, 248a-c StGB und zwar:;3101000;Braunschweig;X;1999;0;0;4;23;66;93;112;135;247;223;563;114;141;255;282;372;208;168;151;1436
3***00;Diebstahl ohne erschwerende Umstände §§ 242, 247, 248a-c StGB und zwar:;4011000;Bremen;M;2548;2;6;22;39;60;129;152;212;364;236;729;150;137;287;298;547;357;198;132;1819
3***00;Diebstahl ohne erschwerende Umstände §§ 242, 247, 248a-c StGB und zwar:;4011000;Bremen;W;1364;3;3;5;13;78;102;178;160;338;110;550;71;64;135;133;185;164;98;99;814
3***00;Diebstahl ohne erschwerende Umstände §§ 242, 247, 248a-c StGB und zwar:;4011000;Bremen;X;3912;5;9;27;52;138;231;330;372;702;346;1279;221;201;422;431;732;521;296;231;2633
3***00;Diebstahl ohne erschwerende Umstände §§ 242, 247, 248a-c StGB und zwar:;4012000;Bremerhaven;M;734;0;3;5;12;10;30;32;32;64;65;159;32;37;69;105;157;115;71;58;575
3***00;Diebstahl ohne erschwerende Umstände §§ 242, 247, 248a-c StGB und zwar:;4012000;Bremerhaven;W;325;0;0;4;2;16;22;20;11;31;28;81;22;13;35;32;48;46;48;35;244
3***00;Diebstahl ohne erschwerende Umstände §§ 242, 247, 248a-c StGB und zwar:;4012000;Bremerhaven;X;1059;0;3;9;14;26;52;52;43;95;93;240;54;50;104;137;205;161;119;93;819
3***00;Diebstahl ohne erschwerende Umstände §§ 242, 247, 248a-c StGB und zwar:;14511000;Chemnitz;M;1438;1;7;4;20;30;62;53;39;92;125;279;100;103;203;299;323;132;90;112;1159
3***00;Diebstahl ohne erschwerende Umstände §§ 242, 247, 248a-c StGB und zwar:;14511000;Chemnitz;W;452;0;1;3;7;33;44;37;35;72;35;151;13;20;33;38;71;42;37;80;301
3***00;Diebstahl ohne erschwerende Umstände §§ 242, 247, 248a-c StGB und zwar:;14511000;Chemnitz;X;1890;1;8;7;27;63;106;90;74;164;160;430;113;123;236;337;394;174;127;192;1460
3***00;Diebstahl ohne erschwerende Umstände §§ 242, 247, 248a-c StGB und zwar:;6411000;Darmstadt;M;822;0;2;4;5;19;30;59;63;122;74;226;38;41;79;81;181;131;68;56;596
3***00;Diebstahl ohne erschwerende Umstände §§ 242, 247, 248a-c StGB und zwar:;6411000;Darmstadt;W;491;0;1;0;3;29;33;63;54;117;52;202;18;22;40;45;67;46;40;51;289
3***00;Diebstahl ohne erschwerende Umstände §§ 242, 247, 248a-c StGB und zwar:;6411000;Darmstadt;X;1313;0;3;4;8;48;63;122;117;239;126;428;56;63;119;126;248;177;108;107;885
3***00;Diebstahl ohne erschwerende Umstände §§ 242, 247, 248a-c StGB und zwar:;5913000;Dortmund;M;4123;2;4;29;66;118;219;204;309;513;517;1249;246;220;466;534;829;525;291;229;2874
3***00;Diebstahl ohne erschwerende Umstände §§ 242, 247, 248a-c StGB und zwar:;5913000;Dortmund;W;1899;1;4;12;34;106;157;229;189;418;167;742;98;91;189;204;255;214;126;169;1157
3***00;Diebstahl ohne erschwerende Umstände §§ 242, 247, 248a-c StGB und zwar:;5913000;Dortmund;X;6022;3;8;41;100;224;376;433;498;931;684;1991;344;311;655;738;1084;739;417;398;4031
3***00;Diebstahl ohne erschwerende Umstände §§ 242, 247, 248a-c StGB und zwar:;14612000;Dresden;M;2719;0;11;19;35;60;125;92;96;188;190;503;136;176;312;471;682;299;195;257;2216
3***00;Diebstahl ohne erschwerende Umstände §§ 242, 247, 248a-c StGB und zwar:;14612000;Dresden;W;1128;0;2;10;18;48;78;95;70;165;65;308;44;53;97;134;154;88;99;248;820
3***00;Diebstahl ohne erschwerende Umstände §§ 242, 247, 248a-c StGB und zwar:;14612000;Dresden;X;3847;0;13;29;53;108;203;187;166;353;255;811;180;229;409;605;836;387;294;505;3036
3***00;Diebstahl ohne erschwerende Umstände §§ 242, 247, 248a-c StGB und zwar:;5112000;Duisburg;M;2354;2;14;37;59;97;209;135;122;257;167;633;130;116;246;297;483;329;211;155;1721
3***00;Diebstahl ohne erschwerende Umstände §§ 242, 247, 248a-c StGB und zwar:;5112000;Duisburg;W;1110;4;6;19;29;51;109;78;69;147;91;347;62;48;110;124;185;138;96;110;763
3***00;Diebstahl ohne erschwerende Umstände §§ 242, 247, 248a-c StGB und zwar:;5112000;Duisburg;X;3464;6;20;56;88;148;318;213;191;404;258;980;192;164;356;421;668;467;307;265;2484
3***00;Diebstahl ohne erschwerende Umstände §§ 242, 247, 248a-c StGB und zwar:;5111000;Düsseldorf;M;3461;1;4;9;28;76;118;137;184;321;322;761;191;220;411;425;792;494;304;274;2700
3***00;Diebstahl ohne erschwerende Umstände §§ 242, 247, 248a-c StGB und zwar:;5111000;Düsseldorf;W;1693;0;1;6;21;97;125;193;161;354;133;612;61;71;132;166;257;202;146;178;1081
3***00;Diebstahl ohne erschwerende Umstände §§ 242, 247, 248a-c StGB und zwar:;5111000;Düsseldorf;X;5154;1;5;15;49;173;243;330;345;675;455;1373;252;291;543;591;1049;696;450;452;3781
3***00;Diebstahl ohne erschwerende Umstände §§ 242, 247, 248a-c StGB und zwar:;16051000;Erfurt;M;1232;1;2;13;33;32;81;61;56;117;79;277;58;68;126;158;257;150;118;146;955
3***00;Diebstahl ohne erschwerende Umstände §§ 242, 247, 248a-c StGB und zwar:;16051000;Erfurt;W;620;1;4;10;20;25;60;52;44;96;36;192;30;22;52;70;89;44;63;110;428
3***00;Diebstahl ohne erschwerende Umstände §§ 242, 247, 248a-c StGB und zwar:;16051000;Erfurt;X;1852;2;6;23;53;57;141;113;100;213;115;469;88;90;178;228;346;194;181;256;1383
3***00;Diebstahl ohne erschwerende Umstände §§ 242, 247, 248a-c StGB und zwar:;9562000;Erlangen;M;536;0;0;2;7;14;23;38;35;73;73;169;42;39;81;66;103;65;36;16;367
3***00;Diebstahl ohne erschwerende Umstände §§ 242, 247, 248a-c StGB und zwar:;9562000;Erlangen;W;249;0;0;0;2;18;20;38;29;67;12;99;10;12;22;26;37;22;23;20;150
3***00;Diebstahl ohne erschwerende Umstände §§ 242, 247, 248a-c StGB und zwar:;9562000;Erlangen;X;785;0;0;2;9;32;43;76;64;140;85;268;52;51;103;92;140;87;59;36;517
3***00;Diebstahl ohne erschwerende Umstände §§ 242, 247, 248a-c StGB und zwar:;5113000;Essen;M;2821;1;2;8;40;106;157;163;197;360;252;769;151;161;312;339;567;441;230;163;2052
3***00;Diebstahl ohne erschwerende Umstände §§ 242, 247, 248a-c StGB und zwar:;5113000;Essen;W;1579;1;0;5;16;97;119;238;189;427;135;681;48;50;98;134;248;154;126;138;898
3***00;Diebstahl ohne erschwerende Umstände §§ 242, 247, 248a-c StGB und zwar:;5113000;Essen;X;4400;2;2;13;56;203;276;401;386;787;387;1450;199;211;410;473;815;595;356;301;2950
3***00;Diebstahl ohne erschwerende Umstände §§ 242, 247, 248a-c StGB und zwar:;6412000;Frankfurt am Main;M;4393;4;2;7;27;54;94;145;232;377;382;853;227;229;456;599;1130;697;384;274;3540
3***00;Diebstahl ohne erschwerende Umstände §§ 242, 247, 248a-c StGB und zwar:;6412000;Frankfurt am Main;W;2054;3;1;5;16;98;123;252;180;432;191;746;111;99;210;190;349;247;144;168;1308
3***00;Diebstahl ohne erschwerende Umstände §§ 242, 247, 248a-c StGB und zwar:;6412000;Frankfurt am Main;X;6447;7;3;12;43;152;217;397;412;809;573;1599;338;328;666;789;1479;944;528;442;4848
3***00;Diebstahl ohne erschwerende Umstände §§ 242, 247, 248a-c StGB und zwar:;8311000;Freiburg im Breisgau;M;1331;1;3;5;20;47;76;93;136;229;127;432;82;69;151;146;245;161;107;89;899
3***00;Diebstahl ohne erschwerende Umstände §§ 242, 247, 248a-c StGB und zwar:;8311000;Freiburg im Breisgau;W;755;0;3;8;18;50;79;116;87;203;75;357;37;26;63;53;83;63;65;71;398
3***00;Diebstahl ohne erschwerende Umstände §§ 242, 247, 248a-c StGB und zwar:;8311000;Freiburg im Breisgau;X;2086;1;6;13;38;97;155;209;223;432;202;789;119;95;214;199;328;224;172;160;1297
3***00;Diebstahl ohne erschwerende Umstände §§ 242, 247, 248a-c StGB und zwar:;9563000;Fürth;M;567;0;1;5;13;30;49;27;21;48;46;143;33;34;67;88;115;86;38;30;424
3***00;Diebstahl ohne erschwerende Umstände §§ 242, 247, 248a-c StGB und zwar:;9563000;Fürth;W;260;0;1;2;4;9;16;19;20;39;21;76;9;10;19;19;38;38;27;43;184
3***00;Diebstahl ohne erschwerende Umstände §§ 242, 247, 248a-c StGB und zwar:;9563000;Fürth;X;827;0;2;7;17;39;65;46;41;87;67;219;42;44;86;107;153;124;65;73;608
3***00;Diebstahl ohne erschwerende Umstände §§ 242, 247, 248a-c StGB und zwar:;5513000;Gelsenkirchen;M;1392;4;1;17;44;80;146;87;82;169;116;431;77;72;149;172;266;188;99;87;961
3***00;Diebstahl ohne erschwerende Umstände §§ 242, 247, 248a-c StGB und zwar:;5513000;Gelsenkirchen;W;923;0;3;7;20;58;88;72;71;143;94;325;47;54;101;101;140;101;79;76;598
3***00;Diebstahl ohne erschwerende Umstände §§ 242, 247, 248a-c StGB und zwar:;5513000;Gelsenkirchen;X;2315;4;4;24;64;138;234;159;153;312;210;756;124;126;250;273;406;289;178;163;1559
3***00;Diebstahl ohne erschwerende Umstände §§ 242, 247, 248a-c StGB und zwar:;3152012;Göttingen;M;742;0;3;8;11;26;48;39;32;71;71;190;55;37;92;100;141;98;54;67;552
3***00;Diebstahl ohne erschwerende Umstände §§ 242, 247, 248a-c StGB und zwar:;3152012;Göttingen;W;394;0;2;4;7;24;37;45;23;68;32;137;19;18;37;29;54;45;42;50;257
3***00;Diebstahl ohne erschwerende Umstände §§ 242, 247, 248a-c StGB und zwar:;3152012;Göttingen;X;1136;0;5;12;18;50;85;84;55;139;103;327;74;55;129;129;195;143;96;117;809
3***00;Diebstahl ohne erschwerende Umstände §§ 242, 247, 248a-c StGB und zwar:;5914000;Hagen;M;1016;0;4;6;16;50;76;59;49;108;77;261;50;38;88;117;234;153;90;73;755
3***00;Diebstahl ohne erschwerende Umstände §§ 242, 247, 248a-c StGB und zwar:;5914000;Hagen;W;515;0;1;0;6;16;23;62;54;116;36;175;20;32;52;45;78;59;51;55;340
3***00;Diebstahl ohne erschwerende Umstände §§ 242, 247, 248a-c StGB und zwar:;5914000;Hagen;X;1531;0;5;6;22;66;99;121;103;224;113;436;70;70;140;162;312;212;141;128;1095
3***00;Diebstahl ohne erschwerende Umstände §§ 242, 247, 248a-c StGB und zwar:;15002000;Halle (Saale);M;1301;1;5;15;27;53;101;60;49;109;72;282;52;74;126;203;275;151;136;128;1019
3***00;Diebstahl ohne erschwerende Umstände §§ 242, 247, 248a-c StGB und zwar:;15002000;Halle (Saale);W;562;0;4;6;16;36;62;44;44;88;32;182;16;17;33;66;76;53;60;92;380
3***00;Diebstahl ohne erschwerende Umstände §§ 242, 247, 248a-c StGB und zwar:;15002000;Halle (Saale);X;1863;1;9;21;43;89;163;104;93;197;104;464;68;91;159;269;351;204;196;220;1399
3***00;Diebstahl ohne erschwerende Umstände §§ 242, 247, 248a-c StGB und zwar:;2000000;Hamburg;M;10315;1;15;62;134;273;485;544;700;1244;834;2563;510;506;1016;1315;2101;1631;925;764;7752
3***00;Diebstahl ohne erschwerende Umstände §§ 242, 247, 248a-c StGB und zwar:;2000000;Hamburg;W;4680;2;11;25;55;255;348;454;286;740;317;1405;199;252;451;450;744;600;490;540;3275
3***00;Diebstahl ohne erschwerende Umstände §§ 242, 247, 248a-c StGB und zwar:;2000000;Hamburg;X;14995;3;26;87;189;528;833;998;986;1984;1151;3968;709;758;1467;1765;2845;2231;1415;1304;11027
3***00;Diebstahl ohne erschwerende Umstände §§ 242, 247, 248a-c StGB und zwar:;5915000;Hamm;M;730;1;2;3;4;20;30;38;46;84;77;191;27;45;72;81;158;113;65;50;539
3***00;Diebstahl ohne erschwerende Umstände §§ 242, 247, 248a-c StGB und zwar:;5915000;Hamm;W;341;0;0;1;8;26;35;29;31;60;38;133;23;18;41;23;45;41;29;29;208
3***00;Diebstahl ohne erschwerende Umstände §§ 242, 247, 248a-c StGB und zwar:;5915000;Hamm;X;1071;1;2;4;12;46;65;67;77;144;115;324;50;63;113;104;203;154;94;79;747
3***00;Diebstahl ohne erschwerende Umstände §§ 242, 247, 248a-c StGB und zwar:;3241001;Hannover;M;3678;2;8;24;33;72;139;149;190;339;362;840;243;217;460;480;785;549;307;257;2838
3***00;Diebstahl ohne erschwerende Umstände §§ 242, 247, 248a-c StGB und zwar:;3241001;Hannover;W;1924;1;4;5;17;110;137;253;198;451;166;754;95;83;178;170;227;219;169;207;1170
3***00;Diebstahl ohne erschwerende Umstände §§ 242, 247, 248a-c StGB und zwar:;3241001;Hannover;X;5602;3;12;29;50;182;276;402;388;790;528;1594;338;300;638;650;1012;768;476;464;4008
3***00;Diebstahl ohne erschwerende Umstände §§ 242, 247, 248a-c StGB und zwar:;8221000;Heidelberg;M;866;0;2;2;3;32;39;56;50;106;67;212;46;55;101;99;187;114;82;71;654
3***00;Diebstahl ohne erschwerende Umstände §§ 242, 247, 248a-c StGB und zwar:;8221000;Heidelberg;W;522;0;0;3;7;32;42;87;39;126;59;227;21;17;38;43;63;54;39;58;295
3***00;Diebstahl ohne erschwerende Umstände §§ 242, 247, 248a-c StGB und zwar:;8221000;Heidelberg;X;1388;0;2;5;10;64;81;143;89;232;126;439;67;72;139;142;250;168;121;129;949
3***00;Diebstahl ohne erschwerende Umstände §§ 242, 247, 248a-c StGB und zwar:;8121000;Heilbronn;M;584;0;0;5;9;11;25;48;36;84;42;151;28;24;52;80;113;87;46;55;433
3***00;Diebstahl ohne erschwerende Umstände §§ 242, 247, 248a-c StGB und zwar:;8121000;Heilbronn;W;321;0;2;0;4;20;26;62;31;93;16;135;9;24;33;35;45;24;18;31;186
3***00;Diebstahl ohne erschwerende Umstände §§ 242, 247, 248a-c StGB und zwar:;8121000;Heilbronn;X;905;0;2;5;13;31;51;110;67;177;58;286;37;48;85;115;158;111;64;86;619
3***00;Diebstahl ohne erschwerende Umstände §§ 242, 247, 248a-c StGB und zwar:;5916000;Herne;M;726;0;2;8;16;39;65;39;44;83;64;212;51;36;87;96;136;88;62;45;514
3***00;Diebstahl ohne erschwerende Umstände §§ 242, 247, 248a-c StGB und zwar:;5916000;Herne;W;353;1;1;0;5;22;29;32;25;57;25;111;23;20;43;29;51;50;31;38;242
3***00;Diebstahl ohne erschwerende Umstände §§ 242, 247, 248a-c StGB und zwar:;5916000;Herne;X;1079;1;3;8;21;61;94;71;69;140;89;323;74;56;130;125;187;138;93;83;756
3***00;Diebstahl ohne erschwerende Umstände §§ 242, 247, 248a-c StGB und zwar:;9161000;Ingolstadt;M;444;0;0;2;10;17;29;32;28;60;34;123;26;23;49;57;82;64;35;34;321
3***00;Diebstahl ohne erschwerende Umstände §§ 242, 247, 248a-c StGB und zwar:;9161000;Ingolstadt;W;308;0;0;0;1;13;14;49;23;72;16;102;13;16;29;23;33;42;36;43;206
3***00;Diebstahl ohne erschwerende Umstände §§ 242, 247, 248a-c StGB und zwar:;9161000;Ingolstadt;X;752;0;0;2;11;30;43;81;51;132;50;225;39;39;78;80;115;106;71;77;527
3***00;Diebstahl ohne erschwerende Umstände §§ 242, 247, 248a-c StGB und zwar:;16053000;Jena;M;382;0;1;4;8;6;19;14;14;28;40;87;18;37;55;57;79;42;26;36;295
3***00;Diebstahl ohne erschwerende Umstände §§ 242, 247, 248a-c StGB und zwar:;16053000;Jena;W;186;0;2;1;2;11;16;9;5;14;18;48;7;17;24;18;26;15;17;38;138
3***00;Diebstahl ohne erschwerende Umstände §§ 242, 247, 248a-c StGB und zwar:;16053000;Jena;X;568;0;3;5;10;17;35;23;19;42;58;135;25;54;79;75;105;57;43;74;433
3***00;Diebstahl ohne erschwerende Umstände §§ 242, 247, 248a-c StGB und zwar:;8212000;Karlsruhe;M;1835;0;1;8;11;44;64;80;153;233;185;482;140;139;279;302;362;180;120;110;1353
3***00;Diebstahl ohne erschwerende Umstände §§ 242, 247, 248a-c StGB und zwar:;8212000;Karlsruhe;W;812;1;0;11;9;34;55;106;83;189;65;309;33;36;69;63;118;95;70;88;503
3***00;Diebstahl ohne erschwerende Umstände §§ 242, 247, 248a-c StGB und zwar:;8212000;Karlsruhe;X;2647;1;1;19;20;78;119;186;236;422;250;791;173;175;348;365;480;275;190;198;1856
3***00;Diebstahl ohne erschwerende Umstände §§ 242, 247, 248a-c StGB und zwar:;6611000;Kassel;M;1142;0;3;3;7;20;33;58;64;122;92;247;71;48;119;141;236;165;120;114;895
3***00;Diebstahl ohne erschwerende Umstände §§ 242, 247, 248a-c StGB und zwar:;6611000;Kassel;W;576;0;0;0;5;23;28;69;53;122;49;199;21;23;44;58;90;74;47;64;377
3***00;Diebstahl ohne erschwerende Umstände §§ 242, 247, 248a-c StGB und zwar:;6611000;Kassel;X;1718;0;3;3;12;43;61;127;117;244;141;446;92;71;163;199;326;239;167;178;1272
3***00;Diebstahl ohne erschwerende Umstände §§ 242, 247, 248a-c StGB und zwar:;1002000;Kiel;M;1126;0;9;13;18;27;67;66;55;121;89;277;55;48;103;144;236;181;113;72;849
3***00;Diebstahl ohne erschwerende Umstände §§ 242, 247, 248a-c StGB und zwar:;1002000;Kiel;W;554;1;0;4;9;20;34;54;49;103;50;187;30;20;50;45;94;68;42;68;367
3***00;Diebstahl ohne erschwerende Umstände §§ 242, 247, 248a-c StGB und zwar:;1002000;Kiel;X;1680;1;9;17;27;47;101;120;104;224;139;464;85;68;153;189;330;249;155;140;1216
3***00;Diebstahl ohne erschwerende Umstände §§ 242, 247, 248a-c StGB und zwar:;7111000;Koblenz;M;540;0;0;1;10;13;24;32;37;69;55;148;33;22;55;69;108;73;56;31;392
3***00;Diebstahl ohne erschwerende Umstände §§ 242, 247, 248a-c StGB und zwar:;7111000;Koblenz;W;338;0;0;0;10;20;30;43;26;69;25;124;19;9;28;33;48;46;30;29;214
3***00;Diebstahl ohne erschwerende Umstände §§ 242, 247, 248a-c StGB und zwar:;7111000;Koblenz;X;878;0;0;1;20;33;54;75;63;138;80;272;52;31;83;102;156;119;86;60;606
3***00;Diebstahl ohne erschwerende Umstände §§ 242, 247, 248a-c StGB und zwar:;5315000;Köln;M;5733;3;8;28;53;174;266;304;416;720;563;1549;302;327;629;727;1213;818;440;357;4184
3***00;Diebstahl ohne erschwerende Umstände §§ 242, 247, 248a-c StGB und zwar:;5315000;Köln;W;2708;1;8;17;43;150;219;311;264;575;202;996;109;130;239;264;387;297;237;288;1712
3***00;Diebstahl ohne erschwerende Umstände §§ 242, 247, 248a-c StGB und zwar:;5315000;Köln;X;8441;4;16;45;96;324;485;615;680;1295;765;2545;411;457;868;991;1600;1115;677;645;5896
3***00;Diebstahl ohne erschwerende Umstände §§ 242, 247, 248a-c StGB und zwar:;5114000;Krefeld;M;1035;0;3;7;12;38;60;58;50;108;96;264;58;67;125;148;231;146;56;65;771
3***00;Diebstahl ohne erschwerende Umstände §§ 242, 247, 248a-c StGB und zwar:;5114000;Krefeld;W;537;0;0;2;11;32;45;62;46;108;39;192;32;24;56;47;86;55;53;48;345
3***00;Diebstahl ohne erschwerende Umstände §§ 242, 247, 248a-c StGB und zwar:;5114000;Krefeld;X;1572;0;3;9;23;70;105;120;96;216;135;456;90;91;181;195;317;201;109;113;1116
3***00;Diebstahl ohne erschwerende Umstände §§ 242, 247, 248a-c StGB und zwar:;14713000;Leipzig;M;3679;1;5;10;42;78;136;118;126;244;258;638;207;270;477;647;870;450;273;324;3041
3***00;Diebstahl ohne erschwerende Umstände §§ 242, 247, 248a-c StGB und zwar:;14713000;Leipzig;W;1513;1;2;9;25;61;98;128;72;200;83;381;78;85;163;188;216;133;171;261;1132
3***00;Diebstahl ohne erschwerende Umstände §§ 242, 247, 248a-c StGB und zwar:;14713000;Leipzig;X;5192;2;7;19;67;139;234;246;198;444;341;1019;285;355;640;835;1086;583;444;585;4173
3***00;Diebstahl ohne erschwerende Umstände §§ 242, 247, 248a-c StGB und zwar:;5316000;Leverkusen;M;533;1;4;4;11;19;39;28;30;58;54;151;31;26;57;56;89;78;54;48;382
3***00;Diebstahl ohne erschwerende Umstände §§ 242, 247, 248a-c StGB und zwar:;5316000;Leverkusen;W;268;1;2;2;13;10;28;27;17;44;17;89;9;14;23;18;31;34;35;38;179
3***00;Diebstahl ohne erschwerende Umstände §§ 242, 247, 248a-c StGB und zwar:;5316000;Leverkusen;X;801;2;6;6;24;29;67;55;47;102;71;240;40;40;80;74;120;112;89;86;561
3***00;Diebstahl ohne erschwerende Umstände §§ 242, 247, 248a-c StGB und zwar:;1003000;Lübeck;M;1336;1;3;15;10;38;67;65;75;140;99;306;73;67;140;154;247;210;130;149;1030
3***00;Diebstahl ohne erschwerende Umstände §§ 242, 247, 248a-c StGB und zwar:;1003000;Lübeck;W;638;0;1;6;13;33;53;66;58;124;55;232;27;33;60;55;80;63;62;86;406
3***00;Diebstahl ohne erschwerende Umstände §§ 242, 247, 248a-c StGB und zwar:;1003000;Lübeck;X;1974;1;4;21;23;71;120;131;133;264;154;538;100;100;200;209;327;273;192;235;1436
3***00;Diebstahl ohne erschwerende Umstände §§ 242, 247, 248a-c StGB und zwar:;7314000;Ludwigshafen am Rhein;M;891;2;8;8;13;27;58;45;51;96;62;216;49;41;90;117;173;157;70;68;675
3***00;Diebstahl ohne erschwerende Umstände §§ 242, 247, 248a-c StGB und zwar:;7314000;Ludwigshafen am Rhein;W;517;0;1;3;12;39;55;53;32;85;46;186;26;19;45;46;74;70;47;49;331
3***00;Diebstahl ohne erschwerende Umstände §§ 242, 247, 248a-c StGB und zwar:;7314000;Ludwigshafen am Rhein;X;1408;2;9;11;25;66;113;98;83;181;108;402;75;60;135;163;247;227;117;117;1006
3***00;Diebstahl ohne erschwerende Umstände §§ 242, 247, 248a-c StGB und zwar:;15003000;Magdeburg;M;1538;0;3;14;25;41;83;74;80;154;134;371;77;88;165;227;265;223;132;155;1167
3***00;Diebstahl ohne erschwerende Umstände §§ 242, 247, 248a-c StGB und zwar:;15003000;Magdeburg;W;749;0;2;5;14;35;56;50;33;83;48;187;35;42;77;69;85;81;80;170;562
3***00;Diebstahl ohne erschwerende Umstände §§ 242, 247, 248a-c StGB und zwar:;15003000;Magdeburg;X;2287;0;5;19;39;76;139;124;113;237;182;558;112;130;242;296;350;304;212;325;1729
3***00;Diebstahl ohne erschwerende Umstände §§ 242, 247, 248a-c StGB und zwar:;7315000;Mainz;M;970;0;1;5;13;19;38;52;66;118;97;253;56;52;108;139;179;124;86;81;717
3***00;Diebstahl ohne erschwerende Umstände §§ 242, 247, 248a-c StGB und zwar:;7315000;Mainz;W;483;0;0;1;9;29;39;69;45;114;42;195;23;19;42;44;62;57;35;48;288
3***00;Diebstahl ohne erschwerende Umstände §§ 242, 247, 248a-c StGB und zwar:;7315000;Mainz;X;1453;0;1;6;22;48;77;121;111;232;139;448;79;71;150;183;241;181;121;129;1005
3***00;Diebstahl ohne erschwerende Umstände §§ 242, 247, 248a-c StGB und zwar:;8222000;Mannheim;M;1520;1;3;6;17;42;69;60;88;148;152;369;92;98;190;201;286;231;137;106;1151
3***00;Diebstahl ohne erschwerende Umstände §§ 242, 247, 248a-c StGB und zwar:;8222000;Mannheim;W;803;1;0;2;16;36;55;94;74;168;73;296;33;38;71;70;131;94;63;78;507
3***00;Diebstahl ohne erschwerende Umstände §§ 242, 247, 248a-c StGB und zwar:;8222000;Mannheim;X;2323;2;3;8;33;78;124;154;162;316;225;665;125;136;261;271;417;325;200;184;1658
3***00;Diebstahl ohne erschwerende Umstände §§ 242, 247, 248a-c StGB und zwar:;5170024;Moers;M;343;0;0;3;5;16;24;15;21;36;31;91;21;23;44;46;77;48;16;21;252
3***00;Diebstahl ohne erschwerende Umstände §§ 242, 247, 248a-c StGB und zwar:;5170024;Moers;W;151;0;0;0;1;6;7;11;10;21;10;38;6;11;17;17;25;21;12;21;113
3***00;Diebstahl ohne erschwerende Umstände §§ 242, 247, 248a-c StGB und zwar:;5170024;Moers;X;494;0;0;3;6;22;31;26;31;57;41;129;27;34;61;63;102;69;28;42;365
3***00;Diebstahl ohne erschwerende Umstände §§ 242, 247, 248a-c StGB und zwar:;5116000;Mönchengladbach;M;1196;0;0;7;17;36;60;38;57;95;121;276;59;77;136;162;278;166;97;81;920
3***00;Diebstahl ohne erschwerende Umstände §§ 242, 247, 248a-c StGB und zwar:;5116000;Mönchengladbach;W;637;0;0;4;5;27;36;73;56;129;47;212;29;26;55;73;85;80;56;76;425
3***00;Diebstahl ohne erschwerende Umstände §§ 242, 247, 248a-c StGB und zwar:;5116000;Mönchengladbach;X;1833;0;0;11;22;63;96;111;113;224;168;488;88;103;191;235;363;246;153;157;1345
3***00;Diebstahl ohne erschwerende Umstände §§ 242, 247, 248a-c StGB und zwar:;5117000;Mülheim an der Ruhr;M;516;0;0;1;7;24;32;36;37;73;45;150;25;26;51;45;96;91;37;46;366
3***00;Diebstahl ohne erschwerende Umstände §§ 242, 247, 248a-c StGB und zwar:;5117000;Mülheim an der Ruhr;W;256;0;0;0;6;11;17;21;18;39;20;76;6;14;20;20;42;32;27;39;180
3***00;Diebstahl ohne erschwerende Umstände §§ 242, 247, 248a-c StGB und zwar:;5117000;Mülheim an der Ruhr;X;772;0;0;1;13;35;49;57;55;112;65;226;31;40;71;65;138;123;64;85;546
3***00;Diebstahl ohne erschwerende Umstände §§ 242, 247, 248a-c StGB und zwar:;9162000;München;M;5656;0;11;23;73;166;273;327;383;710;588;1571;308;326;634;644;1065;787;469;486;4085
3***00;Diebstahl ohne erschwerende Umstände §§ 242, 247, 248a-c StGB und zwar:;9162000;München;W;3255;1;3;6;26;182;218;296;270;566;252;1036;149;125;274;302;439;387;336;481;2219
3***00;Diebstahl ohne erschwerende Umstände §§ 242, 247, 248a-c StGB und zwar:;9162000;München;X;8911;1;14;29;99;348;491;623;653;1276;840;2607;457;451;908;946;1504;1174;805;967;6304
3***00;Diebstahl ohne erschwerende Umstände §§ 242, 247, 248a-c StGB und zwar:;5515000;Münster;M;1467;0;0;4;25;55;84;105;117;222;188;494;110;100;210;187;244;154;96;82;973
3***00;Diebstahl ohne erschwerende Umstände §§ 242, 247, 248a-c StGB und zwar:;5515000;Münster;W;736;0;0;4;17;49;70;87;79;166;58;294;27;31;58;59;113;74;63;75;442
3***00;Diebstahl ohne erschwerende Umstände §§ 242, 247, 248a-c StGB und zwar:;5515000;Münster;X;2203;0;0;8;42;104;154;192;196;388;246;788;137;131;268;246;357;228;159;157;1415
3***00;Diebstahl ohne erschwerende Umstände §§ 242, 247, 248a-c StGB und zwar:;5162024;Neuss;M;743;0;0;2;10;16;28;31;44;75;94;197;37;56;93;113;159;88;48;45;546
3***00;Diebstahl ohne erschwerende Umstände §§ 242, 247, 248a-c StGB und zwar:;5162024;Neuss;W;326;0;0;0;3;18;21;38;23;61;24;106;10;11;21;38;37;39;39;46;220
3***00;Diebstahl ohne erschwerende Umstände §§ 242, 247, 248a-c StGB und zwar:;5162024;Neuss;X;1069;0;0;2;13;34;49;69;67;136;118;303;47;67;114;151;196;127;87;91;766
3***00;Diebstahl ohne erschwerende Umstände §§ 242, 247, 248a-c StGB und zwar:;9564000;Nürnberg;M;3126;0;3;10;39;81;133;132;151;283;248;664;188;172;360;517;698;419;245;223;2462
3***00;Diebstahl ohne erschwerende Umstände §§ 242, 247, 248a-c StGB und zwar:;9564000;Nürnberg;W;1542;0;3;9;16;78;106;155;101;256;116;478;72;84;156;137;220;208;153;190;1064
3***00;Diebstahl ohne erschwerende Umstände §§ 242, 247, 248a-c StGB und zwar:;9564000;Nürnberg;X;4668;0;6;19;55;159;239;287;252;539;364;1142;260;256;516;654;918;627;398;413;3526
3***00;Diebstahl ohne erschwerende Umstände §§ 242, 247, 248a-c StGB und zwar:;5119000;Oberhausen;M;900;0;3;3;9;31;46;51;60;111;97;254;44;54;98;118;186;126;56;62;646
3***00;Diebstahl ohne erschwerende Umstände §§ 242, 247, 248a-c StGB und zwar:;5119000;Oberhausen;W;634;0;0;5;8;36;49;94;76;170;64;283;33;26;59;51;85;67;40;49;351
3***00;Diebstahl ohne erschwerende Umstände §§ 242, 247, 248a-c StGB und zwar:;5119000;Oberhausen;X;1534;0;3;8;17;67;95;145;136;281;161;537;77;80;157;169;271;193;96;111;997
3***00;Diebstahl ohne erschwerende Umstände §§ 242, 247, 248a-c StGB und zwar:;6413000;Offenbach am Main;M;678;0;0;5;13;26;44;36;32;68;76;188;52;29;81;85;132;102;47;43;490
3***00;Diebstahl ohne erschwerende Umstände §§ 242, 247, 248a-c StGB und zwar:;6413000;Offenbach am Main;W;360;0;0;0;2;14;16;30;30;60;33;109;23;13;36;47;61;45;33;29;251
3***00;Diebstahl ohne erschwerende Umstände §§ 242, 247, 248a-c StGB und zwar:;6413000;Offenbach am Main;X;1038;0;0;5;15;40;60;66;62;128;109;297;75;42;117;132;193;147;80;72;741
3***00;Diebstahl ohne erschwerende Umstände §§ 242, 247, 248a-c StGB und zwar:;3403000;Oldenburg (Oldenburg);M;661;0;0;3;7;25;35;44;52;96;76;207;61;38;99;80;110;61;61;43;454
3***00;Diebstahl ohne erschwerende Umstände §§ 242, 247, 248a-c StGB und zwar:;3403000;Oldenburg (Oldenburg);W;339;1;2;2;1;12;18;34;39;73;27;118;17;14;31;29;49;46;36;30;221
3***00;Diebstahl ohne erschwerende Umstände §§ 242, 247, 248a-c StGB und zwar:;3403000;Oldenburg (Oldenburg);X;1000;1;2;5;8;37;53;78;91;169;103;325;78;52;130;109;159;107;97;73;675
3***00;Diebstahl ohne erschwerende Umstände §§ 242, 247, 248a-c StGB und zwar:;3404000;Osnabrück;M;1019;1;0;1;8;21;31;45;45;90;94;215;48;83;131;166;214;137;88;68;804
3***00;Diebstahl ohne erschwerende Umstände §§ 242, 247, 248a-c StGB und zwar:;3404000;Osnabrück;W;494;0;0;1;4;16;21;45;33;78;50;149;25;17;42;48;71;66;52;66;345
3***00;Diebstahl ohne erschwerende Umstände §§ 242, 247, 248a-c StGB und zwar:;3404000;Osnabrück;X;1513;1;0;2;12;37;52;90;78;168;144;364;73;100;173;214;285;203;140;134;1149
3***00;Diebstahl ohne erschwerende Umstände §§ 242, 247, 248a-c StGB und zwar:;5774032;Paderborn;M;744;1;2;4;5;22;34;40;48;88;85;207;49;44;93;99;170;81;54;40;537
3***00;Diebstahl ohne erschwerende Umstände §§ 242, 247, 248a-c StGB und zwar:;5774032;Paderborn;W;255;0;0;0;6;13;19;22;24;46;20;85;9;8;17;17;36;34;30;36;170
3***00;Diebstahl ohne erschwerende Umstände §§ 242, 247, 248a-c StGB und zwar:;5774032;Paderborn;X;999;1;2;4;11;35;53;62;72;134;105;292;58;52;110;116;206;115;84;76;707
3***00;Diebstahl ohne erschwerende Umstände §§ 242, 247, 248a-c StGB und zwar:;8231000;Pforzheim;M;728;0;1;4;18;28;51;52;43;95;44;190;41;41;82;92;144;105;60;55;538
3***00;Diebstahl ohne erschwerende Umstände §§ 242, 247, 248a-c StGB und zwar:;8231000;Pforzheim;W;439;0;1;2;2;29;34;42;29;71;37;142;21;17;38;50;58;50;45;56;297
3***00;Diebstahl ohne erschwerende Umstände §§ 242, 247, 248a-c StGB und zwar:;8231000;Pforzheim;X;1167;0;2;6;20;57;85;94;72;166;81;332;62;58;120;142;202;155;105;111;835
3***00;Diebstahl ohne erschwerende Umstände §§ 242, 247, 248a-c StGB und zwar:;12054000;Potsdam;M;793;0;2;2;7;28;39;59;40;99;57;195;41;49;90;94;150;109;80;75;598
3***00;Diebstahl ohne erschwerende Umstände §§ 242, 247, 248a-c StGB und zwar:;12054000;Potsdam;W;372;0;0;3;3;21;27;35;24;59;27;113;24;15;39;36;45;25;51;63;259
3***00;Diebstahl ohne erschwerende Umstände §§ 242, 247, 248a-c StGB und zwar:;12054000;Potsdam;X;1165;0;2;5;10;49;66;94;64;158;84;308;65;64;129;130;195;134;131;138;857
3***00;Diebstahl ohne erschwerende Umstände §§ 242, 247, 248a-c StGB und zwar:;5562032;Recklinghausen;M;532;0;1;6;10;21;38;43;38;81;44;163;33;30;63;71;96;65;36;38;369
3***00;Diebstahl ohne erschwerende Umstände §§ 242, 247, 248a-c StGB und zwar:;5562032;Recklinghausen;W;240;0;0;0;5;8;13;18;12;30;17;60;12;10;22;26;41;37;28;26;180
3***00;Diebstahl ohne erschwerende Umstände §§ 242, 247, 248a-c StGB und zwar:;5562032;Recklinghausen;X;772;0;1;6;15;29;51;61;50;111;61;223;45;40;85;97;137;102;64;64;549
3***00;Diebstahl ohne erschwerende Umstände §§ 242, 247, 248a-c StGB und zwar:;9362000;Regensburg;M;950;0;1;2;14;36;53;44;53;97;89;239;70;55;125;125;202;129;68;62;711
3***00;Diebstahl ohne erschwerende Umstände §§ 242, 247, 248a-c StGB und zwar:;9362000;Regensburg;W;487;0;0;0;7;21;28;53;34;87;47;162;20;15;35;57;86;49;38;60;325
3***00;Diebstahl ohne erschwerende Umstände §§ 242, 247, 248a-c StGB und zwar:;9362000;Regensburg;X;1437;0;1;2;21;57;81;97;87;184;136;401;90;70;160;182;288;178;106;122;1036
3***00;Diebstahl ohne erschwerende Umstände §§ 242, 247, 248a-c StGB und zwar:;5120000;Remscheid;M;488;0;1;3;5;17;26;35;31;66;48;140;25;22;47;55;92;50;58;46;348
3***00;Diebstahl ohne erschwerende Umstände §§ 242, 247, 248a-c StGB und zwar:;5120000;Remscheid;W;222;0;0;0;5;13;18;12;15;27;10;55;3;7;10;23;41;41;21;31;167
3***00;Diebstahl ohne erschwerende Umstände §§ 242, 247, 248a-c StGB und zwar:;5120000;Remscheid;X;710;0;1;3;10;30;44;47;46;93;58;195;28;29;57;78;133;91;79;77;515
3***00;Diebstahl ohne erschwerende Umstände §§ 242, 247, 248a-c StGB und zwar:;8415061;Reutlingen;M;368;0;1;0;9;27;37;36;23;59;38;134;26;15;41;41;67;38;29;18;234
3***00;Diebstahl ohne erschwerende Umstände §§ 242, 247, 248a-c StGB und zwar:;8415061;Reutlingen;W;242;0;0;1;3;13;17;34;30;64;34;115;6;4;10;21;39;20;20;17;127
3***00;Diebstahl ohne erschwerende Umstände §§ 242, 247, 248a-c StGB und zwar:;8415061;Reutlingen;X;610;0;1;1;12;40;54;70;53;123;72;249;32;19;51;62;106;58;49;35;361
3***00;Diebstahl ohne erschwerende Umstände §§ 242, 247, 248a-c StGB und zwar:;13003000;Rostock;M;880;0;14;26;24;38;102;28;39;67;60;229;47;45;92;125;164;97;74;99;651
3***00;Diebstahl ohne erschwerende Umstände §§ 242, 247, 248a-c StGB und zwar:;13003000;Rostock;W;477;2;1;9;23;37;72;50;26;76;23;171;12;19;31;34;38;45;57;101;306
3***00;Diebstahl ohne erschwerende Umstände §§ 242, 247, 248a-c StGB und zwar:;13003000;Rostock;X;1357;2;15;35;47;75;174;78;65;143;83;400;59;64;123;159;202;142;131;200;957
3***00;Diebstahl ohne erschwerende Umstände §§ 242, 247, 248a-c StGB und zwar:;10041100;Saarbrücken;M;1214;1;4;11;14;40;70;84;78;162;116;348;62;62;124;160;244;160;97;81;866
3***00;Diebstahl ohne erschwerende Umstände §§ 242, 247, 248a-c StGB und zwar:;10041100;Saarbrücken;W;1046;3;1;6;16;78;104;148;109;257;118;479;45;34;79;87;133;84;75;109;567
3***00;Diebstahl ohne erschwerende Umstände §§ 242, 247, 248a-c StGB und zwar:;10041100;Saarbrücken;X;2260;4;5;17;30;118;174;232;187;419;234;827;107;96;203;247;377;244;172;190;1433
3***00;Diebstahl ohne erschwerende Umstände §§ 242, 247, 248a-c StGB und zwar:;5122000;Solingen;M;639;0;1;3;10;19;33;30;42;72;48;153;21;26;47;61;138;90;65;85;486
3***00;Diebstahl ohne erschwerende Umstände §§ 242, 247, 248a-c StGB und zwar:;5122000;Solingen;W;310;0;0;1;3;25;29;22;24;46;12;87;8;15;23;36;52;41;35;36;223
3***00;Diebstahl ohne erschwerende Umstände §§ 242, 247, 248a-c StGB und zwar:;5122000;Solingen;X;949;0;1;4;13;44;62;52;66;118;60;240;29;41;70;97;190;131;100;121;709
3***00;Diebstahl ohne erschwerende Umstände §§ 242, 247, 248a-c StGB und zwar:;8111000;Stuttgart;M;2849;0;15;17;47;86;165;163;202;365;286;816;151;159;310;313;545;378;241;246;2033
3***00;Diebstahl ohne erschwerende Umstände §§ 242, 247, 248a-c StGB und zwar:;8111000;Stuttgart;W;1431;0;2;5;19;71;97;200;138;338;112;547;60;48;108;132;217;146;120;161;884
3***00;Diebstahl ohne erschwerende Umstände §§ 242, 247, 248a-c StGB und zwar:;8111000;Stuttgart;X;4280;0;17;22;66;157;262;363;340;703;398;1363;211;207;418;445;762;524;361;407;2917
3***00;Diebstahl ohne erschwerende Umstände §§ 242, 247, 248a-c StGB und zwar:;7211000;Trier;M;675;0;0;7;18;18;43;38;54;92;66;201;45;53;98;95;139;79;40;23;474
3***00;Diebstahl ohne erschwerende Umstände §§ 242, 247, 248a-c StGB und zwar:;7211000;Trier;W;317;0;0;0;5;19;24;40;25;65;23;112;18;17;35;34;45;30;34;27;205
3***00;Diebstahl ohne erschwerende Umstände §§ 242, 247, 248a-c StGB und zwar:;7211000;Trier;X;992;0;0;7;23;37;67;78;79;157;89;313;63;70;133;129;184;109;74;50;679
3***00;Diebstahl ohne erschwerende Umstände §§ 242, 247, 248a-c StGB und zwar:;8421000;Ulm;M;636;1;0;4;11;36;52;30;53;83;48;183;55;34;89;80;136;66;44;38;453
3***00;Diebstahl ohne erschwerende Umstände §§ 242, 247, 248a-c StGB und zwar:;8421000;Ulm;W;413;0;0;1;5;26;32;73;48;121;36;189;24;16;40;38;53;27;23;43;224
3***00;Diebstahl ohne erschwerende Umstände §§ 242, 247, 248a-c StGB und zwar:;8421000;Ulm;X;1049;1;0;5;16;62;84;103;101;204;84;372;79;50;129;118;189;93;67;81;677
3***00;Diebstahl ohne erschwerende Umstände §§ 242, 247, 248a-c StGB und zwar:;6414000;Wiesbaden;M;1199;0;3;7;12;31;53;93;78;171;111;335;69;55;124;117;240;167;104;112;864
3***00;Diebstahl ohne erschwerende Umstände §§ 242, 247, 248a-c StGB und zwar:;6414000;Wiesbaden;W;696;0;1;4;7;30;42;50;55;105;50;197;29;33;62;59;118;84;65;111;499
3***00;Diebstahl ohne erschwerende Umstände §§ 242, 247, 248a-c StGB und zwar:;6414000;Wiesbaden;X;1895;0;4;11;19;61;95;143;133;276;161;532;98;88;186;176;358;251;169;223;1363
3***00;Diebstahl ohne erschwerende Umstände §§ 242, 247, 248a-c StGB und zwar:;3103000;Wolfsburg;M;405;1;0;1;6;22;30;19;28;47;25;102;17;26;43;56;83;48;32;41;303
3***00;Diebstahl ohne erschwerende Umstände §§ 242, 247, 248a-c StGB und zwar:;3103000;Wolfsburg;W;229;0;1;0;5;23;29;23;11;34;8;71;6;7;13;17;39;20;29;40;158
3***00;Diebstahl ohne erschwerende Umstände §§ 242, 247, 248a-c StGB und zwar:;3103000;Wolfsburg;X;634;1;1;1;11;45;59;42;39;81;33;173;23;33;56;73;122;68;61;81;461
3***00;Diebstahl ohne erschwerende Umstände §§ 242, 247, 248a-c StGB und zwar:;5124000;Wuppertal;M;1925;1;6;18;44;64;133;117;99;216;129;478;91;96;187;211;415;292;186;156;1447
3***00;Diebstahl ohne erschwerende Umstände §§ 242, 247, 248a-c StGB und zwar:;5124000;Wuppertal;W;834;1;5;7;18;52;83;82;76;158;65;306;39;37;76;79;135;86;72;80;528
3***00;Diebstahl ohne erschwerende Umstände §§ 242, 247, 248a-c StGB und zwar:;5124000;Wuppertal;X;2759;2;11;25;62;116;216;199;175;374;194;784;130;133;263;290;550;378;258;236;1975
3***00;Diebstahl ohne erschwerende Umstände §§ 242, 247, 248a-c StGB und zwar:;9663000;Würzburg;M;686;0;1;9;11;33;54;33;31;64;65;183;55;50;105;97;111;69;58;63;503
3***00;Diebstahl ohne erschwerende Umstände §§ 242, 247, 248a-c StGB und zwar:;9663000;Würzburg;W;325;0;0;1;3;31;35;46;21;67;25;127;14;12;26;27;28;24;38;55;198
3***00;Diebstahl ohne erschwerende Umstände §§ 242, 247, 248a-c StGB und zwar:;9663000;Würzburg;X;1011;0;1;10;14;64;89;79;52;131;90;310;69;62;131;124;139;93;96;118;701
326*00;Einfacher Ladendiebstahl;5334002;Aachen;M;883;0;1;5;28;29;63;60;64;124;66;253;36;33;69;112;173;120;102;54;630
326*00;Einfacher Ladendiebstahl;5334002;Aachen;W;488;0;0;2;4;17;23;55;51;106;39;168;26;25;51;38;51;64;62;54;320
326*00;Einfacher Ladendiebstahl;5334002;Aachen;X;1371;0;1;7;32;46;86;115;115;230;105;421;62;58;120;150;224;184;164;108;950
326*00;Einfacher Ladendiebstahl;9761000;Augsburg;M;656;0;2;9;14;36;61;55;33;88;37;186;25;27;52;72;142;85;54;65;470
326*00;Einfacher Ladendiebstahl;9761000;Augsburg;W;517;0;1;1;8;42;52;55;38;93;38;183;15;16;31;45;62;62;61;73;334
326*00;Einfacher Ladendiebstahl;9761000;Augsburg;X;1173;0;3;10;22;78;113;110;71;181;75;369;40;43;83;117;204;147;115;138;804
326*00;Einfacher Ladendiebstahl;5378004;Bergisch Gladbach;M;262;0;0;0;4;12;16;10;8;18;20;54;13;7;20;39;49;40;26;34;208
326*00;Einfacher Ladendiebstahl;5378004;Bergisch Gladbach;W;141;0;0;0;0;3;3;15;14;29;7;39;7;7;14;8;20;23;17;20;102
326*00;Einfacher Ladendiebstahl;5378004;Bergisch Gladbach;X;403;0;0;0;4;15;19;25;22;47;27;93;20;14;34;47;69;63;43;54;310
326*00;Einfacher Ladendiebstahl;11000000;Berlin;M;12818;7;25;133;218;433;816;567;500;1067;946;2829;619;698;1317;1684;2619;1815;1232;1322;9989
326*00;Einfacher Ladendiebstahl;11000000;Berlin;W;7109;6;19;53;131;449;658;756;510;1266;547;2471;310;333;643;727;980;668;631;989;4638
326*00;Einfacher Ladendiebstahl;11000000;Berlin;X;19927;13;44;186;349;882;1474;1323;1010;2333;1493;5300;929;1031;1960;2411;3599;2483;1863;2311;14627
326*00;Einfacher Ladendiebstahl;5711000;Bielefeld;M;1217;0;0;9;21;33;63;47;97;144;69;276;54;73;127;182;278;155;96;103;941
326*00;Einfacher Ladendiebstahl;5711000;Bielefeld;W;581;0;0;7;4;19;30;80;63;143;41;214;26;24;50;44;75;71;65;62;367
326*00;Einfacher Ladendiebstahl;5711000;Bielefeld;X;1798;0;0;16;25;52;93;127;160;287;110;490;80;97;177;226;353;226;161;165;1308
326*00;Einfacher Ladendiebstahl;5911000;Bochum;M;1078;0;3;10;18;38;69;51;52;103;54;226;43;56;99;121;235;181;102;114;852
326*00;Einfacher Ladendiebstahl;5911000;Bochum;W;611;3;2;5;10;29;49;41;45;86;39;174;31;32;63;48;86;81;65;94;437
326*00;Einfacher Ladendiebstahl;5911000;Bochum;X;1689;3;5;15;28;67;118;92;97;189;93;400;74;88;162;169;321;262;167;208;1289
326*00;Einfacher Ladendiebstahl;5314000;Bonn;M;843;0;2;5;14;39;60;69;56;125;58;243;39;27;66;82;180;135;75;62;600
326*00;Einfacher Ladendiebstahl;5314000;Bonn;W;552;0;0;0;4;36;40;95;57;152;24;216;11;20;31;40;83;67;50;65;336
326*00;Einfacher Ladendiebstahl;5314000;Bonn;X;1395;0;2;5;18;75;100;164;113;277;82;459;50;47;97;122;263;202;125;127;936
326*00;Einfacher Ladendiebstahl;5512000;Bottrop;M;271;0;1;6;5;12;24;17;12;29;9;62;9;14;23;33;70;40;21;22;209
326*00;Einfacher Ladendiebstahl;5512000;Bottrop;W;199;0;1;2;2;18;23;28;9;37;16;76;10;6;16;10;32;20;21;24;123
326*00;Einfacher Ladendiebstahl;5512000;Bottrop;X;470;0;2;8;7;30;47;45;21;66;25;138;19;20;39;43;102;60;42;46;332
326*00;Einfacher Ladendiebstahl;3101000;Braunschweig;M;941;0;0;2;14;20;36;32;46;78;110;224;52;72;124;156;197;103;70;67;717
326*00;Einfacher Ladendiebstahl;3101000;Braunschweig;W;382;0;0;0;6;33;39;55;42;97;18;154;10;15;25;27;45;37;37;57;228
326*00;Einfacher Ladendiebstahl;3101000;Braunschweig;X;1323;0;0;2;20;53;75;87;88;175;128;378;62;87;149;183;242;140;107;124;945
326*00;Einfacher Ladendiebstahl;4011000;Bremen;M;1489;2;5;17;34;43;101;108;110;218;109;428;70;62;132;167;329;226;116;91;1061
326*00;Einfacher Ladendiebstahl;4011000;Bremen;W;942;3;2;4;12;64;85;142;128;270;71;426;46;38;84;85;125;82;61;79;516
326*00;Einfacher Ladendiebstahl;4011000;Bremen;X;2431;5;7;21;46;107;186;250;238;488;180;854;116;100;216;252;454;308;177;170;1577
326*00;Einfacher Ladendiebstahl;4012000;Bremerhaven;M;428;0;1;3;10;8;22;14;16;30;23;75;11;15;26;60;91;76;53;47;353
326*00;Einfacher Ladendiebstahl;4012000;Bremerhaven;W;198;0;0;4;1;13;18;14;7;21;9;48;11;7;18;15;28;28;35;26;150
326*00;Einfacher Ladendiebstahl;4012000;Bremerhaven;X;626;0;1;7;11;21;40;28;23;51;32;123;22;22;44;75;119;104;88;73;503
326*00;Einfacher Ladendiebstahl;14511000;Chemnitz;M;1077;1;7;1;18;24;51;43;27;70;97;218;80;79;159;215;236;92;64;93;859
326*00;Einfacher Ladendiebstahl;14511000;Chemnitz;W;346;0;1;2;4;29;36;36;31;67;28;131;8;17;25;24;44;29;23;70;215
326*00;Einfacher Ladendiebstahl;14511000;Chemnitz;X;1423;1;8;3;22;53;87;79;58;137;125;349;88;96;184;239;280;121;87;163;1074
326*00;Einfacher Ladendiebstahl;6411000;Darmstadt;M;579;0;2;3;5;16;26;32;30;62;40;128;27;23;50;55;142;95;56;53;451
326*00;Einfacher Ladendiebstahl;6411000;Darmstadt;W;408;0;1;0;3;26;30;61;46;107;37;174;15;14;29;36;53;40;34;42;234
326*00;Einfacher Ladendiebstahl;6411000;Darmstadt;X;987;0;3;3;8;42;56;93;76;169;77;302;42;37;79;91;195;135;90;95;685
326*00;Einfacher Ladendiebstahl;5913000;Dortmund;M;2822;2;3;23;58;98;184;139;189;328;318;830;158;150;308;332;581;383;201;187;1992
326*00;Einfacher Ladendiebstahl;5913000;Dortmund;W;1464;1;4;12;29;98;144;209;161;370;120;634;70;62;132;132;178;139;96;153;830
326*00;Einfacher Ladendiebstahl;5913000;Dortmund;X;4286;3;7;35;87;196;328;348;350;698;438;1464;228;212;440;464;759;522;297;340;2822
326*00;Einfacher Ladendiebstahl;14612000;Dresden;M;1966;0;11;17;28;54;110;78;68;146;134;390;92;115;207;298;477;203;157;234;1576
326*00;Einfacher Ladendiebstahl;14612000;Dresden;W;922;0;2;9;15;38;64;82;65;147;49;260;33;40;73;91;106;67;88;237;662
326*00;Einfacher Ladendiebstahl;14612000;Dresden;X;2888;0;13;26;43;92;174;160;133;293;183;650;125;155;280;389;583;270;245;471;2238
326*00;Einfacher Ladendiebstahl;5112000;Duisburg;M;1554;2;14;34;52;80;182;88;74;162;99;443;78;66;144;187;308;226;134;112;1111
326*00;Einfacher Ladendiebstahl;5112000;Duisburg;W;812;3;4;16;26;48;97;68;45;113;71;281;40;31;71;88;124;92;65;91;531
326*00;Einfacher Ladendiebstahl;5112000;Duisburg;X;2366;5;18;50;78;128;279;156;119;275;170;724;118;97;215;275;432;318;199;203;1642
326*00;Einfacher Ladendiebstahl;5111000;Düsseldorf;M;2120;1;0;7;21;49;78;96;80;176;120;374;83;107;190;244;531;323;223;235;1746
326*00;Einfacher Ladendiebstahl;5111000;Düsseldorf;W;1339;0;1;4;17;87;109;176;144;320;85;514;48;51;99;116;183;150;115;162;825
326*00;Einfacher Ladendiebstahl;5111000;Düsseldorf;X;3459;1;1;11;38;136;187;272;224;496;205;888;131;158;289;360;714;473;338;397;2571
326*00;Einfacher Ladendiebstahl;16051000;Erfurt;M;896;0;2;13;29;26;70;45;35;80;47;197;38;47;85;105;179;105;97;128;699
326*00;Einfacher Ladendiebstahl;16051000;Erfurt;W;509;1;4;9;19;24;57;52;40;92;28;177;22;16;38;54;58;31;54;97;332
326*00;Einfacher Ladendiebstahl;16051000;Erfurt;X;1405;1;6;22;48;50;127;97;75;172;75;374;60;63;123;159;237;136;151;225;1031
326*00;Einfacher Ladendiebstahl;9562000;Erlangen;M;304;0;0;2;8;12;22;21;17;38;26;86;21;17;38;41;63;42;20;14;218
326*00;Einfacher Ladendiebstahl;9562000;Erlangen;W;204;0;0;0;2;18;20;37;23;60;10;90;8;7;15;20;27;18;15;19;114
326*00;Einfacher Ladendiebstahl;9562000;Erlangen;X;508;0;0;2;10;30;42;58;40;98;36;176;29;24;53;61;90;60;35;33;332
326*00;Einfacher Ladendiebstahl;5113000;Essen;M;2073;1;2;7;36;89;135;128;126;254;162;551;100;107;207;243;444;319;167;142;1522
326*00;Einfacher Ladendiebstahl;5113000;Essen;W;1322;1;0;5;15;92;113;222;174;396;111;620;35;39;74;98;188;117;105;120;702
326*00;Einfacher Ladendiebstahl;5113000;Essen;X;3395;2;2;12;51;181;248;350;300;650;273;1171;135;146;281;341;632;436;272;262;2224
326*00;Einfacher Ladendiebstahl;6412000;Frankfurt am Main;M;2896;2;2;5;22;41;72;101;133;234;195;501;118;138;256;403;762;476;270;228;2395
326*00;Einfacher Ladendiebstahl;6412000;Frankfurt am Main;W;1620;1;1;3;12;80;97;233;161;394;148;639;78;63;141;144;265;179;107;145;981
326*00;Einfacher Ladendiebstahl;6412000;Frankfurt am Main;X;4516;3;3;8;34;121;169;334;294;628;343;1140;196;201;397;547;1027;655;377;373;3376
326*00;Einfacher Ladendiebstahl;8311000;Freiburg im Breisgau;M;877;1;3;5;17;32;58;69;72;141;56;255;38;44;82;88;188;108;84;72;622
326*00;Einfacher Ladendiebstahl;8311000;Freiburg im Breisgau;W;615;0;3;3;17;45;68;106;77;183;59;310;25;20;45;42;63;47;48;60;305
326*00;Einfacher Ladendiebstahl;8311000;Freiburg im Breisgau;X;1492;1;6;8;34;77;126;175;149;324;115;565;63;64;127;130;251;155;132;132;927
326*00;Einfacher Ladendiebstahl;9563000;Fürth;M;352;0;1;4;11;21;37;19;9;28;21;86;16;14;30;53;74;57;26;26;266
326*00;Einfacher Ladendiebstahl;9563000;Fürth;W;197;0;1;2;2;9;14;18;17;35;10;59;8;8;16;9;24;27;21;41;138
326*00;Einfacher Ladendiebstahl;9563000;Fürth;X;549;0;2;6;13;30;51;37;26;63;31;145;24;22;46;62;98;84;47;67;404
326*00;Einfacher Ladendiebstahl;5513000;Gelsenkirchen;M;909;4;1;16;36;62;119;56;52;108;65;292;39;43;82;95;176;127;59;78;617
326*00;Einfacher Ladendiebstahl;5513000;Gelsenkirchen;W;771;0;3;7;21;52;83;69;63;132;70;285;36;46;82;81;108;82;68;65;486
326*00;Einfacher Ladendiebstahl;5513000;Gelsenkirchen;X;1680;4;4;23;57;114;202;125;115;240;135;577;75;89;164;176;284;209;127;143;1103
326*00;Einfacher Ladendiebstahl;3152012;Göttingen;M;464;0;4;6;7;22;39;29;22;51;31;121;30;20;50;57;76;60;39;61;343
326*00;Einfacher Ladendiebstahl;3152012;Göttingen;W;293;0;2;3;7;23;35;41;17;58;24;117;9;13;22;14;37;30;31;42;176
326*00;Einfacher Ladendiebstahl;3152012;Göttingen;X;757;0;6;9;14;45;74;70;39;109;55;238;39;33;72;71;113;90;70;103;519
326*00;Einfacher Ladendiebstahl;5914000;Hagen;M;699;0;3;6;12;35;56;50;26;76;34;166;28;22;50;73;167;108;72;63;533
326*00;Einfacher Ladendiebstahl;5914000;Hagen;W;385;0;0;0;4;12;16;51;42;93;24;133;16;19;35;35;58;36;39;49;252
326*00;Einfacher Ladendiebstahl;5914000;Hagen;X;1084;0;3;6;16;47;72;101;68;169;58;299;44;41;85;108;225;144;111;112;785
326*00;Einfacher Ladendiebstahl;15002000;Halle (Saale);M;914;0;5;11;22;42;80;49;28;77;46;203;39;45;84;123;187;99;101;117;711
326*00;Einfacher Ladendiebstahl;15002000;Halle (Saale);W;437;0;3;5;15;35;58;40;39;79;17;154;10;10;20;50;49;33;45;86;283
326*00;Einfacher Ladendiebstahl;15002000;Halle (Saale);X;1351;0;8;16;37;77;138;89;67;156;63;357;49;55;104;173;236;132;146;203;994
326*00;Einfacher Ladendiebstahl;2000000;Hamburg;M;6634;0;12;41;95;194;342;322;346;668;390;1400;262;281;543;802;1400;1144;685;660;5234
326*00;Einfacher Ladendiebstahl;2000000;Hamburg;W;3439;1;8;22;45;209;285;357;208;565;214;1064;113;168;281;307;511;408;394;474;2375
326*00;Einfacher Ladendiebstahl;2000000;Hamburg;X;10073;1;20;63;140;403;627;679;554;1233;604;2464;375;449;824;1109;1911;1552;1079;1134;7609
326*00;Einfacher Ladendiebstahl;5915000;Hamm;M;475;1;1;2;2;18;24;22;23;45;33;102;13;23;36;60;111;81;45;40;373
326*00;Einfacher Ladendiebstahl;5915000;Hamm;W;266;0;0;1;7;24;32;27;24;51;25;108;21;12;33;20;28;27;26;24;158
326*00;Einfacher Ladendiebstahl;5915000;Hamm;X;741;1;1;3;9;42;56;49;47;96;58;210;34;35;69;80;139;108;71;64;531
326*00;Einfacher Ladendiebstahl;3241001;Hannover;M;2293;2;8;16;27;50;103;84;91;175;177;455;110;129;239;291;512;359;226;211;1838
326*00;Einfacher Ladendiebstahl;3241001;Hannover;W;1465;1;3;3;14;103;124;235;176;411;105;640;64;55;119;112;152;147;116;179;825
326*00;Einfacher Ladendiebstahl;3241001;Hannover;X;3758;3;11;19;41;153;227;319;267;586;282;1095;174;184;358;403;664;506;342;390;2663
326*00;Einfacher Ladendiebstahl;8221000;Heidelberg;M;668;0;2;2;3;28;35;46;33;79;46;160;28;39;67;73;141;94;71;62;508
326*00;Einfacher Ladendiebstahl;8221000;Heidelberg;W;438;0;0;3;7;31;41;81;30;111;43;195;16;13;29;33;50;44;33;54;243
326*00;Einfacher Ladendiebstahl;8221000;Heidelberg;X;1106;0;2;5;10;59;76;127;63;190;89;355;44;52;96;106;191;138;104;116;751
326*00;Einfacher Ladendiebstahl;8121000;Heilbronn;M;420;0;0;4;8;11;23;41;27;68;23;114;9;10;19;56;78;65;41;47;306
326*00;Einfacher Ladendiebstahl;8121000;Heilbronn;W;276;0;2;0;4;20;26;60;24;84;9;119;5;20;25;31;39;22;14;26;157
326*00;Einfacher Ladendiebstahl;8121000;Heilbronn;X;696;0;2;4;12;31;49;101;51;152;32;233;14;30;44;87;117;87;55;73;463
326*00;Einfacher Ladendiebstahl;5916000;Herne;M;452;0;2;8;11;30;51;23;11;34;32;117;24;21;45;63;93;52;47;35;335
326*00;Einfacher Ladendiebstahl;5916000;Herne;W;247;1;1;0;5;19;26;24;16;40;14;80;14;12;26;18;33;35;22;33;167
326*00;Einfacher Ladendiebstahl;5916000;Herne;X;699;1;3;8;16;49;77;47;27;74;46;197;38;33;71;81;126;87;69;68;502
326*00;Einfacher Ladendiebstahl;9161000;Ingolstadt;M;285;0;0;2;8;14;24;21;17;38;14;76;11;12;23;32;56;40;30;28;209
326*00;Einfacher Ladendiebstahl;9161000;Ingolstadt;W;260;0;0;0;1;13;14;48;20;68;11;93;11;12;23;17;23;36;30;38;167
326*00;Einfacher Ladendiebstahl;9161000;Ingolstadt;X;545;0;0;2;9;27;38;69;37;106;25;169;22;24;46;49;79;76;60;66;376
326*00;Einfacher Ladendiebstahl;16053000;Jena;M;251;0;0;4;8;4;16;7;9;16;19;51;12;18;30;33;58;34;15;30;200
326*00;Einfacher Ladendiebstahl;16053000;Jena;W;158;0;1;1;2;11;15;8;5;13;14;42;6;10;16;15;22;13;16;34;116
326*00;Einfacher Ladendiebstahl;16053000;Jena;X;409;0;1;5;10;15;31;15;14;29;33;93;18;28;46;48;80;47;31;64;316
326*00;Einfacher Ladendiebstahl;8212000;Karlsruhe;M;1404;0;0;7;9;40;56;56;108;164;134;354;99;106;205;243;280;140;85;97;1050
326*00;Einfacher Ladendiebstahl;8212000;Karlsruhe;W;698;1;0;7;9;28;45;93;78;171;59;275;29;30;59;50;95;84;53;82;423
326*00;Einfacher Ladendiebstahl;8212000;Karlsruhe;X;2102;1;0;14;18;68;101;149;186;335;193;629;128;136;264;293;375;224;138;179;1473
326*00;Einfacher Ladendiebstahl;6611000;Kassel;M;769;0;2;3;7;12;24;36;33;69;58;151;34;26;60;85;169;110;95;99;618
326*00;Einfacher Ladendiebstahl;6611000;Kassel;W;469;0;0;0;5;21;26;64;48;112;33;171;12;19;31;38;76;58;38;57;298
326*00;Einfacher Ladendiebstahl;6611000;Kassel;X;1238;0;2;3;12;33;50;100;81;181;91;322;46;45;91;123;245;168;133;156;916
326*00;Einfacher Ladendiebstahl;1002000;Kiel;M;683;0;6;12;14;21;53;33;19;52;25;130;21;26;47;80;163;124;84;55;553
326*00;Einfacher Ladendiebstahl;1002000;Kiel;W;414;1;0;4;8;19;32;46;40;86;37;155;20;13;33;29;64;41;32;60;259
326*00;Einfacher Ladendiebstahl;1002000;Kiel;X;1097;1;6;16;22;40;85;79;59;138;62;285;41;39;80;109;227;165;116;115;812
326*00;Einfacher Ladendiebstahl;7111000;Koblenz;M;291;0;0;0;7;7;14;20;9;29;24;67;16;12;28;41;70;35;36;14;224
326*00;Einfacher Ladendiebstahl;7111000;Koblenz;W;250;0;0;0;9;16;25;32;23;55;15;95;12;6;18;23;36;36;22;20;155
326*00;Einfacher Ladendiebstahl;7111000;Koblenz;X;541;0;0;0;16;23;39;52;32;84;39;162;28;18;46;64;106;71;58;34;379
326*00;Einfacher Ladendiebstahl;5315000;Köln;M;3539;3;6;25;38;126;198;210;241;451;271;920;149;169;318;415;745;533;317;291;2619
326*00;Einfacher Ladendiebstahl;5315000;Köln;W;2016;1;6;17;39;129;192;286;212;498;127;817;65;76;141;176;255;199;184;244;1199
326*00;Einfacher Ladendiebstahl;5315000;Köln;X;5555;4;12;42;77;255;390;496;453;949;398;1737;214;245;459;591;1000;732;501;535;3818
326*00;Einfacher Ladendiebstahl;5114000;Krefeld;M;591;0;2;4;7;22;35;39;19;58;49;142;19;32;51;86;148;89;28;47;449
326*00;Einfacher Ladendiebstahl;5114000;Krefeld;W;383;0;0;2;9;29;40;51;40;91;24;155;22;15;37;25;57;32;38;39;228
326*00;Einfacher Ladendiebstahl;5114000;Krefeld;X;974;0;2;6;16;51;75;90;59;149;73;297;41;47;88;111;205;121;66;86;677
326*00;Einfacher Ladendiebstahl;14713000;Leipzig;M;2717;1;5;9;37;59;111;90;86;176;171;458;148;194;342;462;604;334;221;296;2259
326*00;Einfacher Ladendiebstahl;14713000;Leipzig;W;1214;1;2;7;23;55;88;120;61;181;67;336;61;52;113;120;156;93;145;251;878
326*00;Einfacher Ladendiebstahl;14713000;Leipzig;X;3931;2;7;16;60;114;199;210;147;357;238;794;209;246;455;582;760;427;366;547;3137
326*00;Einfacher Ladendiebstahl;5316000;Leverkusen;M;297;0;2;2;8;11;23;11;10;21;15;59;11;18;29;30;51;49;39;40;238
326*00;Einfacher Ladendiebstahl;5316000;Leverkusen;W;180;1;2;2;11;9;25;20;12;32;11;68;6;7;13;13;20;15;21;30;112
326*00;Einfacher Ladendiebstahl;5316000;Leverkusen;X;477;1;4;4;19;20;48;31;22;53;26;127;17;25;42;43;71;64;60;70;350
326*00;Einfacher Ladendiebstahl;1003000;Lübeck;M;848;1;3;12;8;24;48;34;25;59;35;142;42;25;67;93;166;157;93;130;706
326*00;Einfacher Ladendiebstahl;1003000;Lübeck;W;483;0;1;6;11;24;42;55;47;102;38;182;19;22;41;38;58;48;44;72;301
326*00;Einfacher Ladendiebstahl;1003000;Lübeck;X;1331;1;4;18;19;48;90;89;72;161;73;324;61;47;108;131;224;205;137;202;1007
326*00;Einfacher Ladendiebstahl;7314000;Ludwigshafen am Rhein;M;553;0;2;5;9;21;37;30;24;54;38;129;29;27;56;65;102;102;47;52;424
326*00;Einfacher Ladendiebstahl;7314000;Ludwigshafen am Rhein;W;395;0;0;1;7;33;41;46;26;72;36;149;17;15;32;37;45;55;34;43;246
326*00;Einfacher Ladendiebstahl;7314000;Ludwigshafen am Rhein;X;948;0;2;6;16;54;78;76;50;126;74;278;46;42;88;102;147;157;81;95;670
326*00;Einfacher Ladendiebstahl;15003000;Magdeburg;M;1122;0;3;12;20;31;66;55;64;119;100;285;46;59;105;142;191;166;93;140;837
326*00;Einfacher Ladendiebstahl;15003000;Magdeburg;W;621;0;1;5;13;32;51;44;27;71;35;157;21;30;51;52;62;64;71;164;464
326*00;Einfacher Ladendiebstahl;15003000;Magdeburg;X;1743;0;4;17;33;63;117;99;91;190;135;442;67;89;156;194;253;230;164;304;1301
326*00;Einfacher Ladendiebstahl;7315000;Mainz;M;547;0;0;0;7;11;18;35;35;70;43;131;21;22;43;67;113;72;56;65;416
326*00;Einfacher Ladendiebstahl;7315000;Mainz;W;358;0;0;1;7;27;35;62;37;99;30;164;14;15;29;30;35;37;22;41;194
326*00;Einfacher Ladendiebstahl;7315000;Mainz;X;905;0;0;1;14;38;53;97;72;169;73;295;35;37;72;97;148;109;78;106;610
326*00;Einfacher Ladendiebstahl;8222000;Mannheim;M;1032;1;2;4;14;27;48;47;54;101;91;240;55;57;112;138;190;155;108;89;792
326*00;Einfacher Ladendiebstahl;8222000;Mannheim;W;659;1;0;2;15;34;52;87;65;152;60;264;28;30;58;52;90;69;52;74;395
326*00;Einfacher Ladendiebstahl;8222000;Mannheim;X;1691;2;2;6;29;61;100;134;119;253;151;504;83;87;170;190;280;224;160;163;1187
326*00;Einfacher Ladendiebstahl;5170024;Moers;M;174;0;0;3;4;12;19;5;4;9;16;44;11;9;20;19;41;27;10;13;130
326*00;Einfacher Ladendiebstahl;5170024;Moers;W;101;0;0;0;1;6;7;10;6;16;8;31;3;5;8;12;15;12;7;16;70
326*00;Einfacher Ladendiebstahl;5170024;Moers;X;275;0;0;3;5;18;26;15;10;25;24;75;14;14;28;31;56;39;17;29;200
326*00;Einfacher Ladendiebstahl;5116000;Mönchengladbach;M;761;0;1;5;13;27;46;25;38;63;58;167;29;39;68;102;188;114;59;63;594
326*00;Einfacher Ladendiebstahl;5116000;Mönchengladbach;W;491;0;0;3;4;24;31;62;46;108;27;166;19;18;37;53;65;60;44;66;325
326*00;Einfacher Ladendiebstahl;5116000;Mönchengladbach;X;1252;0;1;8;17;51;77;87;84;171;85;333;48;57;105;155;253;174;103;129;919
326*00;Einfacher Ladendiebstahl;5117000;Mülheim an der Ruhr;M;316;0;0;1;6;17;24;25;24;49;18;91;15;16;31;23;63;47;24;37;225
326*00;Einfacher Ladendiebstahl;5117000;Mülheim an der Ruhr;W;187;0;0;0;4;8;12;17;15;32;13;57;2;9;11;12;29;21;20;37;130
326*00;Einfacher Ladendiebstahl;5117000;Mülheim an der Ruhr;X;503;0;0;1;10;25;36;42;39;81;31;148;17;25;42;35;92;68;44;74;355
326*00;Einfacher Ladendiebstahl;9162000;München;M;3438;0;11;19;63;121;214;213;174;387;246;847;136;166;302;324;686;534;324;421;2591
326*00;Einfacher Ladendiebstahl;9162000;München;W;2680;1;3;5;24;173;206;272;239;511;182;899;105;91;196;227;336;302;282;438;1781
326*00;Einfacher Ladendiebstahl;9162000;München;X;6118;1;14;24;87;294;420;485;413;898;428;1746;241;257;498;551;1022;836;606;859;4372
326*00;Einfacher Ladendiebstahl;5515000;Münster;M;822;0;0;4;14;39;57;72;50;122;71;250;47;50;97;103;143;101;64;64;572
326*00;Einfacher Ladendiebstahl;5515000;Münster;W;573;0;0;3;17;44;64;74;66;140;36;240;16;23;39;40;82;56;48;68;333
326*00;Einfacher Ladendiebstahl;5515000;Münster;X;1395;0;0;7;31;83;121;146;116;262;107;490;63;73;136;143;225;157;112;132;905
326*00;Einfacher Ladendiebstahl;5162024;Neuss;M;479;0;0;1;6;13;20;14;26;40;44;104;26;39;65;73;102;59;36;40;375
326*00;Einfacher Ladendiebstahl;5162024;Neuss;W;249;0;0;0;1;16;17;35;20;55;17;89;6;7;13;26;25;26;29;41;160
326*00;Einfacher Ladendiebstahl;5162024;Neuss;X;728;0;0;1;7;29;37;49;46;95;61;193;32;46;78;99;127;85;65;81;535
326*00;Einfacher Ladendiebstahl;9564000;Nürnberg;M;2330;0;3;9;36;68;116;104;100;204;153;473;123;112;235;388;534;318;190;192;1857
326*00;Einfacher Ladendiebstahl;9564000;Nürnberg;W;1295;0;3;8;16;75;102;149;85;234;87;423;52;64;116;101;176;172;135;172;872
326*00;Einfacher Ladendiebstahl;9564000;Nürnberg;X;3625;0;6;17;52;143;218;253;185;438;240;896;175;176;351;489;710;490;325;364;2729
326*00;Einfacher Ladendiebstahl;5119000;Oberhausen;M;605;0;3;3;7;28;41;40;37;77;57;175;20;31;51;77;127;81;46;48;430
326*00;Einfacher Ladendiebstahl;5119000;Oberhausen;W;489;0;0;3;7;35;45;84;67;151;46;242;25;17;42;33;57;42;26;47;247
326*00;Einfacher Ladendiebstahl;5119000;Oberhausen;X;1094;0;3;6;14;63;86;124;104;228;103;417;45;48;93;110;184;123;72;95;677
326*00;Einfacher Ladendiebstahl;6413000;Offenbach am Main;M;473;0;0;5;11;23;39;20;16;36;46;121;29;17;46;65;99;66;38;38;352
326*00;Einfacher Ladendiebstahl;6413000;Offenbach am Main;W;291;0;0;0;2;13;15;27;29;56;26;97;19;8;27;38;42;36;27;24;194
326*00;Einfacher Ladendiebstahl;6413000;Offenbach am Main;X;764;0;0;5;13;36;54;47;45;92;72;218;48;25;73;103;141;102;65;62;546
326*00;Einfacher Ladendiebstahl;3403000;Oldenburg (Oldenburg);M;303;0;0;2;7;18;27;26;21;47;18;92;20;14;34;29;61;27;29;31;211
326*00;Einfacher Ladendiebstahl;3403000;Oldenburg (Oldenburg);W;233;1;1;2;1;12;17;30;31;61;15;93;13;9;22;14;29;26;26;23;140
326*00;Einfacher Ladendiebstahl;3403000;Oldenburg (Oldenburg);X;536;1;1;4;8;30;44;56;52;108;33;185;33;23;56;43;90;53;55;54;351
326*00;Einfacher Ladendiebstahl;3404000;Osnabrück;M;639;0;0;1;7;20;28;31;26;57;53;138;22;43;65;91;144;91;55;55;501
326*00;Einfacher Ladendiebstahl;3404000;Osnabrück;W;368;0;0;0;3;14;17;40;24;64;31;112;15;13;28;33;54;44;42;55;256
326*00;Einfacher Ladendiebstahl;3404000;Osnabrück;X;1007;0;0;1;10;34;45;71;50;121;84;250;37;56;93;124;198;135;97;110;757
326*00;Einfacher Ladendiebstahl;5774032;Paderborn;M;483;1;2;4;4;18;29;28;26;54;42;125;17;24;41;55;121;59;48;34;358
326*00;Einfacher Ladendiebstahl;5774032;Paderborn;W;202;0;0;0;5;12;17;18;21;39;15;71;7;4;11;13;26;28;22;31;131
326*00;Einfacher Ladendiebstahl;5774032;Paderborn;X;685;1;2;4;9;30;46;46;47;93;57;196;24;28;52;68;147;87;70;65;489
326*00;Einfacher Ladendiebstahl;8231000;Pforzheim;M;547;0;1;3;15;27;46;43;26;69;23;138;27;30;57;69;111;80;46;46;409
326*00;Einfacher Ladendiebstahl;8231000;Pforzheim;W;363;0;1;2;2;29;34;38;24;62;28;124;16;15;31;37;44;41;37;49;239
326*00;Einfacher Ladendiebstahl;8231000;Pforzheim;X;910;0;2;5;17;56;80;81;50;131;51;262;43;45;88;106;155;121;83;95;648
326*00;Einfacher Ladendiebstahl;12054000;Potsdam;M;595;0;2;2;7;21;32;47;23;70;43;145;28;29;57;72;112;84;57;68;450
326*00;Einfacher Ladendiebstahl;12054000;Potsdam;W;308;0;0;3;3;19;25;31;19;50;20;95;24;12;36;27;32;20;42;56;213
326*00;Einfacher Ladendiebstahl;12054000;Potsdam;X;903;0;2;5;10;40;57;78;42;120;63;240;52;41;93;99;144;104;99;124;663
326*00;Einfacher Ladendiebstahl;5562032;Recklinghausen;M;351;0;1;5;7;15;28;29;21;50;29;107;15;16;31;45;68;41;24;35;244
326*00;Einfacher Ladendiebstahl;5562032;Recklinghausen;W;165;0;0;0;4;4;8;9;6;15;9;32;9;9;18;18;26;22;23;26;133
326*00;Einfacher Ladendiebstahl;5562032;Recklinghausen;X;516;0;1;5;11;19;36;38;27;65;38;139;24;25;49;63;94;63;47;61;377
326*00;Einfacher Ladendiebstahl;9362000;Regensburg;M;699;0;1;2;13;33;49;36;42;78;43;170;40;34;74;86;157;103;53;56;529
326*00;Einfacher Ladendiebstahl;9362000;Regensburg;W;411;0;0;0;7;21;28;49;34;83;40;151;15;9;24;42;69;36;31;58;260
326*00;Einfacher Ladendiebstahl;9362000;Regensburg;X;1110;0;1;2;20;54;77;85;76;161;83;321;55;43;98;128;226;139;84;114;789
326*00;Einfacher Ladendiebstahl;5120000;Remscheid;M;340;0;1;3;2;16;22;31;22;53;25;100;10;10;20;31;66;36;45;42;240
326*00;Einfacher Ladendiebstahl;5120000;Remscheid;W;185;0;0;0;4;13;17;11;14;25;8;50;3;5;8;17;33;30;19;28;135
326*00;Einfacher Ladendiebstahl;5120000;Remscheid;X;525;0;1;3;6;29;39;42;36;78;33;150;13;15;28;48;99;66;64;70;375
326*00;Einfacher Ladendiebstahl;8415061;Reutlingen;M;238;0;1;0;6;23;30;26;10;36;16;82;10;7;17;28;49;24;24;14;156
326*00;Einfacher Ladendiebstahl;8415061;Reutlingen;W;195;0;0;1;3;13;17;30;25;55;26;98;3;2;5;19;27;15;15;16;97
326*00;Einfacher Ladendiebstahl;8415061;Reutlingen;X;433;0;1;1;9;36;47;56;35;91;42;180;13;9;22;47;76;39;39;30;253
326*00;Einfacher Ladendiebstahl;13003000;Rostock;M;592;0;14;23;20;29;86;19;28;47;37;170;25;26;51;72;100;59;54;86;422
326*00;Einfacher Ladendiebstahl;13003000;Rostock;W;378;2;1;7;19;31;60;45;19;64;19;143;7;9;16;21;22;33;49;94;235
326*00;Einfacher Ladendiebstahl;13003000;Rostock;X;970;2;15;30;39;60;146;64;47;111;56;313;32;35;67;93;122;92;103;180;657
326*00;Einfacher Ladendiebstahl;10041100;Saarbrücken;M;843;1;2;7;12;33;55;57;59;116;84;255;36;41;77;107;159;111;71;63;588
326*00;Einfacher Ladendiebstahl;10041100;Saarbrücken;W;885;2;1;6;13;67;89;139;100;239;98;426;39;24;63;67;105;65;61;98;459
326*00;Einfacher Ladendiebstahl;10041100;Saarbrücken;X;1728;3;3;13;25;100;144;196;159;355;182;681;75;65;140;174;264;176;132;161;1047
326*00;Einfacher Ladendiebstahl;5122000;Solingen;M;425;0;1;3;10;16;30;16;20;36;25;91;12;12;24;36;91;53;51;79;334
326*00;Einfacher Ladendiebstahl;5122000;Solingen;W;227;0;0;1;3;24;28;18;17;35;8;71;2;11;13;24;34;31;24;30;156
326*00;Einfacher Ladendiebstahl;5122000;Solingen;X;652;0;1;4;13;40;58;34;37;71;33;162;14;23;37;60;125;84;75;109;490
326*00;Einfacher Ladendiebstahl;8111000;Stuttgart;M;1879;0;8;10;37;62;117;111;114;225;159;501;67;92;159;210;382;251;183;193;1378
326*00;Einfacher Ladendiebstahl;8111000;Stuttgart;W;1140;0;2;3;18;68;91;178;117;295;78;464;40;30;70;88;166;113;95;144;676
326*00;Einfacher Ladendiebstahl;8111000;Stuttgart;X;3019;0;10;13;55;130;208;289;231;520;237;965;107;122;229;298;548;364;278;337;2054
326*00;Einfacher Ladendiebstahl;7211000;Trier;M;462;0;0;5;16;14;35;23;29;52;39;126;28;37;65;69;100;54;31;17;336
326*00;Einfacher Ladendiebstahl;7211000;Trier;W;245;0;0;0;5;19;24;36;20;56;14;94;15;12;27;26;30;21;23;24;151
326*00;Einfacher Ladendiebstahl;7211000;Trier;X;707;0;0;5;21;33;59;59;49;108;53;220;43;49;92;95;130;75;54;41;487
326*00;Einfacher Ladendiebstahl;8421000;Ulm;M;442;1;0;4;11;29;45;25;37;62;27;134;34;15;49;49;100;51;28;31;308
326*00;Einfacher Ladendiebstahl;8421000;Ulm;W;343;0;0;0;5;26;31;67;39;106;28;165;20;13;33;25;41;23;21;35;178
326*00;Einfacher Ladendiebstahl;8421000;Ulm;X;785;1;0;4;16;55;76;92;76;168;55;299;54;28;82;74;141;74;49;66;486
326*00;Einfacher Ladendiebstahl;6414000;Wiesbaden;M;719;0;2;5;9;15;31;53;40;93;42;166;32;27;59;63;158;106;70;97;553
326*00;Einfacher Ladendiebstahl;6414000;Wiesbaden;W;522;0;1;2;6;27;36;45;38;83;27;146;16;19;35;42;85;66;50;98;376
326*00;Einfacher Ladendiebstahl;6414000;Wiesbaden;X;1241;0;3;7;15;42;67;98;78;176;69;312;48;46;94;105;243;172;120;195;929
326*00;Einfacher Ladendiebstahl;3103000;Wolfsburg;M;206;1;0;1;6;15;23;8;14;22;6;51;6;5;11;28;40;25;18;33;155
326*00;Einfacher Ladendiebstahl;3103000;Wolfsburg;W;166;0;1;0;4;21;26;14;10;24;4;54;3;6;9;13;25;11;17;37;112
326*00;Einfacher Ladendiebstahl;3103000;Wolfsburg;X;372;1;1;1;10;36;49;22;24;46;10;105;9;11;20;41;65;36;35;70;267
326*00;Einfacher Ladendiebstahl;5124000;Wuppertal;M;1349;1;4;15;40;44;104;81;51;132;65;301;47;63;110;144;309;204;145;136;1048
326*00;Einfacher Ladendiebstahl;5124000;Wuppertal;W;620;1;4;7;15;41;68;68;57;125;38;231;27;25;52;54;92;57;57;77;389
326*00;Einfacher Ladendiebstahl;5124000;Wuppertal;X;1969;2;8;22;55;85;172;149;108;257;103;532;74;88;162;198;401;261;202;213;1437
326*00;Einfacher Ladendiebstahl;9663000;Würzburg;M;420;0;1;8;11;30;50;24;16;40;21;111;20;12;32;56;67;50;47;57;309
326*00;Einfacher Ladendiebstahl;9663000;Würzburg;W;266;0;0;1;2;28;31;43;18;61;19;111;10;7;17;14;19;22;32;51;155
326*00;Einfacher Ladendiebstahl;9663000;Würzburg;X;686;0;1;9;13;58;81;67;34;101;40;222;30;19;49;70;86;72;79;108;464
4***00;Diebstahl unter erschwerenden Umständen §§ 243-244a StGB und zwar:;5334002;Aachen;M;407;0;0;0;1;4;5;30;47;77;52;134;19;28;47;54;107;44;14;7;273
4***00;Diebstahl unter erschwerenden Umständen §§ 243-244a StGB und zwar:;5334002;Aachen;W;47;0;0;0;0;1;1;5;4;9;10;20;2;3;5;5;9;7;1;0;27
4***00;Diebstahl unter erschwerenden Umständen §§ 243-244a StGB und zwar:;5334002;Aachen;X;454;0;0;0;1;5;6;35;51;86;62;154;21;31;52;59;116;51;15;7;300
4***00;Diebstahl unter erschwerenden Umständen §§ 243-244a StGB und zwar:;9761000;Augsburg;M;307;0;0;0;2;8;10;18;28;46;34;90;21;17;38;63;67;23;18;8;217
4***00;Diebstahl unter erschwerenden Umständen §§ 243-244a StGB und zwar:;9761000;Augsburg;W;38;0;0;0;1;1;2;1;0;1;3;6;2;3;5;6;12;3;5;1;32
4***00;Diebstahl unter erschwerenden Umständen §§ 243-244a StGB und zwar:;9761000;Augsburg;X;345;0;0;0;3;9;12;19;28;47;37;96;23;20;43;69;79;26;23;9;249
4***00;Diebstahl unter erschwerenden Umständen §§ 243-244a StGB und zwar:;5378004;Bergisch Gladbach;M;132;0;0;0;0;0;0;5;6;11;24;35;5;7;12;29;35;12;6;3;97
4***00;Diebstahl unter erschwerenden Umständen §§ 243-244a StGB und zwar:;5378004;Bergisch Gladbach;W;21;0;0;0;0;0;0;0;3;3;5;8;3;3;6;3;2;0;2;0;13
4***00;Diebstahl unter erschwerenden Umständen §§ 243-244a StGB und zwar:;5378004;Bergisch Gladbach;X;153;0;0;0;0;0;0;5;9;14;29;43;8;10;18;32;37;12;8;3;110
4***00;Diebstahl unter erschwerenden Umständen §§ 243-244a StGB und zwar:;11000000;Berlin;M;5004;0;1;7;19;75;102;254;368;622;632;1356;400;351;751;813;1258;544;209;73;3648
4***00;Diebstahl unter erschwerenden Umständen §§ 243-244a StGB und zwar:;11000000;Berlin;W;525;0;1;2;6;15;24;55;32;87;63;174;24;36;60;69;111;59;35;17;351
4***00;Diebstahl unter erschwerenden Umständen §§ 243-244a StGB und zwar:;11000000;Berlin;X;5529;0;2;9;25;90;126;309;400;709;695;1530;424;387;811;882;1369;603;244;90;3999
4***00;Diebstahl unter erschwerenden Umständen §§ 243-244a StGB und zwar:;5711000;Bielefeld;M;404;0;0;0;0;1;1;21;40;61;50;112;31;44;75;57;99;41;12;8;292
4***00;Diebstahl unter erschwerenden Umständen §§ 243-244a StGB und zwar:;5711000;Bielefeld;W;46;0;0;0;0;1;1;4;3;7;10;18;2;3;5;6;7;9;1;0;28
4***00;Diebstahl unter erschwerenden Umständen §§ 243-244a StGB und zwar:;5711000;Bielefeld;X;450;0;0;0;0;2;2;25;43;68;60;130;33;47;80;63;106;50;13;8;320
4***00;Diebstahl unter erschwerenden Umständen §§ 243-244a StGB und zwar:;5911000;Bochum;M;528;0;0;0;2;3;5;16;43;59;73;137;56;38;94;90;152;28;23;4;391
4***00;Diebstahl unter erschwerenden Umständen §§ 243-244a StGB und zwar:;5911000;Bochum;W;106;0;0;0;1;3;4;9;12;21;13;38;2;8;10;19;23;6;7;3;68
4***00;Diebstahl unter erschwerenden Umständen §§ 243-244a StGB und zwar:;5911000;Bochum;X;634;0;0;0;3;6;9;25;55;80;86;175;58;46;104;109;175;34;30;7;459
4***00;Diebstahl unter erschwerenden Umständen §§ 243-244a StGB und zwar:;5314000;Bonn;M;576;0;1;1;8;21;31;33;42;75;67;173;45;39;84;68;153;67;25;6;403
4***00;Diebstahl unter erschwerenden Umständen §§ 243-244a StGB und zwar:;5314000;Bonn;W;110;0;0;0;2;4;6;11;12;23;16;45;3;5;8;17;20;13;5;2;65
4***00;Diebstahl unter erschwerenden Umständen §§ 243-244a StGB und zwar:;5314000;Bonn;X;686;0;1;1;10;25;37;44;54;98;83;218;48;44;92;85;173;80;30;8;468
4***00;Diebstahl unter erschwerenden Umständen §§ 243-244a StGB und zwar:;5512000;Bottrop;M;126;0;0;0;1;1;2;4;4;8;17;27;13;7;20;22;37;15;4;1;99
4***00;Diebstahl unter erschwerenden Umständen §§ 243-244a StGB und zwar:;5512000;Bottrop;W;20;0;0;0;0;0;0;1;3;4;3;7;0;4;4;1;2;5;0;1;13
4***00;Diebstahl unter erschwerenden Umständen §§ 243-244a StGB und zwar:;5512000;Bottrop;X;146;0;0;0;1;1;2;5;7;12;20;34;13;11;24;23;39;20;4;2;112
4***00;Diebstahl unter erschwerenden Umständen §§ 243-244a StGB und zwar:;3101000;Braunschweig;M;483;0;0;0;0;2;2;11;15;26;57;85;39;38;77;97;134;51;25;14;398
4***00;Diebstahl unter erschwerenden Umständen §§ 243-244a StGB und zwar:;3101000;Braunschweig;W;57;0;0;0;0;1;1;1;3;4;7;12;4;5;9;9;16;8;1;2;45
4***00;Diebstahl unter erschwerenden Umständen §§ 243-244a StGB und zwar:;3101000;Braunschweig;X;540;0;0;0;0;3;3;12;18;30;64;97;43;43;86;106;150;59;26;16;443
4***00;Diebstahl unter erschwerenden Umständen §§ 243-244a StGB und zwar:;4011000;Bremen;M;1083;0;1;0;6;17;24;53;116;169;155;348;76;66;142;179;236;114;49;15;735
4***00;Diebstahl unter erschwerenden Umständen §§ 243-244a StGB und zwar:;4011000;Bremen;W;149;1;0;0;0;2;3;7;14;21;19;43;8;14;22;23;27;17;15;2;106
4***00;Diebstahl unter erschwerenden Umständen §§ 243-244a StGB und zwar:;4011000;Bremen;X;1232;1;1;0;6;19;27;60;130;190;174;391;84;80;164;202;263;131;64;17;841
4***00;Diebstahl unter erschwerenden Umständen §§ 243-244a StGB und zwar:;4012000;Bremerhaven;M;233;0;1;3;1;5;10;7;19;26;32;68;27;19;46;51;42;19;4;3;165
4***00;Diebstahl unter erschwerenden Umständen §§ 243-244a StGB und zwar:;4012000;Bremerhaven;W;18;0;1;0;0;0;1;1;2;3;1;5;2;2;4;2;2;2;2;1;13
4***00;Diebstahl unter erschwerenden Umständen §§ 243-244a StGB und zwar:;4012000;Bremerhaven;X;251;0;2;3;1;5;11;8;21;29;33;73;29;21;50;53;44;21;6;4;178
4***00;Diebstahl unter erschwerenden Umständen §§ 243-244a StGB und zwar:;14511000;Chemnitz;M;565;0;0;0;0;5;5;15;12;27;52;84;43;48;91;137;169;55;21;8;481
4***00;Diebstahl unter erschwerenden Umständen §§ 243-244a StGB und zwar:;14511000;Chemnitz;W;71;0;0;0;0;0;0;6;7;13;10;23;3;6;9;13;10;6;8;2;48
4***00;Diebstahl unter erschwerenden Umständen §§ 243-244a StGB und zwar:;14511000;Chemnitz;X;636;0;0;0;0;5;5;21;19;40;62;107;46;54;100;150;179;61;29;10;529
4***00;Diebstahl unter erschwerenden Umständen §§ 243-244a StGB und zwar:;6411000;Darmstadt;M;283;0;0;3;1;2;6;25;32;57;48;111;20;15;35;25;65;33;12;2;172
4***00;Diebstahl unter erschwerenden Umständen §§ 243-244a StGB und zwar:;6411000;Darmstadt;W;33;0;0;0;0;1;1;4;3;7;6;14;0;4;4;6;5;2;1;1;19
4***00;Diebstahl unter erschwerenden Umständen §§ 243-244a StGB und zwar:;6411000;Darmstadt;X;316;0;0;3;1;3;7;29;35;64;54;125;20;19;39;31;70;35;13;3;191
4***00;Diebstahl unter erschwerenden Umständen §§ 243-244a StGB und zwar:;5913000;Dortmund;M;1292;0;0;0;10;26;36;57;120;177;199;412;108;96;204;196;300;122;43;15;880
4***00;Diebstahl unter erschwerenden Umständen §§ 243-244a StGB und zwar:;5913000;Dortmund;W;265;0;0;4;3;12;19;28;34;62;29;110;18;20;38;35;46;24;10;2;155
4***00;Diebstahl unter erschwerenden Umständen §§ 243-244a StGB und zwar:;5913000;Dortmund;X;1557;0;0;4;13;38;55;85;154;239;228;522;126;116;242;231;346;146;53;17;1035
4***00;Diebstahl unter erschwerenden Umständen §§ 243-244a StGB und zwar:;14612000;Dresden;M;1134;0;0;0;0;6;6;15;32;47;77;130;71;107;178;277;393;114;31;11;1004
4***00;Diebstahl unter erschwerenden Umständen §§ 243-244a StGB und zwar:;14612000;Dresden;W;186;0;0;0;0;6;6;6;5;11;13;30;10;23;33;50;41;14;14;4;156
4***00;Diebstahl unter erschwerenden Umständen §§ 243-244a StGB und zwar:;14612000;Dresden;X;1320;0;0;0;0;12;12;21;37;58;90;160;81;130;211;327;434;128;45;15;1160
4***00;Diebstahl unter erschwerenden Umständen §§ 243-244a StGB und zwar:;5112000;Duisburg;M;750;0;0;3;12;20;35;57;52;109;86;230;61;52;113;108;160;96;34;9;520
4***00;Diebstahl unter erschwerenden Umständen §§ 243-244a StGB und zwar:;5112000;Duisburg;W;134;0;0;0;3;9;12;13;10;23;17;52;10;4;14;17;29;13;4;5;82
4***00;Diebstahl unter erschwerenden Umständen §§ 243-244a StGB und zwar:;5112000;Duisburg;X;884;0;0;3;15;29;47;70;62;132;103;282;71;56;127;125;189;109;38;14;602
4***00;Diebstahl unter erschwerenden Umständen §§ 243-244a StGB und zwar:;5111000;Düsseldorf;M;1222;0;0;1;5;15;21;59;76;135;139;295;104;89;193;226;280;154;53;21;927
4***00;Diebstahl unter erschwerenden Umständen §§ 243-244a StGB und zwar:;5111000;Düsseldorf;W;198;0;0;0;0;5;5;22;20;42;35;82;13;14;27;25;38;19;6;1;116
4***00;Diebstahl unter erschwerenden Umständen §§ 243-244a StGB und zwar:;5111000;Düsseldorf;X;1420;0;0;1;5;20;26;81;96;177;174;377;117;103;220;251;318;173;59;22;1043
4***00;Diebstahl unter erschwerenden Umständen §§ 243-244a StGB und zwar:;16051000;Erfurt;M;261;0;0;0;2;3;5;7;23;30;17;52;19;19;38;47;84;25;11;4;209
4***00;Diebstahl unter erschwerenden Umständen §§ 243-244a StGB und zwar:;16051000;Erfurt;W;39;0;0;0;0;3;3;8;5;13;0;16;4;1;5;5;8;2;2;1;23
4***00;Diebstahl unter erschwerenden Umständen §§ 243-244a StGB und zwar:;16051000;Erfurt;X;300;0;0;0;2;6;8;15;28;43;17;68;23;20;43;52;92;27;13;5;232
4***00;Diebstahl unter erschwerenden Umständen §§ 243-244a StGB und zwar:;9562000;Erlangen;M;160;0;1;0;1;1;3;12;12;24;22;49;10;15;25;24;33;20;4;5;111
4***00;Diebstahl unter erschwerenden Umständen §§ 243-244a StGB und zwar:;9562000;Erlangen;W;14;0;0;1;1;3;5;0;1;1;0;6;1;0;1;1;2;3;1;0;8
4***00;Diebstahl unter erschwerenden Umständen §§ 243-244a StGB und zwar:;9562000;Erlangen;X;174;0;1;1;2;4;8;12;13;25;22;55;11;15;26;25;35;23;5;5;119
4***00;Diebstahl unter erschwerenden Umständen §§ 243-244a StGB und zwar:;5113000;Essen;M;900;0;0;1;4;26;31;51;70;121;106;258;87;78;165;126;197;110;32;12;642
4***00;Diebstahl unter erschwerenden Umständen §§ 243-244a StGB und zwar:;5113000;Essen;W;175;0;0;0;2;14;16;14;22;36;20;72;15;11;26;24;29;18;4;2;103
4***00;Diebstahl unter erschwerenden Umständen §§ 243-244a StGB und zwar:;5113000;Essen;X;1075;0;0;1;6;40;47;65;92;157;126;330;102;89;191;150;226;128;36;14;745
4***00;Diebstahl unter erschwerenden Umständen §§ 243-244a StGB und zwar:;6412000;Frankfurt am Main;M;1168;0;0;0;2;10;12;42;77;119;185;316;80;81;161;188;292;146;45;20;852
4***00;Diebstahl unter erschwerenden Umständen §§ 243-244a StGB und zwar:;6412000;Frankfurt am Main;W;116;0;0;0;0;2;2;14;14;28;17;47;4;6;10;14;28;11;5;1;69
4***00;Diebstahl unter erschwerenden Umständen §§ 243-244a StGB und zwar:;6412000;Frankfurt am Main;X;1284;0;0;0;2;12;14;56;91;147;202;363;84;87;171;202;320;157;50;21;921
4***00;Diebstahl unter erschwerenden Umständen §§ 243-244a StGB und zwar:;8311000;Freiburg im Breisgau;M;369;0;2;2;1;3;8;21;51;72;73;153;26;33;59;51;57;34;11;4;216
4***00;Diebstahl unter erschwerenden Umständen §§ 243-244a StGB und zwar:;8311000;Freiburg im Breisgau;W;30;0;0;0;0;0;0;5;4;9;1;10;3;1;4;6;4;6;0;0;20
4***00;Diebstahl unter erschwerenden Umständen §§ 243-244a StGB und zwar:;8311000;Freiburg im Breisgau;X;399;0;2;2;1;3;8;26;55;81;74;163;29;34;63;57;61;40;11;4;236
4***00;Diebstahl unter erschwerenden Umständen §§ 243-244a StGB und zwar:;9563000;Fürth;M;140;0;0;0;1;2;3;2;5;7;20;30;6;10;16;30;41;17;6;0;110
4***00;Diebstahl unter erschwerenden Umständen §§ 243-244a StGB und zwar:;9563000;Fürth;W;23;0;0;0;0;0;0;0;3;3;2;5;2;2;4;4;6;3;1;0;18
4***00;Diebstahl unter erschwerenden Umständen §§ 243-244a StGB und zwar:;9563000;Fürth;X;163;0;0;0;1;2;3;2;8;10;22;35;8;12;20;34;47;20;7;0;128
4***00;Diebstahl unter erschwerenden Umständen §§ 243-244a StGB und zwar:;5513000;Gelsenkirchen;M;497;0;0;1;2;9;12;16;31;47;60;119;42;39;81;84;120;64;19;10;378
4***00;Diebstahl unter erschwerenden Umständen §§ 243-244a StGB und zwar:;5513000;Gelsenkirchen;W;136;0;2;1;3;3;9;7;6;13;22;44;8;15;23;20;30;14;2;3;92
4***00;Diebstahl unter erschwerenden Umständen §§ 243-244a StGB und zwar:;5513000;Gelsenkirchen;X;633;0;2;2;5;12;21;23;37;60;82;163;50;54;104;104;150;78;21;13;470
4***00;Diebstahl unter erschwerenden Umständen §§ 243-244a StGB und zwar:;3152012;Göttingen;M;260;0;0;2;1;4;7;8;19;27;26;60;24;19;43;49;72;26;6;4;200
4***00;Diebstahl unter erschwerenden Umständen §§ 243-244a StGB und zwar:;3152012;Göttingen;W;48;0;0;0;1;1;2;2;1;3;4;9;5;7;12;10;11;4;2;0;39
4***00;Diebstahl unter erschwerenden Umständen §§ 243-244a StGB und zwar:;3152012;Göttingen;X;308;0;0;2;2;5;9;10;20;30;30;69;29;26;55;59;83;30;8;4;239
4***00;Diebstahl unter erschwerenden Umständen §§ 243-244a StGB und zwar:;5914000;Hagen;M;411;0;0;0;1;6;7;13;22;35;56;98;29;33;62;75;103;52;14;7;313
4***00;Diebstahl unter erschwerenden Umständen §§ 243-244a StGB und zwar:;5914000;Hagen;W;66;0;0;0;0;3;3;2;3;5;7;15;7;10;17;13;13;4;2;2;51
4***00;Diebstahl unter erschwerenden Umständen §§ 243-244a StGB und zwar:;5914000;Hagen;X;477;0;0;0;1;9;10;15;25;40;63;113;36;43;79;88;116;56;16;9;364
4***00;Diebstahl unter erschwerenden Umständen §§ 243-244a StGB und zwar:;15002000;Halle (Saale);M;419;0;3;1;2;11;17;17;33;50;32;99;26;27;53;91;120;30;19;7;320
4***00;Diebstahl unter erschwerenden Umständen §§ 243-244a StGB und zwar:;15002000;Halle (Saale);W;51;0;0;0;2;0;2;5;5;10;3;15;3;6;9;11;6;3;2;5;36
4***00;Diebstahl unter erschwerenden Umständen §§ 243-244a StGB und zwar:;15002000;Halle (Saale);X;470;0;3;1;4;11;19;22;38;60;35;114;29;33;62;102;126;33;21;12;356
4***00;Diebstahl unter erschwerenden Umständen §§ 243-244a StGB und zwar:;2000000;Hamburg;M;2853;0;1;3;11;42;57;154;285;439;394;890;190;191;381;428;657;344;116;37;1963
4***00;Diebstahl unter erschwerenden Umständen §§ 243-244a StGB und zwar:;2000000;Hamburg;W;357;0;0;0;3;17;20;26;34;60;36;116;19;27;46;43;75;54;17;6;241
4***00;Diebstahl unter erschwerenden Umständen §§ 243-244a StGB und zwar:;2000000;Hamburg;X;3210;0;1;3;14;59;77;180;319;499;430;1006;209;218;427;471;732;398;133;43;2204
4***00;Diebstahl unter erschwerenden Umständen §§ 243-244a StGB und zwar:;5915000;Hamm;M;269;0;0;0;2;2;4;23;17;40;31;75;17;20;37;44;68;39;6;0;194
4***00;Diebstahl unter erschwerenden Umständen §§ 243-244a StGB und zwar:;5915000;Hamm;W;52;0;0;0;0;3;3;5;5;10;4;17;4;5;9;11;10;5;0;0;35
4***00;Diebstahl unter erschwerenden Umständen §§ 243-244a StGB und zwar:;5915000;Hamm;X;321;0;0;0;2;5;7;28;22;50;35;92;21;25;46;55;78;44;6;0;229
4***00;Diebstahl unter erschwerenden Umständen §§ 243-244a StGB und zwar:;3241001;Hannover;M;1284;0;1;4;3;13;21;48;68;116;152;289;105;95;200;214;321;175;64;21;995
4***00;Diebstahl unter erschwerenden Umständen §§ 243-244a StGB und zwar:;3241001;Hannover;W;257;1;1;1;2;8;13;22;20;42;22;77;16;17;33;32;68;33;9;5;180
4***00;Diebstahl unter erschwerenden Umständen §§ 243-244a StGB und zwar:;3241001;Hannover;X;1541;1;2;5;5;21;34;70;88;158;174;366;121;112;233;246;389;208;73;26;1175
4***00;Diebstahl unter erschwerenden Umständen §§ 243-244a StGB und zwar:;8221000;Heidelberg;M;173;0;0;1;0;4;5;11;16;27;26;58;11;10;21;33;38;20;2;1;115
4***00;Diebstahl unter erschwerenden Umständen §§ 243-244a StGB und zwar:;8221000;Heidelberg;W;46;0;0;0;1;0;1;9;2;11;9;21;3;4;7;6;4;5;3;0;25
4***00;Diebstahl unter erschwerenden Umständen §§ 243-244a StGB und zwar:;8221000;Heidelberg;X;219;0;0;1;1;4;6;20;18;38;35;79;14;14;28;39;42;25;5;1;140
4***00;Diebstahl unter erschwerenden Umständen §§ 243-244a StGB und zwar:;8121000;Heilbronn;M;123;1;0;0;1;2;4;4;4;8;12;24;9;14;23;24;34;11;5;2;99
4***00;Diebstahl unter erschwerenden Umständen §§ 243-244a StGB und zwar:;8121000;Heilbronn;W;11;0;0;0;0;0;0;0;0;0;2;2;4;2;6;1;2;0;0;0;9
4***00;Diebstahl unter erschwerenden Umständen §§ 243-244a StGB und zwar:;8121000;Heilbronn;X;134;1;0;0;1;2;4;4;4;8;14;26;13;16;29;25;36;11;5;2;108
4***00;Diebstahl unter erschwerenden Umständen §§ 243-244a StGB und zwar:;5916000;Herne;M;283;0;0;0;1;4;5;21;38;59;38;102;18;16;34;45;65;29;8;0;181
4***00;Diebstahl unter erschwerenden Umständen §§ 243-244a StGB und zwar:;5916000;Herne;W;45;0;0;0;0;0;0;1;5;6;4;10;3;3;6;6;10;10;3;0;35
4***00;Diebstahl unter erschwerenden Umständen §§ 243-244a StGB und zwar:;5916000;Herne;X;328;0;0;0;1;4;5;22;43;65;42;112;21;19;40;51;75;39;11;0;216
4***00;Diebstahl unter erschwerenden Umständen §§ 243-244a StGB und zwar:;9161000;Ingolstadt;M;129;0;0;0;0;4;4;8;7;15;7;26;8;11;19;15;39;23;5;2;103
4***00;Diebstahl unter erschwerenden Umständen §§ 243-244a StGB und zwar:;9161000;Ingolstadt;W;9;0;0;0;0;0;0;0;2;2;1;3;0;2;2;1;1;2;0;0;6
4***00;Diebstahl unter erschwerenden Umständen §§ 243-244a StGB und zwar:;9161000;Ingolstadt;X;138;0;0;0;0;4;4;8;9;17;8;29;8;13;21;16;40;25;5;2;109
4***00;Diebstahl unter erschwerenden Umständen §§ 243-244a StGB und zwar:;16053000;Jena;M;86;0;0;0;0;4;4;0;2;2;6;12;8;6;14;14;30;7;6;3;74
4***00;Diebstahl unter erschwerenden Umständen §§ 243-244a StGB und zwar:;16053000;Jena;W;8;0;0;0;0;0;0;0;1;1;0;1;1;0;1;1;4;1;0;0;7
4***00;Diebstahl unter erschwerenden Umständen §§ 243-244a StGB und zwar:;16053000;Jena;X;94;0;0;0;0;4;4;0;3;3;6;13;9;6;15;15;34;8;6;3;81
4***00;Diebstahl unter erschwerenden Umständen §§ 243-244a StGB und zwar:;8212000;Karlsruhe;M;456;0;0;1;0;9;10;22;39;61;50;121;38;53;91;73;104;46;15;6;335
4***00;Diebstahl unter erschwerenden Umständen §§ 243-244a StGB und zwar:;8212000;Karlsruhe;W;53;0;0;0;0;2;2;7;2;9;7;18;2;1;3;9;12;6;3;2;35
4***00;Diebstahl unter erschwerenden Umständen §§ 243-244a StGB und zwar:;8212000;Karlsruhe;X;509;0;0;1;0;11;12;29;41;70;57;139;40;54;94;82;116;52;18;8;370
4***00;Diebstahl unter erschwerenden Umständen §§ 243-244a StGB und zwar:;6611000;Kassel;M;401;0;0;2;2;2;6;11;22;33;39;78;45;31;76;57;105;67;15;3;323
4***00;Diebstahl unter erschwerenden Umständen §§ 243-244a StGB und zwar:;6611000;Kassel;W;52;0;0;0;0;0;0;0;1;1;5;6;4;2;6;11;18;8;2;1;46
4***00;Diebstahl unter erschwerenden Umständen §§ 243-244a StGB und zwar:;6611000;Kassel;X;453;0;0;2;2;2;6;11;23;34;44;84;49;33;82;68;123;75;17;4;369
4***00;Diebstahl unter erschwerenden Umständen §§ 243-244a StGB und zwar:;1002000;Kiel;M;362;0;0;0;2;8;10;11;29;40;34;84;40;19;59;57;84;53;18;7;278
4***00;Diebstahl unter erschwerenden Umständen §§ 243-244a StGB und zwar:;1002000;Kiel;W;64;0;0;0;0;2;2;6;1;7;6;15;2;5;7;9;19;9;3;2;49
4***00;Diebstahl unter erschwerenden Umständen §§ 243-244a StGB und zwar:;1002000;Kiel;X;426;0;0;0;2;10;12;17;30;47;40;99;42;24;66;66;103;62;21;9;327
4***00;Diebstahl unter erschwerenden Umständen §§ 243-244a StGB und zwar:;7111000;Koblenz;M;147;0;0;0;0;4;4;6;20;26;13;43;11;9;20;22;40;10;9;3;104
4***00;Diebstahl unter erschwerenden Umständen §§ 243-244a StGB und zwar:;7111000;Koblenz;W;19;0;0;0;0;0;0;1;2;3;4;7;1;2;3;2;5;1;0;1;12
4***00;Diebstahl unter erschwerenden Umständen §§ 243-244a StGB und zwar:;7111000;Koblenz;X;166;0;0;0;0;4;4;7;22;29;17;50;12;11;23;24;45;11;9;4;116
4***00;Diebstahl unter erschwerenden Umständen §§ 243-244a StGB und zwar:;5315000;Köln;M;2354;0;0;5;6;47;58;141;241;382;314;754;193;175;368;364;529;232;84;23;1600
4***00;Diebstahl unter erschwerenden Umständen §§ 243-244a StGB und zwar:;5315000;Köln;W;471;0;0;0;4;18;22;61;54;115;66;203;28;39;67;63;77;36;17;8;268
4***00;Diebstahl unter erschwerenden Umständen §§ 243-244a StGB und zwar:;5315000;Köln;X;2825;0;0;5;10;65;80;202;295;497;380;957;221;214;435;427;606;268;101;31;1868
4***00;Diebstahl unter erschwerenden Umständen §§ 243-244a StGB und zwar:;5114000;Krefeld;M;379;0;0;0;0;5;5;13;23;36;43;84;31;22;53;75;98;49;14;6;295
4***00;Diebstahl unter erschwerenden Umständen §§ 243-244a StGB und zwar:;5114000;Krefeld;W;48;0;0;0;0;0;0;4;1;5;4;9;5;5;10;8;9;8;4;0;39
4***00;Diebstahl unter erschwerenden Umständen §§ 243-244a StGB und zwar:;5114000;Krefeld;X;427;0;0;0;0;5;5;17;24;41;47;93;36;27;63;83;107;57;18;6;334
4***00;Diebstahl unter erschwerenden Umständen §§ 243-244a StGB und zwar:;14713000;Leipzig;M;1284;0;0;0;3;12;15;47;51;98;115;228;84;126;210;288;405;102;34;17;1056
4***00;Diebstahl unter erschwerenden Umständen §§ 243-244a StGB und zwar:;14713000;Leipzig;W;161;0;0;1;2;4;7;8;8;16;15;38;13;19;32;40;32;11;6;2;123
4***00;Diebstahl unter erschwerenden Umständen §§ 243-244a StGB und zwar:;14713000;Leipzig;X;1445;0;0;1;5;16;22;55;59;114;130;266;97;145;242;328;437;113;40;19;1179
4***00;Diebstahl unter erschwerenden Umständen §§ 243-244a StGB und zwar:;5316000;Leverkusen;M;251;0;0;0;0;7;7;17;11;28;40;75;23;12;35;43;60;25;11;2;176
4***00;Diebstahl unter erschwerenden Umständen §§ 243-244a StGB und zwar:;5316000;Leverkusen;W;52;0;0;0;0;4;4;0;4;4;4;12;5;2;7;12;13;3;4;1;40
4***00;Diebstahl unter erschwerenden Umständen §§ 243-244a StGB und zwar:;5316000;Leverkusen;X;303;0;0;0;0;11;11;17;15;32;44;87;28;14;42;55;73;28;15;3;216
4***00;Diebstahl unter erschwerenden Umständen §§ 243-244a StGB und zwar:;1003000;Lübeck;M;367;0;0;0;2;6;8;17;25;42;31;81;33;27;60;59;80;64;16;7;286
4***00;Diebstahl unter erschwerenden Umständen §§ 243-244a StGB und zwar:;1003000;Lübeck;W;54;0;0;0;0;2;2;8;5;13;6;21;1;4;5;10;7;10;1;0;33
4***00;Diebstahl unter erschwerenden Umständen §§ 243-244a StGB und zwar:;1003000;Lübeck;X;421;0;0;0;2;8;10;25;30;55;37;102;34;31;65;69;87;74;17;7;319
4***00;Diebstahl unter erschwerenden Umständen §§ 243-244a StGB und zwar:;7314000;Ludwigshafen am Rhein;M;313;0;2;2;0;9;13;13;21;34;32;79;21;22;43;52;84;36;12;7;234
4***00;Diebstahl unter erschwerenden Umständen §§ 243-244a StGB und zwar:;7314000;Ludwigshafen am Rhein;W;49;0;0;0;0;1;1;5;5;10;7;18;2;1;3;7;10;5;4;2;31
4***00;Diebstahl unter erschwerenden Umständen §§ 243-244a StGB und zwar:;7314000;Ludwigshafen am Rhein;X;362;0;2;2;0;10;14;18;26;44;39;97;23;23;46;59;94;41;16;9;265
4***00;Diebstahl unter erschwerenden Umständen §§ 243-244a StGB und zwar:;15003000;Magdeburg;M;456;0;0;0;1;5;6;12;39;51;71;128;40;47;87;84;93;34;24;6;328
4***00;Diebstahl unter erschwerenden Umständen §§ 243-244a StGB und zwar:;15003000;Magdeburg;W;49;0;0;0;1;1;2;8;3;11;6;19;5;3;8;8;6;4;1;3;30
4***00;Diebstahl unter erschwerenden Umständen §§ 243-244a StGB und zwar:;15003000;Magdeburg;X;505;0;0;0;2;6;8;20;42;62;77;147;45;50;95;92;99;38;25;9;358
4***00;Diebstahl unter erschwerenden Umständen §§ 243-244a StGB und zwar:;7315000;Mainz;M;283;0;0;0;0;4;4;16;25;41;32;77;26;20;46;36;74;32;12;6;206
4***00;Diebstahl unter erschwerenden Umständen §§ 243-244a StGB und zwar:;7315000;Mainz;W;62;0;0;0;1;4;5;9;2;11;5;21;7;8;15;4;6;13;3;0;41
4***00;Diebstahl unter erschwerenden Umständen §§ 243-244a StGB und zwar:;7315000;Mainz;X;345;0;0;0;1;8;9;25;27;52;37;98;33;28;61;40;80;45;15;6;247
4***00;Diebstahl unter erschwerenden Umständen §§ 243-244a StGB und zwar:;8222000;Mannheim;M;378;0;0;0;3;4;7;22;35;57;38;102;36;27;63;63;89;45;13;3;276
4***00;Diebstahl unter erschwerenden Umständen §§ 243-244a StGB und zwar:;8222000;Mannheim;W;58;0;0;1;0;2;3;2;3;5;10;18;6;5;11;10;8;8;2;1;40
4***00;Diebstahl unter erschwerenden Umständen §§ 243-244a StGB und zwar:;8222000;Mannheim;X;436;0;0;1;3;6;10;24;38;62;48;120;42;32;74;73;97;53;15;4;316
4***00;Diebstahl unter erschwerenden Umständen §§ 243-244a StGB und zwar:;5170024;Moers;M;139;0;0;0;1;5;6;4;9;13;16;35;6;15;21;24;35;20;3;1;104
4***00;Diebstahl unter erschwerenden Umständen §§ 243-244a StGB und zwar:;5170024;Moers;W;15;0;0;0;0;1;1;1;1;2;1;4;4;0;4;1;2;3;1;0;11
4***00;Diebstahl unter erschwerenden Umständen §§ 243-244a StGB und zwar:;5170024;Moers;X;154;0;0;0;1;6;7;5;10;15;17;39;10;15;25;25;37;23;4;1;115
4***00;Diebstahl unter erschwerenden Umständen §§ 243-244a StGB und zwar:;5116000;Mönchengladbach;M;341;0;0;0;2;0;2;12;22;34;52;88;39;34;73;52;79;32;15;2;253
4***00;Diebstahl unter erschwerenden Umständen §§ 243-244a StGB und zwar:;5116000;Mönchengladbach;W;50;0;0;0;1;3;4;3;2;5;3;12;3;2;5;12;9;11;1;0;38
4***00;Diebstahl unter erschwerenden Umständen §§ 243-244a StGB und zwar:;5116000;Mönchengladbach;X;391;0;0;0;3;3;6;15;24;39;55;100;42;36;78;64;88;43;16;2;291
4***00;Diebstahl unter erschwerenden Umständen §§ 243-244a StGB und zwar:;5117000;Mülheim an der Ruhr;M;200;0;0;0;1;2;3;12;13;25;26;54;20;19;39;31;46;19;9;2;146
4***00;Diebstahl unter erschwerenden Umständen §§ 243-244a StGB und zwar:;5117000;Mülheim an der Ruhr;W;42;0;0;0;0;4;4;3;4;7;9;20;3;2;5;4;3;7;2;1;22
4***00;Diebstahl unter erschwerenden Umständen §§ 243-244a StGB und zwar:;5117000;Mülheim an der Ruhr;X;242;0;0;0;1;6;7;15;17;32;35;74;23;21;44;35;49;26;11;3;168
4***00;Diebstahl unter erschwerenden Umständen §§ 243-244a StGB und zwar:;9162000;München;M;1643;0;1;4;12;30;47;97;125;222;191;460;100;106;206;240;374;213;97;53;1183
4***00;Diebstahl unter erschwerenden Umständen §§ 243-244a StGB und zwar:;9162000;München;W;270;1;0;0;1;12;14;27;18;45;32;91;16;17;33;38;60;29;10;9;179
4***00;Diebstahl unter erschwerenden Umständen §§ 243-244a StGB und zwar:;9162000;München;X;1913;1;1;4;13;42;61;124;143;267;223;551;116;123;239;278;434;242;107;62;1362
4***00;Diebstahl unter erschwerenden Umständen §§ 243-244a StGB und zwar:;5515000;Münster;M;529;0;0;0;1;14;15;33;55;88;96;199;52;38;90;76;88;50;16;10;330
4***00;Diebstahl unter erschwerenden Umständen §§ 243-244a StGB und zwar:;5515000;Münster;W;79;0;0;0;1;3;4;9;8;17;11;32;3;3;6;12;22;4;3;0;47
4***00;Diebstahl unter erschwerenden Umständen §§ 243-244a StGB und zwar:;5515000;Münster;X;608;0;0;0;2;17;19;42;63;105;107;231;55;41;96;88;110;54;19;10;377
4***00;Diebstahl unter erschwerenden Umständen §§ 243-244a StGB und zwar:;5162024;Neuss;M;292;0;0;0;2;3;5;12;18;30;39;74;19;29;48;49;73;29;16;3;218
4***00;Diebstahl unter erschwerenden Umständen §§ 243-244a StGB und zwar:;5162024;Neuss;W;39;0;0;0;1;5;6;3;3;6;1;13;1;1;2;3;11;9;1;0;26
4***00;Diebstahl unter erschwerenden Umständen §§ 243-244a StGB und zwar:;5162024;Neuss;X;331;0;0;0;3;8;11;15;21;36;40;87;20;30;50;52;84;38;17;3;244
4***00;Diebstahl unter erschwerenden Umständen §§ 243-244a StGB und zwar:;9564000;Nürnberg;M;741;0;0;0;3;12;15;29;44;73;69;157;41;57;98;150;221;75;29;11;584
4***00;Diebstahl unter erschwerenden Umständen §§ 243-244a StGB und zwar:;9564000;Nürnberg;W;84;0;0;0;0;3;3;6;9;15;8;26;5;3;8;11;16;11;5;7;58
4***00;Diebstahl unter erschwerenden Umständen §§ 243-244a StGB und zwar:;9564000;Nürnberg;X;825;0;0;0;3;15;18;35;53;88;77;183;46;60;106;161;237;86;34;18;642
4***00;Diebstahl unter erschwerenden Umständen §§ 243-244a StGB und zwar:;5119000;Oberhausen;M;347;0;0;0;0;0;0;22;20;42;42;84;33;23;56;63;82;44;13;5;263
4***00;Diebstahl unter erschwerenden Umständen §§ 243-244a StGB und zwar:;5119000;Oberhausen;W;57;0;0;0;0;6;6;6;4;10;7;23;2;2;4;11;10;6;2;1;34
4***00;Diebstahl unter erschwerenden Umständen §§ 243-244a StGB und zwar:;5119000;Oberhausen;X;404;0;0;0;0;6;6;28;24;52;49;107;35;25;60;74;92;50;15;6;297
4***00;Diebstahl unter erschwerenden Umständen §§ 243-244a StGB und zwar:;6413000;Offenbach am Main;M;267;0;0;1;1;7;9;22;35;57;50;116;17;20;37;37;45;23;6;3;151
4***00;Diebstahl unter erschwerenden Umständen §§ 243-244a StGB und zwar:;6413000;Offenbach am Main;W;24;0;0;0;0;1;1;2;3;5;1;7;2;2;4;1;7;1;3;1;17
4***00;Diebstahl unter erschwerenden Umständen §§ 243-244a StGB und zwar:;6413000;Offenbach am Main;X;291;0;0;1;1;8;10;24;38;62;51;123;19;22;41;38;52;24;9;4;168
4***00;Diebstahl unter erschwerenden Umständen §§ 243-244a StGB und zwar:;3403000;Oldenburg (Oldenburg);M;412;0;0;0;1;5;6;21;27;48;64;118;45;33;78;66;81;36;26;7;294
4***00;Diebstahl unter erschwerenden Umständen §§ 243-244a StGB und zwar:;3403000;Oldenburg (Oldenburg);W;65;0;0;0;0;5;5;4;4;8;9;22;6;2;8;9;16;6;2;2;43
4***00;Diebstahl unter erschwerenden Umständen §§ 243-244a StGB und zwar:;3403000;Oldenburg (Oldenburg);X;477;0;0;0;1;10;11;25;31;56;73;140;51;35;86;75;97;42;28;9;337
4***00;Diebstahl unter erschwerenden Umständen §§ 243-244a StGB und zwar:;3404000;Osnabrück;M;496;0;0;0;1;7;8;21;22;43;56;107;35;36;71;87;130;68;29;4;389
4***00;Diebstahl unter erschwerenden Umständen §§ 243-244a StGB und zwar:;3404000;Osnabrück;W;67;0;0;0;0;0;0;3;1;4;5;9;6;2;8;7;27;9;7;0;58
4***00;Diebstahl unter erschwerenden Umständen §§ 243-244a StGB und zwar:;3404000;Osnabrück;X;563;0;0;0;1;7;8;24;23;47;61;116;41;38;79;94;157;77;36;4;447
4***00;Diebstahl unter erschwerenden Umständen §§ 243-244a StGB und zwar:;5774032;Paderborn;M;280;0;0;0;0;4;4;12;27;39;32;75;19;28;47;53;59;26;14;6;205
4***00;Diebstahl unter erschwerenden Umständen §§ 243-244a StGB und zwar:;5774032;Paderborn;W;51;0;0;0;0;2;2;3;4;7;6;15;3;3;6;6;12;6;5;1;36
4***00;Diebstahl unter erschwerenden Umständen §§ 243-244a StGB und zwar:;5774032;Paderborn;X;331;0;0;0;0;6;6;15;31;46;38;90;22;31;53;59;71;32;19;7;241
4***00;Diebstahl unter erschwerenden Umständen §§ 243-244a StGB und zwar:;8231000;Pforzheim;M;171;0;0;0;0;3;3;12;17;29;25;57;9;11;20;43;25;20;3;3;114
4***00;Diebstahl unter erschwerenden Umständen §§ 243-244a StGB und zwar:;8231000;Pforzheim;W;23;0;0;0;0;0;0;0;2;2;1;3;0;0;0;5;6;5;1;3;20
4***00;Diebstahl unter erschwerenden Umständen §§ 243-244a StGB und zwar:;8231000;Pforzheim;X;194;0;0;0;0;3;3;12;19;31;26;60;9;11;20;48;31;25;4;6;134
4***00;Diebstahl unter erschwerenden Umständen §§ 243-244a StGB und zwar:;12054000;Potsdam;M;283;0;0;0;1;3;4;11;16;27;38;69;28;34;62;40;69;25;15;3;214
4***00;Diebstahl unter erschwerenden Umständen §§ 243-244a StGB und zwar:;12054000;Potsdam;W;29;0;0;1;0;0;1;4;5;9;3;13;0;2;2;5;5;2;1;1;16
4***00;Diebstahl unter erschwerenden Umständen §§ 243-244a StGB und zwar:;12054000;Potsdam;X;312;0;0;1;1;3;5;15;21;36;41;82;28;36;64;45;74;27;16;4;230
4***00;Diebstahl unter erschwerenden Umständen §§ 243-244a StGB und zwar:;5562032;Recklinghausen;M;216;0;0;0;1;2;3;7;10;17;29;49;21;19;40;33;65;23;5;1;167
4***00;Diebstahl unter erschwerenden Umständen §§ 243-244a StGB und zwar:;5562032;Recklinghausen;W;43;0;0;0;0;1;1;7;4;11;4;16;5;5;10;5;7;1;4;0;27
4***00;Diebstahl unter erschwerenden Umständen §§ 243-244a StGB und zwar:;5562032;Recklinghausen;X;259;0;0;0;1;3;4;14;14;28;33;65;26;24;50;38;72;24;9;1;194
4***00;Diebstahl unter erschwerenden Umständen §§ 243-244a StGB und zwar:;9362000;Regensburg;M;206;0;0;1;1;0;2;13;4;17;13;32;9;13;22;49;66;21;12;4;174
4***00;Diebstahl unter erschwerenden Umständen §§ 243-244a StGB und zwar:;9362000;Regensburg;W;34;0;0;0;0;3;3;1;1;2;3;8;3;1;4;7;8;3;3;1;26
4***00;Diebstahl unter erschwerenden Umständen §§ 243-244a StGB und zwar:;9362000;Regensburg;X;240;0;0;1;1;3;5;14;5;19;16;40;12;14;26;56;74;24;15;5;200
4***00;Diebstahl unter erschwerenden Umständen §§ 243-244a StGB und zwar:;5120000;Remscheid;M;120;0;0;0;0;1;1;0;5;5;10;16;11;12;23;26;34;11;9;1;104
4***00;Diebstahl unter erschwerenden Umständen §§ 243-244a StGB und zwar:;5120000;Remscheid;W;26;0;0;0;1;0;1;1;0;1;3;5;1;1;2;5;8;4;2;0;21
4***00;Diebstahl unter erschwerenden Umständen §§ 243-244a StGB und zwar:;5120000;Remscheid;X;146;0;0;0;1;1;2;1;5;6;13;21;12;13;25;31;42;15;11;1;125
4***00;Diebstahl unter erschwerenden Umständen §§ 243-244a StGB und zwar:;8415061;Reutlingen;M;74;0;0;0;0;2;2;13;12;25;3;30;4;5;9;9;11;8;5;2;44
4***00;Diebstahl unter erschwerenden Umständen §§ 243-244a StGB und zwar:;8415061;Reutlingen;W;16;0;0;0;0;0;0;1;4;5;1;6;2;0;2;3;2;0;2;1;10
4***00;Diebstahl unter erschwerenden Umständen §§ 243-244a StGB und zwar:;8415061;Reutlingen;X;90;0;0;0;0;2;2;14;16;30;4;36;6;5;11;12;13;8;7;3;54
4***00;Diebstahl unter erschwerenden Umständen §§ 243-244a StGB und zwar:;13003000;Rostock;M;346;0;0;4;2;10;16;27;30;57;33;106;23;24;47;68;90;22;10;3;240
4***00;Diebstahl unter erschwerenden Umständen §§ 243-244a StGB und zwar:;13003000;Rostock;W;48;0;0;0;2;4;6;2;5;7;3;16;2;3;5;10;11;2;1;3;32
4***00;Diebstahl unter erschwerenden Umständen §§ 243-244a StGB und zwar:;13003000;Rostock;X;394;0;0;4;4;14;22;29;35;64;36;122;25;27;52;78;101;24;11;6;272
4***00;Diebstahl unter erschwerenden Umständen §§ 243-244a StGB und zwar:;10041100;Saarbrücken;M;401;0;0;0;1;8;9;29;25;54;35;98;22;26;48;85;108;36;21;5;303
4***00;Diebstahl unter erschwerenden Umständen §§ 243-244a StGB und zwar:;10041100;Saarbrücken;W;88;0;0;0;1;5;6;3;5;8;16;30;3;5;8;13;19;13;3;2;58
4***00;Diebstahl unter erschwerenden Umständen §§ 243-244a StGB und zwar:;10041100;Saarbrücken;X;489;0;0;0;2;13;15;32;30;62;51;128;25;31;56;98;127;49;24;7;361
4***00;Diebstahl unter erschwerenden Umständen §§ 243-244a StGB und zwar:;5122000;Solingen;M;163;0;0;0;0;3;3;4;8;12;20;35;11;12;23;26;45;29;5;0;128
4***00;Diebstahl unter erschwerenden Umständen §§ 243-244a StGB und zwar:;5122000;Solingen;W;31;0;0;0;0;2;2;0;0;0;4;6;3;3;6;4;12;1;0;2;25
4***00;Diebstahl unter erschwerenden Umständen §§ 243-244a StGB und zwar:;5122000;Solingen;X;194;0;0;0;0;5;5;4;8;12;24;41;14;15;29;30;57;30;5;2;153
4***00;Diebstahl unter erschwerenden Umständen §§ 243-244a StGB und zwar:;8111000;Stuttgart;M;865;0;0;0;2;13;15;25;68;93;90;198;63;71;134;164;219;98;38;14;667
4***00;Diebstahl unter erschwerenden Umständen §§ 243-244a StGB und zwar:;8111000;Stuttgart;W;186;0;0;1;1;5;7;15;13;28;25;60;8;7;15;22;41;28;17;3;126
4***00;Diebstahl unter erschwerenden Umständen §§ 243-244a StGB und zwar:;8111000;Stuttgart;X;1051;0;0;1;3;18;22;40;81;121;115;258;71;78;149;186;260;126;55;17;793
4***00;Diebstahl unter erschwerenden Umständen §§ 243-244a StGB und zwar:;7211000;Trier;M;145;0;0;0;0;1;1;7;14;21;15;37;14;20;34;28;24;13;8;1;108
4***00;Diebstahl unter erschwerenden Umständen §§ 243-244a StGB und zwar:;7211000;Trier;W;21;0;0;0;0;0;0;0;3;3;2;5;1;2;3;5;4;2;2;0;16
4***00;Diebstahl unter erschwerenden Umständen §§ 243-244a StGB und zwar:;7211000;Trier;X;166;0;0;0;0;1;1;7;17;24;17;42;15;22;37;33;28;15;10;1;124
4***00;Diebstahl unter erschwerenden Umständen §§ 243-244a StGB und zwar:;8421000;Ulm;M;154;0;0;0;0;0;0;4;10;14;17;31;16;12;28;26;45;20;4;0;123
4***00;Diebstahl unter erschwerenden Umständen §§ 243-244a StGB und zwar:;8421000;Ulm;W;16;0;0;0;0;1;1;0;1;1;0;2;1;0;1;8;2;2;0;1;14
4***00;Diebstahl unter erschwerenden Umständen §§ 243-244a StGB und zwar:;8421000;Ulm;X;170;0;0;0;0;1;1;4;11;15;17;33;17;12;29;34;47;22;4;1;137
4***00;Diebstahl unter erschwerenden Umständen §§ 243-244a StGB und zwar:;6414000;Wiesbaden;M;384;0;2;1;2;19;24;39;36;75;59;158;25;19;44;48;81;33;18;2;226
4***00;Diebstahl unter erschwerenden Umständen §§ 243-244a StGB und zwar:;6414000;Wiesbaden;W;45;0;0;0;3;8;11;3;1;4;4;19;3;6;9;3;8;3;2;1;26
4***00;Diebstahl unter erschwerenden Umständen §§ 243-244a StGB und zwar:;6414000;Wiesbaden;X;429;0;2;1;5;27;35;42;37;79;63;177;28;25;53;51;89;36;20;3;252
4***00;Diebstahl unter erschwerenden Umständen §§ 243-244a StGB und zwar:;3103000;Wolfsburg;M;207;0;0;0;0;10;10;9;20;29;25;64;11;17;28;31;55;16;10;3;143
4***00;Diebstahl unter erschwerenden Umständen §§ 243-244a StGB und zwar:;3103000;Wolfsburg;W;32;0;0;0;0;0;0;3;3;6;2;8;2;2;4;8;7;3;2;0;24
4***00;Diebstahl unter erschwerenden Umständen §§ 243-244a StGB und zwar:;3103000;Wolfsburg;X;239;0;0;0;0;10;10;12;23;35;27;72;13;19;32;39;62;19;12;3;167
4***00;Diebstahl unter erschwerenden Umständen §§ 243-244a StGB und zwar:;5124000;Wuppertal;M;448;0;0;1;5;12;18;25;24;49;46;113;27;36;63;79;128;50;13;2;335
4***00;Diebstahl unter erschwerenden Umständen §§ 243-244a StGB und zwar:;5124000;Wuppertal;W;106;0;0;1;0;9;10;13;4;17;13;40;4;11;15;14;20;11;5;1;66
4***00;Diebstahl unter erschwerenden Umständen §§ 243-244a StGB und zwar:;5124000;Wuppertal;X;554;0;0;2;5;21;28;38;28;66;59;153;31;47;78;93;148;61;18;3;401
4***00;Diebstahl unter erschwerenden Umständen §§ 243-244a StGB und zwar:;9663000;Würzburg;M;169;0;0;0;0;1;1;7;12;19;18;38;13;13;26;27;44;21;8;5;131
4***00;Diebstahl unter erschwerenden Umständen §§ 243-244a StGB und zwar:;9663000;Würzburg;W;15;0;0;0;0;2;2;0;0;0;2;4;1;3;4;1;2;2;1;1;11
4***00;Diebstahl unter erschwerenden Umständen §§ 243-244a StGB und zwar:;9663000;Würzburg;X;184;0;0;0;0;3;3;7;12;19;20;42;14;16;30;28;46;23;9;6;142
435*00;Wohnungseinbruchdiebstahl § 244 Abs. 1 Nr. 3 StGB darunter:;5334002;Aachen;M;55;0;0;0;0;0;0;0;3;3;6;9;4;5;9;11;17;8;1;0;46
435*00;Wohnungseinbruchdiebstahl § 244 Abs. 1 Nr. 3 StGB darunter:;5334002;Aachen;W;17;0;0;0;0;0;0;2;1;3;5;8;2;1;3;1;2;3;0;0;9
435*00;Wohnungseinbruchdiebstahl § 244 Abs. 1 Nr. 3 StGB darunter:;5334002;Aachen;X;72;0;0;0;0;0;0;2;4;6;11;17;6;6;12;12;19;11;1;0;55
435*00;Wohnungseinbruchdiebstahl § 244 Abs. 1 Nr. 3 StGB darunter:;9761000;Augsburg;M;27;0;0;0;0;0;0;0;0;0;1;1;2;2;4;3;14;2;3;0;26
435*00;Wohnungseinbruchdiebstahl § 244 Abs. 1 Nr. 3 StGB darunter:;9761000;Augsburg;W;5;0;0;0;0;0;0;0;0;0;0;0;1;1;2;0;2;1;0;0;5
435*00;Wohnungseinbruchdiebstahl § 244 Abs. 1 Nr. 3 StGB darunter:;9761000;Augsburg;X;32;0;0;0;0;0;0;0;0;0;1;1;3;3;6;3;16;3;3;0;31
435*00;Wohnungseinbruchdiebstahl § 244 Abs. 1 Nr. 3 StGB darunter:;5378004;Bergisch Gladbach;M;29;0;0;0;0;0;0;0;0;0;5;5;3;2;5;3;8;2;5;1;24
435*00;Wohnungseinbruchdiebstahl § 244 Abs. 1 Nr. 3 StGB darunter:;5378004;Bergisch Gladbach;W;6;0;0;0;0;0;0;0;1;1;1;2;0;1;1;1;2;0;0;0;4
435*00;Wohnungseinbruchdiebstahl § 244 Abs. 1 Nr. 3 StGB darunter:;5378004;Bergisch Gladbach;X;35;0;0;0;0;0;0;0;1;1;6;7;3;3;6;4;10;2;5;1;28
435*00;Wohnungseinbruchdiebstahl § 244 Abs. 1 Nr. 3 StGB darunter:;11000000;Berlin;M;679;0;0;0;1;8;9;41;69;110;114;233;63;45;108;101;151;55;19;12;446
435*00;Wohnungseinbruchdiebstahl § 244 Abs. 1 Nr. 3 StGB darunter:;11000000;Berlin;W;113;0;0;1;0;4;5;7;9;16;20;41;6;8;14;10;22;16;7;3;72
435*00;Wohnungseinbruchdiebstahl § 244 Abs. 1 Nr. 3 StGB darunter:;11000000;Berlin;X;792;0;0;1;1;12;14;48;78;126;134;274;69;53;122;111;173;71;26;15;518
435*00;Wohnungseinbruchdiebstahl § 244 Abs. 1 Nr. 3 StGB darunter:;5711000;Bielefeld;M;94;0;0;0;0;0;0;5;7;12;13;25;9;10;19;18;20;6;4;2;69
435*00;Wohnungseinbruchdiebstahl § 244 Abs. 1 Nr. 3 StGB darunter:;5711000;Bielefeld;W;12;0;0;0;0;0;0;2;1;3;3;6;0;0;0;2;3;0;1;0;6
435*00;Wohnungseinbruchdiebstahl § 244 Abs. 1 Nr. 3 StGB darunter:;5711000;Bielefeld;X;106;0;0;0;0;0;0;7;8;15;16;31;9;10;19;20;23;6;5;2;75
435*00;Wohnungseinbruchdiebstahl § 244 Abs. 1 Nr. 3 StGB darunter:;5911000;Bochum;M;107;0;0;0;0;0;0;2;4;6;11;17;13;9;22;23;38;2;3;2;90
435*00;Wohnungseinbruchdiebstahl § 244 Abs. 1 Nr. 3 StGB darunter:;5911000;Bochum;W;25;0;0;0;1;2;3;1;3;4;4;11;0;2;2;5;4;0;3;0;14
435*00;Wohnungseinbruchdiebstahl § 244 Abs. 1 Nr. 3 StGB darunter:;5911000;Bochum;X;132;0;0;0;1;2;3;3;7;10;15;28;13;11;24;28;42;2;6;2;104
435*00;Wohnungseinbruchdiebstahl § 244 Abs. 1 Nr. 3 StGB darunter:;5314000;Bonn;M;98;0;0;0;0;2;2;6;8;14;10;26;7;14;21;12;23;13;3;0;72
435*00;Wohnungseinbruchdiebstahl § 244 Abs. 1 Nr. 3 StGB darunter:;5314000;Bonn;W;23;0;0;0;1;1;2;4;2;6;4;12;0;1;1;1;3;6;0;0;11
435*00;Wohnungseinbruchdiebstahl § 244 Abs. 1 Nr. 3 StGB darunter:;5314000;Bonn;X;121;0;0;0;1;3;4;10;10;20;14;38;7;15;22;13;26;19;3;0;83
435*00;Wohnungseinbruchdiebstahl § 244 Abs. 1 Nr. 3 StGB darunter:;5512000;Bottrop;M;13;0;0;0;0;0;0;0;0;0;0;0;3;0;3;4;4;1;1;0;13
435*00;Wohnungseinbruchdiebstahl § 244 Abs. 1 Nr. 3 StGB darunter:;5512000;Bottrop;W;3;0;0;0;0;0;0;0;1;1;0;1;0;0;0;1;0;1;0;0;2
435*00;Wohnungseinbruchdiebstahl § 244 Abs. 1 Nr. 3 StGB darunter:;5512000;Bottrop;X;16;0;0;0;0;0;0;0;1;1;0;1;3;0;3;5;4;2;1;0;15
435*00;Wohnungseinbruchdiebstahl § 244 Abs. 1 Nr. 3 StGB darunter:;3101000;Braunschweig;M;45;0;0;0;0;0;0;0;2;2;8;10;6;3;9;7;12;2;4;1;35
435*00;Wohnungseinbruchdiebstahl § 244 Abs. 1 Nr. 3 StGB darunter:;3101000;Braunschweig;W;11;0;0;0;0;0;0;0;1;1;3;4;0;1;1;2;3;1;0;0;7
435*00;Wohnungseinbruchdiebstahl § 244 Abs. 1 Nr. 3 StGB darunter:;3101000;Braunschweig;X;56;0;0;0;0;0;0;0;3;3;11;14;6;4;10;9;15;3;4;1;42
435*00;Wohnungseinbruchdiebstahl § 244 Abs. 1 Nr. 3 StGB darunter:;4011000;Bremen;M;216;0;0;0;2;3;5;14;44;58;35;98;12;11;23;27;39;17;8;4;118
435*00;Wohnungseinbruchdiebstahl § 244 Abs. 1 Nr. 3 StGB darunter:;4011000;Bremen;W;25;0;0;0;0;1;1;1;3;4;4;9;2;4;6;1;2;2;4;1;16
435*00;Wohnungseinbruchdiebstahl § 244 Abs. 1 Nr. 3 StGB darunter:;4011000;Bremen;X;241;0;0;0;2;4;6;15;47;62;39;107;14;15;29;28;41;19;12;5;134
435*00;Wohnungseinbruchdiebstahl § 244 Abs. 1 Nr. 3 StGB darunter:;4012000;Bremerhaven;M;62;0;0;0;0;1;1;2;8;10;10;21;7;7;14;14;9;2;1;1;41
435*00;Wohnungseinbruchdiebstahl § 244 Abs. 1 Nr. 3 StGB darunter:;4012000;Bremerhaven;W;2;0;0;0;0;0;0;0;0;0;0;0;1;0;1;0;0;0;1;0;2
435*00;Wohnungseinbruchdiebstahl § 244 Abs. 1 Nr. 3 StGB darunter:;4012000;Bremerhaven;X;64;0;0;0;0;1;1;2;8;10;10;21;8;7;15;14;9;2;2;1;43
435*00;Wohnungseinbruchdiebstahl § 244 Abs. 1 Nr. 3 StGB darunter:;14511000;Chemnitz;M;44;0;0;0;0;0;0;2;2;4;6;10;1;1;2;11;16;2;3;0;34
435*00;Wohnungseinbruchdiebstahl § 244 Abs. 1 Nr. 3 StGB darunter:;14511000;Chemnitz;W;17;0;0;0;0;0;0;1;2;3;5;8;0;0;0;1;4;0;3;1;9
435*00;Wohnungseinbruchdiebstahl § 244 Abs. 1 Nr. 3 StGB darunter:;14511000;Chemnitz;X;61;0;0;0;0;0;0;3;4;7;11;18;1;1;2;12;20;2;6;1;43
435*00;Wohnungseinbruchdiebstahl § 244 Abs. 1 Nr. 3 StGB darunter:;6411000;Darmstadt;M;34;0;0;2;1;0;3;0;2;2;6;11;3;4;7;3;6;5;2;0;23
435*00;Wohnungseinbruchdiebstahl § 244 Abs. 1 Nr. 3 StGB darunter:;6411000;Darmstadt;W;1;0;0;0;0;0;0;0;0;0;0;0;0;1;1;0;0;0;0;0;1
435*00;Wohnungseinbruchdiebstahl § 244 Abs. 1 Nr. 3 StGB darunter:;6411000;Darmstadt;X;35;0;0;2;1;0;3;0;2;2;6;11;3;5;8;3;6;5;2;0;24
435*00;Wohnungseinbruchdiebstahl § 244 Abs. 1 Nr. 3 StGB darunter:;5913000;Dortmund;M;235;0;0;0;2;3;5;7;15;22;42;69;17;17;34;44;55;21;10;2;166
435*00;Wohnungseinbruchdiebstahl § 244 Abs. 1 Nr. 3 StGB darunter:;5913000;Dortmund;W;55;0;0;0;1;3;4;4;8;12;7;23;3;3;6;10;7;5;3;1;32
435*00;Wohnungseinbruchdiebstahl § 244 Abs. 1 Nr. 3 StGB darunter:;5913000;Dortmund;X;290;0;0;0;3;6;9;11;23;34;49;92;20;20;40;54;62;26;13;3;198
435*00;Wohnungseinbruchdiebstahl § 244 Abs. 1 Nr. 3 StGB darunter:;14612000;Dresden;M;94;0;0;0;0;1;1;1;2;3;8;12;4;7;11;27;36;6;1;1;82
435*00;Wohnungseinbruchdiebstahl § 244 Abs. 1 Nr. 3 StGB darunter:;14612000;Dresden;W;15;0;0;0;0;0;0;0;1;1;3;4;0;2;2;8;1;0;0;0;11
435*00;Wohnungseinbruchdiebstahl § 244 Abs. 1 Nr. 3 StGB darunter:;14612000;Dresden;X;109;0;0;0;0;1;1;1;3;4;11;16;4;9;13;35;37;6;1;1;93
435*00;Wohnungseinbruchdiebstahl § 244 Abs. 1 Nr. 3 StGB darunter:;5112000;Duisburg;M;168;0;0;0;0;3;3;8;8;16;15;34;19;14;33;30;34;19;12;6;134
435*00;Wohnungseinbruchdiebstahl § 244 Abs. 1 Nr. 3 StGB darunter:;5112000;Duisburg;W;40;0;0;0;0;1;1;2;4;6;5;12;1;2;3;6;11;3;3;2;28
435*00;Wohnungseinbruchdiebstahl § 244 Abs. 1 Nr. 3 StGB darunter:;5112000;Duisburg;X;208;0;0;0;0;4;4;10;12;22;20;46;20;16;36;36;45;22;15;8;162
435*00;Wohnungseinbruchdiebstahl § 244 Abs. 1 Nr. 3 StGB darunter:;5111000;Düsseldorf;M;199;0;0;0;3;1;4;14;11;25;13;42;22;17;39;37;42;21;14;4;157
435*00;Wohnungseinbruchdiebstahl § 244 Abs. 1 Nr. 3 StGB darunter:;5111000;Düsseldorf;W;62;0;0;0;0;3;3;14;6;20;12;35;3;5;8;5;8;5;1;0;27
435*00;Wohnungseinbruchdiebstahl § 244 Abs. 1 Nr. 3 StGB darunter:;5111000;Düsseldorf;X;261;0;0;0;3;4;7;28;17;45;25;77;25;22;47;42;50;26;15;4;184
435*00;Wohnungseinbruchdiebstahl § 244 Abs. 1 Nr. 3 StGB darunter:;16051000;Erfurt;M;41;0;0;0;0;0;0;0;4;4;3;7;3;2;5;10;17;1;0;1;34
435*00;Wohnungseinbruchdiebstahl § 244 Abs. 1 Nr. 3 StGB darunter:;16051000;Erfurt;W;4;0;0;0;0;0;0;0;0;0;0;0;1;1;2;0;1;1;0;0;4
435*00;Wohnungseinbruchdiebstahl § 244 Abs. 1 Nr. 3 StGB darunter:;16051000;Erfurt;X;45;0;0;0;0;0;0;0;4;4;3;7;4;3;7;10;18;2;0;1;38
435*00;Wohnungseinbruchdiebstahl § 244 Abs. 1 Nr. 3 StGB darunter:;9562000;Erlangen;M;17;0;0;0;0;0;0;1;1;2;3;5;0;2;2;1;7;2;0;0;12
435*00;Wohnungseinbruchdiebstahl § 244 Abs. 1 Nr. 3 StGB darunter:;9562000;Erlangen;W;0;0;0;0;0;0;0;0;0;0;0;0;0;0;0;0;0;0;0;0;0
435*00;Wohnungseinbruchdiebstahl § 244 Abs. 1 Nr. 3 StGB darunter:;9562000;Erlangen;X;17;0;0;0;0;0;0;1;1;2;3;5;0;2;2;1;7;2;0;0;12
435*00;Wohnungseinbruchdiebstahl § 244 Abs. 1 Nr. 3 StGB darunter:;5113000;Essen;M;146;0;0;0;0;5;5;5;4;9;16;30;10;16;26;23;38;16;10;3;116
435*00;Wohnungseinbruchdiebstahl § 244 Abs. 1 Nr. 3 StGB darunter:;5113000;Essen;W;35;0;0;0;0;2;2;4;1;5;5;12;3;4;7;5;4;6;1;0;23
435*00;Wohnungseinbruchdiebstahl § 244 Abs. 1 Nr. 3 StGB darunter:;5113000;Essen;X;181;0;0;0;0;7;7;9;5;14;21;42;13;20;33;28;42;22;11;3;139
435*00;Wohnungseinbruchdiebstahl § 244 Abs. 1 Nr. 3 StGB darunter:;6412000;Frankfurt am Main;M;179;0;0;0;0;0;0;2;11;13;38;51;16;12;28;28;46;18;6;2;128
435*00;Wohnungseinbruchdiebstahl § 244 Abs. 1 Nr. 3 StGB darunter:;6412000;Frankfurt am Main;W;29;0;0;0;0;1;1;7;1;8;5;14;1;1;2;6;3;2;2;0;15
435*00;Wohnungseinbruchdiebstahl § 244 Abs. 1 Nr. 3 StGB darunter:;6412000;Frankfurt am Main;X;208;0;0;0;0;1;1;9;12;21;43;65;17;13;30;34;49;20;8;2;143
435*00;Wohnungseinbruchdiebstahl § 244 Abs. 1 Nr. 3 StGB darunter:;8311000;Freiburg im Breisgau;M;53;0;0;0;0;0;0;2;5;7;3;10;4;5;9;11;14;5;3;1;43
435*00;Wohnungseinbruchdiebstahl § 244 Abs. 1 Nr. 3 StGB darunter:;8311000;Freiburg im Breisgau;W;5;0;0;0;0;0;0;1;2;3;0;3;0;0;0;0;0;2;0;0;2
435*00;Wohnungseinbruchdiebstahl § 244 Abs. 1 Nr. 3 StGB darunter:;8311000;Freiburg im Breisgau;X;58;0;0;0;0;0;0;3;7;10;3;13;4;5;9;11;14;7;3;1;45
435*00;Wohnungseinbruchdiebstahl § 244 Abs. 1 Nr. 3 StGB darunter:;9563000;Fürth;M;18;0;0;0;0;1;1;0;0;0;1;2;0;2;2;6;7;1;0;0;16
435*00;Wohnungseinbruchdiebstahl § 244 Abs. 1 Nr. 3 StGB darunter:;9563000;Fürth;W;2;0;0;0;0;0;0;0;1;1;0;1;0;0;0;0;1;0;0;0;1
435*00;Wohnungseinbruchdiebstahl § 244 Abs. 1 Nr. 3 StGB darunter:;9563000;Fürth;X;20;0;0;0;0;1;1;0;1;1;1;3;0;2;2;6;8;1;0;0;17
435*00;Wohnungseinbruchdiebstahl § 244 Abs. 1 Nr. 3 StGB darunter:;5513000;Gelsenkirchen;M;75;0;0;0;0;0;0;1;2;3;9;12;10;5;15;16;18;8;5;1;63
435*00;Wohnungseinbruchdiebstahl § 244 Abs. 1 Nr. 3 StGB darunter:;5513000;Gelsenkirchen;W;16;0;0;0;0;0;0;2;1;3;2;5;1;3;4;0;4;1;1;1;11
435*00;Wohnungseinbruchdiebstahl § 244 Abs. 1 Nr. 3 StGB darunter:;5513000;Gelsenkirchen;X;91;0;0;0;0;0;0;3;3;6;11;17;11;8;19;16;22;9;6;2;74
435*00;Wohnungseinbruchdiebstahl § 244 Abs. 1 Nr. 3 StGB darunter:;3152012;Göttingen;M;45;0;0;0;1;4;5;2;2;4;6;15;4;1;5;9;12;4;0;0;30
435*00;Wohnungseinbruchdiebstahl § 244 Abs. 1 Nr. 3 StGB darunter:;3152012;Göttingen;W;18;0;0;0;1;0;1;0;0;0;1;2;3;3;6;4;4;1;1;0;16
435*00;Wohnungseinbruchdiebstahl § 244 Abs. 1 Nr. 3 StGB darunter:;3152012;Göttingen;X;63;0;0;0;2;4;6;2;2;4;7;17;7;4;11;13;16;5;1;0;46
435*00;Wohnungseinbruchdiebstahl § 244 Abs. 1 Nr. 3 StGB darunter:;5914000;Hagen;M;70;0;0;0;0;2;2;1;5;6;8;16;1;8;9;17;13;11;3;1;54
435*00;Wohnungseinbruchdiebstahl § 244 Abs. 1 Nr. 3 StGB darunter:;5914000;Hagen;W;14;0;0;0;0;2;2;0;0;0;2;4;0;3;3;3;1;0;2;1;10
435*00;Wohnungseinbruchdiebstahl § 244 Abs. 1 Nr. 3 StGB darunter:;5914000;Hagen;X;84;0;0;0;0;4;4;1;5;6;10;20;1;11;12;20;14;11;5;2;64
435*00;Wohnungseinbruchdiebstahl § 244 Abs. 1 Nr. 3 StGB darunter:;15002000;Halle (Saale);M;58;0;0;0;1;0;1;1;4;5;6;12;3;4;7;13;20;4;2;0;46
435*00;Wohnungseinbruchdiebstahl § 244 Abs. 1 Nr. 3 StGB darunter:;15002000;Halle (Saale);W;7;0;0;0;1;0;1;0;0;0;0;1;0;1;1;3;1;1;0;0;6
435*00;Wohnungseinbruchdiebstahl § 244 Abs. 1 Nr. 3 StGB darunter:;15002000;Halle (Saale);X;65;0;0;0;2;0;2;1;4;5;6;13;3;5;8;16;21;5;2;0;52
435*00;Wohnungseinbruchdiebstahl § 244 Abs. 1 Nr. 3 StGB darunter:;2000000;Hamburg;M;441;0;1;1;1;1;4;28;41;69;52;125;31;26;57;76;112;46;20;5;316
435*00;Wohnungseinbruchdiebstahl § 244 Abs. 1 Nr. 3 StGB darunter:;2000000;Hamburg;W;63;0;0;0;0;4;4;5;9;14;10;28;0;4;4;6;12;8;5;0;35
435*00;Wohnungseinbruchdiebstahl § 244 Abs. 1 Nr. 3 StGB darunter:;2000000;Hamburg;X;504;0;1;1;1;5;8;33;50;83;62;153;31;30;61;82;124;54;25;5;351
435*00;Wohnungseinbruchdiebstahl § 244 Abs. 1 Nr. 3 StGB darunter:;5915000;Hamm;M;37;0;0;0;0;0;0;2;0;2;6;8;5;3;8;6;10;4;1;0;29
435*00;Wohnungseinbruchdiebstahl § 244 Abs. 1 Nr. 3 StGB darunter:;5915000;Hamm;W;4;0;0;0;0;0;0;1;0;1;1;2;0;0;0;0;2;0;0;0;2
435*00;Wohnungseinbruchdiebstahl § 244 Abs. 1 Nr. 3 StGB darunter:;5915000;Hamm;X;41;0;0;0;0;0;0;3;0;3;7;10;5;3;8;6;12;4;1;0;31
435*00;Wohnungseinbruchdiebstahl § 244 Abs. 1 Nr. 3 StGB darunter:;3241001;Hannover;M;160;0;0;0;1;2;3;4;9;13;20;36;21;11;32;31;32;20;7;2;124
435*00;Wohnungseinbruchdiebstahl § 244 Abs. 1 Nr. 3 StGB darunter:;3241001;Hannover;W;38;0;0;0;1;0;1;7;7;14;3;18;6;1;7;5;5;1;1;1;20
435*00;Wohnungseinbruchdiebstahl § 244 Abs. 1 Nr. 3 StGB darunter:;3241001;Hannover;X;198;0;0;0;2;2;4;11;16;27;23;54;27;12;39;36;37;21;8;3;144
435*00;Wohnungseinbruchdiebstahl § 244 Abs. 1 Nr. 3 StGB darunter:;8221000;Heidelberg;M;33;0;0;0;0;0;0;5;2;7;5;12;1;0;1;7;11;2;0;0;21
435*00;Wohnungseinbruchdiebstahl § 244 Abs. 1 Nr. 3 StGB darunter:;8221000;Heidelberg;W;16;0;0;0;0;0;0;3;2;5;3;8;3;2;5;2;0;0;1;0;8
435*00;Wohnungseinbruchdiebstahl § 244 Abs. 1 Nr. 3 StGB darunter:;8221000;Heidelberg;X;49;0;0;0;0;0;0;8;4;12;8;20;4;2;6;9;11;2;1;0;29
435*00;Wohnungseinbruchdiebstahl § 244 Abs. 1 Nr. 3 StGB darunter:;8121000;Heilbronn;M;19;0;0;0;0;0;0;0;1;1;1;2;0;6;6;6;3;1;1;0;17
435*00;Wohnungseinbruchdiebstahl § 244 Abs. 1 Nr. 3 StGB darunter:;8121000;Heilbronn;W;2;0;0;0;0;0;0;0;0;0;0;0;0;2;2;0;0;0;0;0;2
435*00;Wohnungseinbruchdiebstahl § 244 Abs. 1 Nr. 3 StGB darunter:;8121000;Heilbronn;X;21;0;0;0;0;0;0;0;1;1;1;2;0;8;8;6;3;1;1;0;19
435*00;Wohnungseinbruchdiebstahl § 244 Abs. 1 Nr. 3 StGB darunter:;5916000;Herne;M;67;0;0;0;0;2;2;2;3;5;8;15;3;4;7;14;18;10;3;0;52
435*00;Wohnungseinbruchdiebstahl § 244 Abs. 1 Nr. 3 StGB darunter:;5916000;Herne;W;16;0;0;0;0;0;0;1;2;3;0;3;1;0;1;1;5;5;1;0;13
435*00;Wohnungseinbruchdiebstahl § 244 Abs. 1 Nr. 3 StGB darunter:;5916000;Herne;X;83;0;0;0;0;2;2;3;5;8;8;18;4;4;8;15;23;15;4;0;65
435*00;Wohnungseinbruchdiebstahl § 244 Abs. 1 Nr. 3 StGB darunter:;9161000;Ingolstadt;M;14;0;0;0;0;0;0;0;0;0;1;1;1;1;2;0;6;5;0;0;13
435*00;Wohnungseinbruchdiebstahl § 244 Abs. 1 Nr. 3 StGB darunter:;9161000;Ingolstadt;W;0;0;0;0;0;0;0;0;0;0;0;0;0;0;0;0;0;0;0;0;0
435*00;Wohnungseinbruchdiebstahl § 244 Abs. 1 Nr. 3 StGB darunter:;9161000;Ingolstadt;X;14;0;0;0;0;0;0;0;0;0;1;1;1;1;2;0;6;5;0;0;13
435*00;Wohnungseinbruchdiebstahl § 244 Abs. 1 Nr. 3 StGB darunter:;16053000;Jena;M;9;0;0;0;0;0;0;0;0;0;0;0;2;1;3;2;2;1;0;1;9
435*00;Wohnungseinbruchdiebstahl § 244 Abs. 1 Nr. 3 StGB darunter:;16053000;Jena;W;0;0;0;0;0;0;0;0;0;0;0;0;0;0;0;0;0;0;0;0;0
435*00;Wohnungseinbruchdiebstahl § 244 Abs. 1 Nr. 3 StGB darunter:;16053000;Jena;X;9;0;0;0;0;0;0;0;0;0;0;0;2;1;3;2;2;1;0;1;9
435*00;Wohnungseinbruchdiebstahl § 244 Abs. 1 Nr. 3 StGB darunter:;8212000;Karlsruhe;M;71;0;0;0;0;0;0;2;5;7;6;13;7;12;19;13;20;5;1;0;58
435*00;Wohnungseinbruchdiebstahl § 244 Abs. 1 Nr. 3 StGB darunter:;8212000;Karlsruhe;W;4;0;0;0;0;0;0;1;1;2;0;2;0;0;0;1;1;0;0;0;2
435*00;Wohnungseinbruchdiebstahl § 244 Abs. 1 Nr. 3 StGB darunter:;8212000;Karlsruhe;X;75;0;0;0;0;0;0;3;6;9;6;15;7;12;19;14;21;5;1;0;60
435*00;Wohnungseinbruchdiebstahl § 244 Abs. 1 Nr. 3 StGB darunter:;6611000;Kassel;M;58;0;0;0;0;0;0;2;2;4;4;8;8;4;12;8;10;16;3;1;50
435*00;Wohnungseinbruchdiebstahl § 244 Abs. 1 Nr. 3 StGB darunter:;6611000;Kassel;W;2;0;0;0;0;0;0;0;0;0;0;0;2;0;2;0;0;0;0;0;2
435*00;Wohnungseinbruchdiebstahl § 244 Abs. 1 Nr. 3 StGB darunter:;6611000;Kassel;X;60;0;0;0;0;0;0;2;2;4;4;8;10;4;14;8;10;16;3;1;52
435*00;Wohnungseinbruchdiebstahl § 244 Abs. 1 Nr. 3 StGB darunter:;1002000;Kiel;M;49;0;0;0;0;0;0;0;2;2;4;6;9;5;14;8;13;5;3;0;43
435*00;Wohnungseinbruchdiebstahl § 244 Abs. 1 Nr. 3 StGB darunter:;1002000;Kiel;W;8;0;0;0;0;0;0;0;0;0;1;1;1;0;1;2;2;1;0;1;7
435*00;Wohnungseinbruchdiebstahl § 244 Abs. 1 Nr. 3 StGB darunter:;1002000;Kiel;X;57;0;0;0;0;0;0;0;2;2;5;7;10;5;15;10;15;6;3;1;50
435*00;Wohnungseinbruchdiebstahl § 244 Abs. 1 Nr. 3 StGB darunter:;7111000;Koblenz;M;12;0;0;0;0;0;0;0;0;0;0;0;3;1;4;3;1;1;2;1;12
435*00;Wohnungseinbruchdiebstahl § 244 Abs. 1 Nr. 3 StGB darunter:;7111000;Koblenz;W;0;0;0;0;0;0;0;0;0;0;0;0;0;0;0;0;0;0;0;0;0
435*00;Wohnungseinbruchdiebstahl § 244 Abs. 1 Nr. 3 StGB darunter:;7111000;Koblenz;X;12;0;0;0;0;0;0;0;0;0;0;0;3;1;4;3;1;1;2;1;12
435*00;Wohnungseinbruchdiebstahl § 244 Abs. 1 Nr. 3 StGB darunter:;5315000;Köln;M;293;0;0;0;0;3;3;14;26;40;38;81;34;21;55;46;72;30;7;2;212
435*00;Wohnungseinbruchdiebstahl § 244 Abs. 1 Nr. 3 StGB darunter:;5315000;Köln;W;72;0;0;0;0;1;1;15;8;23;13;37;2;8;10;11;10;4;0;0;35
435*00;Wohnungseinbruchdiebstahl § 244 Abs. 1 Nr. 3 StGB darunter:;5315000;Köln;X;365;0;0;0;0;4;4;29;34;63;51;118;36;29;65;57;82;34;7;2;247
435*00;Wohnungseinbruchdiebstahl § 244 Abs. 1 Nr. 3 StGB darunter:;5114000;Krefeld;M;121;0;0;0;0;2;2;2;1;3;8;13;16;2;18;31;34;19;5;1;108
435*00;Wohnungseinbruchdiebstahl § 244 Abs. 1 Nr. 3 StGB darunter:;5114000;Krefeld;W;23;0;0;0;0;0;0;0;1;1;2;3;3;1;4;4;6;6;0;0;20
435*00;Wohnungseinbruchdiebstahl § 244 Abs. 1 Nr. 3 StGB darunter:;5114000;Krefeld;X;144;0;0;0;0;2;2;2;2;4;10;16;19;3;22;35;40;25;5;1;128
435*00;Wohnungseinbruchdiebstahl § 244 Abs. 1 Nr. 3 StGB darunter:;14713000;Leipzig;M;204;0;0;0;1;5;6;13;11;24;16;46;12;22;34;48;54;15;6;1;158
435*00;Wohnungseinbruchdiebstahl § 244 Abs. 1 Nr. 3 StGB darunter:;14713000;Leipzig;W;34;0;0;0;0;0;0;3;0;3;2;5;4;3;7;6;9;6;1;0;29
435*00;Wohnungseinbruchdiebstahl § 244 Abs. 1 Nr. 3 StGB darunter:;14713000;Leipzig;X;238;0;0;0;1;5;6;16;11;27;18;51;16;25;41;54;63;21;7;1;187
435*00;Wohnungseinbruchdiebstahl § 244 Abs. 1 Nr. 3 StGB darunter:;5316000;Leverkusen;M;38;0;0;0;0;0;0;0;2;2;6;8;4;1;5;5;12;5;3;0;30
435*00;Wohnungseinbruchdiebstahl § 244 Abs. 1 Nr. 3 StGB darunter:;5316000;Leverkusen;W;17;0;0;0;0;3;3;0;3;3;1;7;0;0;0;5;3;1;0;1;10
435*00;Wohnungseinbruchdiebstahl § 244 Abs. 1 Nr. 3 StGB darunter:;5316000;Leverkusen;X;55;0;0;0;0;3;3;0;5;5;7;15;4;1;5;10;15;6;3;1;40
435*00;Wohnungseinbruchdiebstahl § 244 Abs. 1 Nr. 3 StGB darunter:;1003000;Lübeck;M;62;0;0;0;0;0;0;3;2;5;2;7;7;3;10;22;10;9;2;2;55
435*00;Wohnungseinbruchdiebstahl § 244 Abs. 1 Nr. 3 StGB darunter:;1003000;Lübeck;W;9;0;0;0;0;1;1;2;2;4;1;6;0;0;0;0;1;2;0;0;3
435*00;Wohnungseinbruchdiebstahl § 244 Abs. 1 Nr. 3 StGB darunter:;1003000;Lübeck;X;71;0;0;0;0;1;1;5;4;9;3;13;7;3;10;22;11;11;2;2;58
435*00;Wohnungseinbruchdiebstahl § 244 Abs. 1 Nr. 3 StGB darunter:;7314000;Ludwigshafen am Rhein;M;20;0;0;0;0;0;0;0;0;0;7;7;1;0;1;2;7;1;2;0;13
435*00;Wohnungseinbruchdiebstahl § 244 Abs. 1 Nr. 3 StGB darunter:;7314000;Ludwigshafen am Rhein;W;4;0;0;0;0;0;0;0;1;1;0;1;0;0;0;1;1;1;0;0;3
435*00;Wohnungseinbruchdiebstahl § 244 Abs. 1 Nr. 3 StGB darunter:;7314000;Ludwigshafen am Rhein;X;24;0;0;0;0;0;0;0;1;1;7;8;1;0;1;3;8;2;2;0;16
435*00;Wohnungseinbruchdiebstahl § 244 Abs. 1 Nr. 3 StGB darunter:;15003000;Magdeburg;M;70;0;0;0;0;1;1;3;5;8;11;20;8;5;13;9;12;6;8;2;50
435*00;Wohnungseinbruchdiebstahl § 244 Abs. 1 Nr. 3 StGB darunter:;15003000;Magdeburg;W;8;0;0;0;0;0;0;0;1;1;2;3;2;0;2;0;1;2;0;0;5
435*00;Wohnungseinbruchdiebstahl § 244 Abs. 1 Nr. 3 StGB darunter:;15003000;Magdeburg;X;78;0;0;0;0;1;1;3;6;9;13;23;10;5;15;9;13;8;8;2;55
435*00;Wohnungseinbruchdiebstahl § 244 Abs. 1 Nr. 3 StGB darunter:;7315000;Mainz;M;17;0;0;0;0;0;0;1;4;5;0;5;3;3;6;0;3;2;0;1;12
435*00;Wohnungseinbruchdiebstahl § 244 Abs. 1 Nr. 3 StGB darunter:;7315000;Mainz;W;4;0;0;0;0;0;0;0;0;0;1;1;1;0;1;0;0;2;0;0;3
435*00;Wohnungseinbruchdiebstahl § 244 Abs. 1 Nr. 3 StGB darunter:;7315000;Mainz;X;21;0;0;0;0;0;0;1;4;5;1;6;4;3;7;0;3;4;0;1;15
435*00;Wohnungseinbruchdiebstahl § 244 Abs. 1 Nr. 3 StGB darunter:;8222000;Mannheim;M;74;0;0;0;0;0;0;1;9;10;6;16;9;7;16;14;16;7;4;1;58
435*00;Wohnungseinbruchdiebstahl § 244 Abs. 1 Nr. 3 StGB darunter:;8222000;Mannheim;W;23;0;0;0;0;1;1;2;1;3;3;7;4;2;6;6;2;1;1;0;16
435*00;Wohnungseinbruchdiebstahl § 244 Abs. 1 Nr. 3 StGB darunter:;8222000;Mannheim;X;97;0;0;0;0;1;1;3;10;13;9;23;13;9;22;20;18;8;5;1;74
435*00;Wohnungseinbruchdiebstahl § 244 Abs. 1 Nr. 3 StGB darunter:;5170024;Moers;M;44;0;0;0;0;0;0;1;4;5;6;11;2;5;7;10;10;4;1;1;33
435*00;Wohnungseinbruchdiebstahl § 244 Abs. 1 Nr. 3 StGB darunter:;5170024;Moers;W;5;0;0;0;0;0;0;0;1;1;1;2;2;0;2;0;0;1;0;0;3
435*00;Wohnungseinbruchdiebstahl § 244 Abs. 1 Nr. 3 StGB darunter:;5170024;Moers;X;49;0;0;0;0;0;0;1;5;6;7;13;4;5;9;10;10;5;1;1;36
435*00;Wohnungseinbruchdiebstahl § 244 Abs. 1 Nr. 3 StGB darunter:;5116000;Mönchengladbach;M;63;0;0;0;0;0;0;0;4;4;10;14;8;5;13;18;14;3;1;0;49
435*00;Wohnungseinbruchdiebstahl § 244 Abs. 1 Nr. 3 StGB darunter:;5116000;Mönchengladbach;W;14;0;0;0;0;0;0;3;0;3;1;4;0;0;0;2;2;5;1;0;10
435*00;Wohnungseinbruchdiebstahl § 244 Abs. 1 Nr. 3 StGB darunter:;5116000;Mönchengladbach;X;77;0;0;0;0;0;0;3;4;7;11;18;8;5;13;20;16;8;2;0;59
435*00;Wohnungseinbruchdiebstahl § 244 Abs. 1 Nr. 3 StGB darunter:;5117000;Mülheim an der Ruhr;M;43;0;0;0;0;1;1;1;1;2;4;7;5;3;8;7;12;4;3;2;36
435*00;Wohnungseinbruchdiebstahl § 244 Abs. 1 Nr. 3 StGB darunter:;5117000;Mülheim an der Ruhr;W;11;0;0;0;0;1;1;2;1;3;1;5;0;1;1;3;0;2;0;0;6
435*00;Wohnungseinbruchdiebstahl § 244 Abs. 1 Nr. 3 StGB darunter:;5117000;Mülheim an der Ruhr;X;54;0;0;0;0;2;2;3;2;5;5;12;5;4;9;10;12;6;3;2;42
435*00;Wohnungseinbruchdiebstahl § 244 Abs. 1 Nr. 3 StGB darunter:;9162000;München;M;180;0;0;0;0;1;1;5;10;15;24;40;6;17;23;31;47;24;11;4;140
435*00;Wohnungseinbruchdiebstahl § 244 Abs. 1 Nr. 3 StGB darunter:;9162000;München;W;44;0;0;0;0;2;2;8;4;12;5;19;3;4;7;5;7;5;1;0;25
435*00;Wohnungseinbruchdiebstahl § 244 Abs. 1 Nr. 3 StGB darunter:;9162000;München;X;224;0;0;0;0;3;3;13;14;27;29;59;9;21;30;36;54;29;12;4;165
435*00;Wohnungseinbruchdiebstahl § 244 Abs. 1 Nr. 3 StGB darunter:;5515000;Münster;M;83;0;0;0;0;0;0;2;16;18;9;27;9;6;15;12;18;10;1;0;56
435*00;Wohnungseinbruchdiebstahl § 244 Abs. 1 Nr. 3 StGB darunter:;5515000;Münster;W;17;0;0;0;1;2;3;4;2;6;4;13;0;0;0;0;2;1;1;0;4
435*00;Wohnungseinbruchdiebstahl § 244 Abs. 1 Nr. 3 StGB darunter:;5515000;Münster;X;100;0;0;0;1;2;3;6;18;24;13;40;9;6;15;12;20;11;2;0;60
435*00;Wohnungseinbruchdiebstahl § 244 Abs. 1 Nr. 3 StGB darunter:;5162024;Neuss;M;56;0;0;0;0;0;0;0;5;5;9;14;4;6;10;12;8;5;5;2;42
435*00;Wohnungseinbruchdiebstahl § 244 Abs. 1 Nr. 3 StGB darunter:;5162024;Neuss;W;10;0;0;0;0;1;1;2;2;4;0;5;1;0;1;0;3;1;0;0;5
435*00;Wohnungseinbruchdiebstahl § 244 Abs. 1 Nr. 3 StGB darunter:;5162024;Neuss;X;66;0;0;0;0;1;1;2;7;9;9;19;5;6;11;12;11;6;5;2;47
435*00;Wohnungseinbruchdiebstahl § 244 Abs. 1 Nr. 3 StGB darunter:;9564000;Nürnberg;M;80;0;0;0;0;2;2;0;5;5;3;10;8;5;13;16;33;6;2;0;70
435*00;Wohnungseinbruchdiebstahl § 244 Abs. 1 Nr. 3 StGB darunter:;9564000;Nürnberg;W;6;0;0;0;0;0;0;1;0;1;0;1;0;0;0;0;2;1;2;0;5
435*00;Wohnungseinbruchdiebstahl § 244 Abs. 1 Nr. 3 StGB darunter:;9564000;Nürnberg;X;86;0;0;0;0;2;2;1;5;6;3;11;8;5;13;16;35;7;4;0;75
435*00;Wohnungseinbruchdiebstahl § 244 Abs. 1 Nr. 3 StGB darunter:;5119000;Oberhausen;M;91;0;0;0;0;0;0;1;2;3;13;16;16;7;23;14;15;15;5;3;75
435*00;Wohnungseinbruchdiebstahl § 244 Abs. 1 Nr. 3 StGB darunter:;5119000;Oberhausen;W;17;0;0;0;0;1;1;3;0;3;3;7;2;0;2;3;2;2;1;0;10
435*00;Wohnungseinbruchdiebstahl § 244 Abs. 1 Nr. 3 StGB darunter:;5119000;Oberhausen;X;108;0;0;0;0;1;1;4;2;6;16;23;18;7;25;17;17;17;6;3;85
435*00;Wohnungseinbruchdiebstahl § 244 Abs. 1 Nr. 3 StGB darunter:;6413000;Offenbach am Main;M;58;0;0;0;0;0;0;1;7;8;13;21;4;3;7;12;11;3;3;1;37
435*00;Wohnungseinbruchdiebstahl § 244 Abs. 1 Nr. 3 StGB darunter:;6413000;Offenbach am Main;W;4;0;0;0;0;0;0;1;0;1;0;1;0;1;1;0;1;0;1;0;3
435*00;Wohnungseinbruchdiebstahl § 244 Abs. 1 Nr. 3 StGB darunter:;6413000;Offenbach am Main;X;62;0;0;0;0;0;0;2;7;9;13;22;4;4;8;12;12;3;4;1;40
435*00;Wohnungseinbruchdiebstahl § 244 Abs. 1 Nr. 3 StGB darunter:;3403000;Oldenburg (Oldenburg);M;72;0;0;0;0;0;0;2;1;3;10;13;11;9;20;11;9;10;7;2;59
435*00;Wohnungseinbruchdiebstahl § 244 Abs. 1 Nr. 3 StGB darunter:;3403000;Oldenburg (Oldenburg);W;6;0;0;0;0;1;1;1;1;2;0;3;0;1;1;1;1;0;0;0;3
435*00;Wohnungseinbruchdiebstahl § 244 Abs. 1 Nr. 3 StGB darunter:;3403000;Oldenburg (Oldenburg);X;78;0;0;0;0;1;1;3;2;5;10;16;11;10;21;12;10;10;7;2;62
435*00;Wohnungseinbruchdiebstahl § 244 Abs. 1 Nr. 3 StGB darunter:;3404000;Osnabrück;M;68;0;0;0;1;0;1;6;4;10;7;18;3;5;8;11;11;13;7;0;50
435*00;Wohnungseinbruchdiebstahl § 244 Abs. 1 Nr. 3 StGB darunter:;3404000;Osnabrück;W;16;0;0;0;0;0;0;0;1;1;3;4;1;0;1;1;8;1;1;0;12
435*00;Wohnungseinbruchdiebstahl § 244 Abs. 1 Nr. 3 StGB darunter:;3404000;Osnabrück;X;84;0;0;0;1;0;1;6;5;11;10;22;4;5;9;12;19;14;8;0;62
435*00;Wohnungseinbruchdiebstahl § 244 Abs. 1 Nr. 3 StGB darunter:;5774032;Paderborn;M;40;0;0;0;0;0;0;1;2;3;5;8;4;5;9;8;8;3;1;3;32
435*00;Wohnungseinbruchdiebstahl § 244 Abs. 1 Nr. 3 StGB darunter:;5774032;Paderborn;W;8;0;0;0;0;0;0;0;0;0;1;1;0;0;0;1;5;0;0;1;7
435*00;Wohnungseinbruchdiebstahl § 244 Abs. 1 Nr. 3 StGB darunter:;5774032;Paderborn;X;48;0;0;0;0;0;0;1;2;3;6;9;4;5;9;9;13;3;1;4;39
435*00;Wohnungseinbruchdiebstahl § 244 Abs. 1 Nr. 3 StGB darunter:;8231000;Pforzheim;M;31;0;0;0;0;0;0;0;0;0;3;3;4;4;8;10;5;4;1;0;28
435*00;Wohnungseinbruchdiebstahl § 244 Abs. 1 Nr. 3 StGB darunter:;8231000;Pforzheim;W;3;0;0;0;0;0;0;0;2;2;0;2;0;0;0;0;0;1;0;0;1
435*00;Wohnungseinbruchdiebstahl § 244 Abs. 1 Nr. 3 StGB darunter:;8231000;Pforzheim;X;34;0;0;0;0;0;0;0;2;2;3;5;4;4;8;10;5;5;1;0;29
435*00;Wohnungseinbruchdiebstahl § 244 Abs. 1 Nr. 3 StGB darunter:;12054000;Potsdam;M;24;0;0;0;0;0;0;0;4;4;5;9;3;5;8;0;2;3;2;0;15
435*00;Wohnungseinbruchdiebstahl § 244 Abs. 1 Nr. 3 StGB darunter:;12054000;Potsdam;W;7;0;0;0;0;0;0;0;0;0;0;0;0;0;0;2;3;0;1;1;7
435*00;Wohnungseinbruchdiebstahl § 244 Abs. 1 Nr. 3 StGB darunter:;12054000;Potsdam;X;31;0;0;0;0;0;0;0;4;4;5;9;3;5;8;2;5;3;3;1;22
435*00;Wohnungseinbruchdiebstahl § 244 Abs. 1 Nr. 3 StGB darunter:;5562032;Recklinghausen;M;53;0;0;0;0;1;1;0;2;2;9;12;7;4;11;11;13;4;1;1;41
435*00;Wohnungseinbruchdiebstahl § 244 Abs. 1 Nr. 3 StGB darunter:;5562032;Recklinghausen;W;3;0;0;0;0;0;0;1;0;1;1;2;0;1;1;0;0;0;0;0;1
435*00;Wohnungseinbruchdiebstahl § 244 Abs. 1 Nr. 3 StGB darunter:;5562032;Recklinghausen;X;56;0;0;0;0;1;1;1;2;3;10;14;7;5;12;11;13;4;1;1;42
435*00;Wohnungseinbruchdiebstahl § 244 Abs. 1 Nr. 3 StGB darunter:;9362000;Regensburg;M;18;0;0;0;0;0;0;2;1;3;1;4;2;1;3;2;3;2;3;1;14
435*00;Wohnungseinbruchdiebstahl § 244 Abs. 1 Nr. 3 StGB darunter:;9362000;Regensburg;W;3;0;0;0;0;0;0;0;1;1;0;1;0;0;0;1;0;0;0;1;2
435*00;Wohnungseinbruchdiebstahl § 244 Abs. 1 Nr. 3 StGB darunter:;9362000;Regensburg;X;21;0;0;0;0;0;0;2;2;4;1;5;2;1;3;3;3;2;3;2;16
435*00;Wohnungseinbruchdiebstahl § 244 Abs. 1 Nr. 3 StGB darunter:;5120000;Remscheid;M;22;0;0;0;0;0;0;0;0;0;2;2;4;5;9;6;3;0;2;0;20
435*00;Wohnungseinbruchdiebstahl § 244 Abs. 1 Nr. 3 StGB darunter:;5120000;Remscheid;W;5;0;0;0;0;0;0;0;0;0;2;2;0;0;0;0;3;0;0;0;3
435*00;Wohnungseinbruchdiebstahl § 244 Abs. 1 Nr. 3 StGB darunter:;5120000;Remscheid;X;27;0;0;0;0;0;0;0;0;0;4;4;4;5;9;6;6;0;2;0;23
435*00;Wohnungseinbruchdiebstahl § 244 Abs. 1 Nr. 3 StGB darunter:;8415061;Reutlingen;M;15;0;0;0;0;0;0;2;4;6;2;8;1;1;2;3;1;1;0;0;7
435*00;Wohnungseinbruchdiebstahl § 244 Abs. 1 Nr. 3 StGB darunter:;8415061;Reutlingen;W;3;0;0;0;0;0;0;1;2;3;0;3;0;0;0;0;0;0;0;0;0
435*00;Wohnungseinbruchdiebstahl § 244 Abs. 1 Nr. 3 StGB darunter:;8415061;Reutlingen;X;18;0;0;0;0;0;0;3;6;9;2;11;1;1;2;3;1;1;0;0;7
435*00;Wohnungseinbruchdiebstahl § 244 Abs. 1 Nr. 3 StGB darunter:;13003000;Rostock;M;46;0;0;2;0;1;3;5;2;7;2;12;2;3;5;11;14;2;2;0;34
435*00;Wohnungseinbruchdiebstahl § 244 Abs. 1 Nr. 3 StGB darunter:;13003000;Rostock;W;11;0;0;0;0;1;1;0;0;0;1;2;0;0;0;5;3;0;1;0;9
435*00;Wohnungseinbruchdiebstahl § 244 Abs. 1 Nr. 3 StGB darunter:;13003000;Rostock;X;57;0;0;2;0;2;4;5;2;7;3;14;2;3;5;16;17;2;3;0;43
435*00;Wohnungseinbruchdiebstahl § 244 Abs. 1 Nr. 3 StGB darunter:;10041100;Saarbrücken;M;72;0;0;0;1;5;6;9;4;13;9;28;2;3;5;9;14;9;4;3;44
435*00;Wohnungseinbruchdiebstahl § 244 Abs. 1 Nr. 3 StGB darunter:;10041100;Saarbrücken;W;13;0;0;0;0;2;2;0;0;0;1;3;0;2;2;1;4;2;1;0;10
435*00;Wohnungseinbruchdiebstahl § 244 Abs. 1 Nr. 3 StGB darunter:;10041100;Saarbrücken;X;85;0;0;0;1;7;8;9;4;13;10;31;2;5;7;10;18;11;5;3;54
435*00;Wohnungseinbruchdiebstahl § 244 Abs. 1 Nr. 3 StGB darunter:;5122000;Solingen;M;27;0;0;0;0;0;0;0;2;2;3;5;5;1;6;5;9;2;0;0;22
435*00;Wohnungseinbruchdiebstahl § 244 Abs. 1 Nr. 3 StGB darunter:;5122000;Solingen;W;7;0;0;0;0;2;2;0;0;0;0;2;0;1;1;0;4;0;0;0;5
435*00;Wohnungseinbruchdiebstahl § 244 Abs. 1 Nr. 3 StGB darunter:;5122000;Solingen;X;34;0;0;0;0;2;2;0;2;2;3;7;5;2;7;5;13;2;0;0;27
435*00;Wohnungseinbruchdiebstahl § 244 Abs. 1 Nr. 3 StGB darunter:;8111000;Stuttgart;M;75;0;0;0;0;2;2;2;1;3;6;11;4;10;14;14;20;11;4;1;64
435*00;Wohnungseinbruchdiebstahl § 244 Abs. 1 Nr. 3 StGB darunter:;8111000;Stuttgart;W;13;0;0;0;0;0;0;0;0;0;4;4;0;0;0;2;4;3;0;0;9
435*00;Wohnungseinbruchdiebstahl § 244 Abs. 1 Nr. 3 StGB darunter:;8111000;Stuttgart;X;88;0;0;0;0;2;2;2;1;3;10;15;4;10;14;16;24;14;4;1;73
435*00;Wohnungseinbruchdiebstahl § 244 Abs. 1 Nr. 3 StGB darunter:;7211000;Trier;M;24;0;0;0;0;1;1;0;1;1;5;7;3;4;7;3;2;5;0;0;17
435*00;Wohnungseinbruchdiebstahl § 244 Abs. 1 Nr. 3 StGB darunter:;7211000;Trier;W;2;0;0;0;0;0;0;0;0;0;0;0;0;1;1;0;1;0;0;0;2
435*00;Wohnungseinbruchdiebstahl § 244 Abs. 1 Nr. 3 StGB darunter:;7211000;Trier;X;26;0;0;0;0;1;1;0;1;1;5;7;3;5;8;3;3;5;0;0;19
435*00;Wohnungseinbruchdiebstahl § 244 Abs. 1 Nr. 3 StGB darunter:;8421000;Ulm;M;14;0;0;0;0;0;0;2;0;2;0;2;3;2;5;3;4;0;0;0;12
435*00;Wohnungseinbruchdiebstahl § 244 Abs. 1 Nr. 3 StGB darunter:;8421000;Ulm;W;0;0;0;0;0;0;0;0;0;0;0;0;0;0;0;0;0;0;0;0;0
435*00;Wohnungseinbruchdiebstahl § 244 Abs. 1 Nr. 3 StGB darunter:;8421000;Ulm;X;14;0;0;0;0;0;0;2;0;2;0;2;3;2;5;3;4;0;0;0;12
435*00;Wohnungseinbruchdiebstahl § 244 Abs. 1 Nr. 3 StGB darunter:;6414000;Wiesbaden;M;50;0;0;0;0;0;0;6;3;9;10;19;6;3;9;3;11;6;1;1;31
435*00;Wohnungseinbruchdiebstahl § 244 Abs. 1 Nr. 3 StGB darunter:;6414000;Wiesbaden;W;6;0;0;0;0;1;1;0;1;1;0;2;1;1;2;1;1;0;0;0;4
435*00;Wohnungseinbruchdiebstahl § 244 Abs. 1 Nr. 3 StGB darunter:;6414000;Wiesbaden;X;56;0;0;0;0;1;1;6;4;10;10;21;7;4;11;4;12;6;1;1;35
435*00;Wohnungseinbruchdiebstahl § 244 Abs. 1 Nr. 3 StGB darunter:;3103000;Wolfsburg;M;26;0;0;0;0;0;0;0;3;3;4;7;3;0;3;7;6;2;1;0;19
435*00;Wohnungseinbruchdiebstahl § 244 Abs. 1 Nr. 3 StGB darunter:;3103000;Wolfsburg;W;5;0;0;0;0;0;0;0;2;2;0;2;0;0;0;1;2;0;0;0;3
435*00;Wohnungseinbruchdiebstahl § 244 Abs. 1 Nr. 3 StGB darunter:;3103000;Wolfsburg;X;31;0;0;0;0;0;0;0;5;5;4;9;3;0;3;8;8;2;1;0;22
435*00;Wohnungseinbruchdiebstahl § 244 Abs. 1 Nr. 3 StGB darunter:;5124000;Wuppertal;M;81;0;0;0;0;0;0;4;8;12;14;26;6;8;14;15;17;7;2;0;55
435*00;Wohnungseinbruchdiebstahl § 244 Abs. 1 Nr. 3 StGB darunter:;5124000;Wuppertal;W;17;0;0;0;0;0;0;2;1;3;3;6;2;1;3;1;3;3;1;0;11
435*00;Wohnungseinbruchdiebstahl § 244 Abs. 1 Nr. 3 StGB darunter:;5124000;Wuppertal;X;98;0;0;0;0;0;0;6;9;15;17;32;8;9;17;16;20;10;3;0;66
435*00;Wohnungseinbruchdiebstahl § 244 Abs. 1 Nr. 3 StGB darunter:;9663000;Würzburg;M;16;0;0;0;0;0;0;0;1;1;2;3;1;0;1;4;5;2;0;1;13
435*00;Wohnungseinbruchdiebstahl § 244 Abs. 1 Nr. 3 StGB darunter:;9663000;Würzburg;W;3;0;0;0;0;0;0;0;0;0;0;0;0;1;1;0;0;1;0;1;3
435*00;Wohnungseinbruchdiebstahl § 244 Abs. 1 Nr. 3 StGB darunter:;9663000;Würzburg;X;19;0;0;0;0;0;0;0;1;1;2;3;1;1;2;4;5;3;0;2;16
436*00;Tageswohnungseinbruch;5334002;Aachen;M;28;0;0;0;0;0;0;0;2;2;2;4;0;2;2;7;11;4;0;0;24
436*00;Tageswohnungseinbruch;5334002;Aachen;W;11;0;0;0;0;0;0;2;1;3;3;6;1;1;2;1;1;1;0;0;5
436*00;Tageswohnungseinbruch;5334002;Aachen;X;39;0;0;0;0;0;0;2;3;5;5;10;1;3;4;8;12;5;0;0;29
436*00;Tageswohnungseinbruch;9761000;Augsburg;M;8;0;0;0;0;0;0;0;0;0;0;0;1;0;1;0;6;0;1;0;8
436*00;Tageswohnungseinbruch;9761000;Augsburg;W;2;0;0;0;0;0;0;0;0;0;0;0;0;0;0;0;2;0;0;0;2
436*00;Tageswohnungseinbruch;9761000;Augsburg;X;10;0;0;0;0;0;0;0;0;0;0;0;1;0;1;0;8;0;1;0;10
436*00;Tageswohnungseinbruch;5378004;Bergisch Gladbach;M;10;0;0;0;0;0;0;0;0;0;2;2;0;1;1;2;3;0;1;1;8
436*00;Tageswohnungseinbruch;5378004;Bergisch Gladbach;W;1;0;0;0;0;0;0;0;0;0;0;0;0;0;0;0;1;0;0;0;1
436*00;Tageswohnungseinbruch;5378004;Bergisch Gladbach;X;11;0;0;0;0;0;0;0;0;0;2;2;0;1;1;2;4;0;1;1;9
436*00;Tageswohnungseinbruch;11000000;Berlin;M;374;0;0;0;1;4;5;28;42;70;73;148;32;25;57;59;69;33;6;2;226
436*00;Tageswohnungseinbruch;11000000;Berlin;W;71;0;0;1;0;2;3;5;5;10;17;30;5;6;11;5;13;9;2;1;41
436*00;Tageswohnungseinbruch;11000000;Berlin;X;445;0;0;1;1;6;8;33;47;80;90;178;37;31;68;64;82;42;8;3;267
436*00;Tageswohnungseinbruch;5711000;Bielefeld;M;45;0;0;0;0;0;0;1;3;4;5;9;6;5;11;11;10;2;1;1;36
436*00;Tageswohnungseinbruch;5711000;Bielefeld;W;5;0;0;0;0;0;0;2;0;2;1;3;0;0;0;1;0;0;1;0;2
436*00;Tageswohnungseinbruch;5711000;Bielefeld;X;50;0;0;0;0;0;0;3;3;6;6;12;6;5;11;12;10;2;2;1;38
436*00;Tageswohnungseinbruch;5911000;Bochum;M;50;0;0;0;0;0;0;0;3;3;5;8;5;5;10;9;20;0;3;0;42
436*00;Tageswohnungseinbruch;5911000;Bochum;W;10;0;0;0;1;2;3;0;1;1;2;6;0;1;1;1;2;0;0;0;4
436*00;Tageswohnungseinbruch;5911000;Bochum;X;60;0;0;0;1;2;3;0;4;4;7;14;5;6;11;10;22;0;3;0;46
436*00;Tageswohnungseinbruch;5314000;Bonn;M;49;0;0;0;0;2;2;4;6;10;6;18;3;5;8;4;11;7;1;0;31
436*00;Tageswohnungseinbruch;5314000;Bonn;W;16;0;0;0;1;1;2;3;1;4;4;10;0;1;1;1;3;1;0;0;6
436*00;Tageswohnungseinbruch;5314000;Bonn;X;65;0;0;0;1;3;4;7;7;14;10;28;3;6;9;5;14;8;1;0;37
436*00;Tageswohnungseinbruch;5512000;Bottrop;M;7;0;0;0;0;0;0;0;0;0;0;0;2;0;2;2;2;1;0;0;7
436*00;Tageswohnungseinbruch;5512000;Bottrop;W;3;0;0;0;0;0;0;0;1;1;0;1;0;0;0;1;0;1;0;0;2
436*00;Tageswohnungseinbruch;5512000;Bottrop;X;10;0;0;0;0;0;0;0;1;1;0;1;2;0;2;3;2;2;0;0;9
436*00;Tageswohnungseinbruch;3101000;Braunschweig;M;22;0;0;0;0;0;0;0;0;0;3;3;3;1;4;4;8;1;2;0;19
436*00;Tageswohnungseinbruch;3101000;Braunschweig;W;8;0;0;0;0;0;0;0;1;1;2;3;0;0;0;2;3;0;0;0;5
436*00;Tageswohnungseinbruch;3101000;Braunschweig;X;30;0;0;0;0;0;0;0;1;1;5;6;3;1;4;6;11;1;2;0;24
436*00;Tageswohnungseinbruch;4011000;Bremen;M;84;0;0;0;2;2;4;7;11;18;11;33;5;4;9;17;13;9;0;3;51
436*00;Tageswohnungseinbruch;4011000;Bremen;W;7;0;0;0;0;1;1;0;1;1;1;3;1;1;2;1;0;0;1;0;4
436*00;Tageswohnungseinbruch;4011000;Bremen;X;91;0;0;0;2;3;5;7;12;19;12;36;6;5;11;18;13;9;1;3;55
436*00;Tageswohnungseinbruch;4012000;Bremerhaven;M;32;0;0;0;0;1;1;2;2;4;7;12;5;2;7;9;3;1;0;0;20
436*00;Tageswohnungseinbruch;4012000;Bremerhaven;W;0;0;0;0;0;0;0;0;0;0;0;0;0;0;0;0;0;0;0;0;0
436*00;Tageswohnungseinbruch;4012000;Bremerhaven;X;32;0;0;0;0;1;1;2;2;4;7;12;5;2;7;9;3;1;0;0;20
436*00;Tageswohnungseinbruch;14511000;Chemnitz;M;26;0;0;0;0;0;0;2;2;4;1;5;1;1;2;7;10;1;1;0;21
436*00;Tageswohnungseinbruch;14511000;Chemnitz;W;10;0;0;0;0;0;0;1;2;3;1;4;0;0;0;1;4;0;0;1;6
436*00;Tageswohnungseinbruch;14511000;Chemnitz;X;36;0;0;0;0;0;0;3;4;7;2;9;1;1;2;8;14;1;1;1;27
436*00;Tageswohnungseinbruch;6411000;Darmstadt;M;22;0;0;2;1;0;3;0;2;2;3;8;2;0;2;3;4;3;2;0;14
436*00;Tageswohnungseinbruch;6411000;Darmstadt;W;1;0;0;0;0;0;0;0;0;0;0;0;0;1;1;0;0;0;0;0;1
436*00;Tageswohnungseinbruch;6411000;Darmstadt;X;23;0;0;2;1;0;3;0;2;2;3;8;2;1;3;3;4;3;2;0;15
436*00;Tageswohnungseinbruch;5913000;Dortmund;M;122;0;0;0;1;3;4;4;8;12;20;36;10;10;20;20;31;9;6;0;86
436*00;Tageswohnungseinbruch;5913000;Dortmund;W;34;0;0;0;1;3;4;3;6;9;5;18;2;3;5;5;3;1;2;0;16
436*00;Tageswohnungseinbruch;5913000;Dortmund;X;156;0;0;0;2;6;8;7;14;21;25;54;12;13;25;25;34;10;8;0;102
436*00;Tageswohnungseinbruch;14612000;Dresden;M;41;0;0;0;0;0;0;0;2;2;4;6;2;3;5;8;18;3;1;0;35
436*00;Tageswohnungseinbruch;14612000;Dresden;W;7;0;0;0;0;0;0;0;0;0;2;2;0;0;0;5;0;0;0;0;5
436*00;Tageswohnungseinbruch;14612000;Dresden;X;48;0;0;0;0;0;0;0;2;2;6;8;2;3;5;13;18;3;1;0;40
436*00;Tageswohnungseinbruch;5112000;Duisburg;M;71;0;0;0;0;2;2;3;5;8;6;16;8;3;11;13;19;8;2;2;55
436*00;Tageswohnungseinbruch;5112000;Duisburg;W;22;0;0;0;0;1;1;2;2;4;2;7;1;1;2;5;6;1;1;0;15
436*00;Tageswohnungseinbruch;5112000;Duisburg;X;93;0;0;0;0;3;3;5;7;12;8;23;9;4;13;18;25;9;3;2;70
436*00;Tageswohnungseinbruch;5111000;Düsseldorf;M;121;0;0;0;0;0;0;13;6;19;11;30;12;11;23;19;26;11;9;3;91
436*00;Tageswohnungseinbruch;5111000;Düsseldorf;W;46;0;0;0;0;3;3;11;5;16;8;27;3;4;7;4;5;3;0;0;19
436*00;Tageswohnungseinbruch;5111000;Düsseldorf;X;167;0;0;0;0;3;3;24;11;35;19;57;15;15;30;23;31;14;9;3;110
436*00;Tageswohnungseinbruch;16051000;Erfurt;M;19;0;0;0;0;0;0;0;1;1;1;2;2;0;2;6;8;1;0;0;17
436*00;Tageswohnungseinbruch;16051000;Erfurt;W;3;0;0;0;0;0;0;0;0;0;0;0;1;1;2;0;0;1;0;0;3
436*00;Tageswohnungseinbruch;16051000;Erfurt;X;22;0;0;0;0;0;0;0;1;1;1;2;3;1;4;6;8;2;0;0;20
436*00;Tageswohnungseinbruch;9562000;Erlangen;M;7;0;0;0;0;0;0;1;0;1;0;1;0;1;1;1;3;1;0;0;6
436*00;Tageswohnungseinbruch;9562000;Erlangen;W;0;0;0;0;0;0;0;0;0;0;0;0;0;0;0;0;0;0;0;0;0
436*00;Tageswohnungseinbruch;9562000;Erlangen;X;7;0;0;0;0;0;0;1;0;1;0;1;0;1;1;1;3;1;0;0;6
436*00;Tageswohnungseinbruch;5113000;Essen;M;77;0;0;0;0;0;0;1;2;3;6;9;11;10;21;12;19;10;5;1;68
436*00;Tageswohnungseinbruch;5113000;Essen;W;26;0;0;0;0;2;2;4;0;4;4;10;3;4;7;3;2;4;0;0;16
436*00;Tageswohnungseinbruch;5113000;Essen;X;103;0;0;0;0;2;2;5;2;7;10;19;14;14;28;15;21;14;5;1;84
436*00;Tageswohnungseinbruch;6412000;Frankfurt am Main;M;66;0;0;0;0;0;0;1;2;3;9;12;5;7;12;11;20;8;2;1;54
436*00;Tageswohnungseinbruch;6412000;Frankfurt am Main;W;19;0;0;0;0;1;1;6;0;6;4;11;1;1;2;4;1;0;1;0;8
436*00;Tageswohnungseinbruch;6412000;Frankfurt am Main;X;85;0;0;0;0;1;1;7;2;9;13;23;6;8;14;15;21;8;3;1;62
436*00;Tageswohnungseinbruch;8311000;Freiburg im Breisgau;M;25;0;0;0;0;0;0;0;1;1;1;2;2;3;5;6;6;3;2;1;23
436*00;Tageswohnungseinbruch;8311000;Freiburg im Breisgau;W;3;0;0;0;0;0;0;1;1;2;0;2;0;0;0;0;0;1;0;0;1
436*00;Tageswohnungseinbruch;8311000;Freiburg im Breisgau;X;28;0;0;0;0;0;0;1;2;3;1;4;2;3;5;6;6;4;2;1;24
436*00;Tageswohnungseinbruch;9563000;Fürth;M;8;0;0;0;0;1;1;0;0;0;0;1;0;0;0;1;6;0;0;0;7
436*00;Tageswohnungseinbruch;9563000;Fürth;W;2;0;0;0;0;0;0;0;1;1;0;1;0;0;0;0;1;0;0;0;1
436*00;Tageswohnungseinbruch;9563000;Fürth;X;10;0;0;0;0;1;1;0;1;1;0;2;0;0;0;1;7;0;0;0;8
436*00;Tageswohnungseinbruch;5513000;Gelsenkirchen;M;40;0;0;0;0;0;0;1;2;3;7;10;4;3;7;8;9;4;2;0;30
436*00;Tageswohnungseinbruch;5513000;Gelsenkirchen;W;7;0;0;0;0;0;0;0;1;1;0;1;0;3;3;0;2;1;0;0;6
436*00;Tageswohnungseinbruch;5513000;Gelsenkirchen;X;47;0;0;0;0;0;0;1;3;4;7;11;4;6;10;8;11;5;2;0;36
436*00;Tageswohnungseinbruch;3152012;Göttingen;M;23;0;0;0;1;4;5;1;0;1;3;9;2;0;2;3;7;2;0;0;14
436*00;Tageswohnungseinbruch;3152012;Göttingen;W;11;0;0;0;1;0;1;0;0;0;1;2;2;2;4;2;3;0;0;0;9
436*00;Tageswohnungseinbruch;3152012;Göttingen;X;34;0;0;0;2;4;6;1;0;1;4;11;4;2;6;5;10;2;0;0;23
436*00;Tageswohnungseinbruch;5914000;Hagen;M;25;0;0;0;0;2;2;1;1;2;1;5;0;2;2;11;5;2;0;0;20
436*00;Tageswohnungseinbruch;5914000;Hagen;W;4;0;0;0;0;2;2;0;0;0;1;3;0;1;1;0;0;0;0;0;1
436*00;Tageswohnungseinbruch;5914000;Hagen;X;29;0;0;0;0;4;4;1;1;2;2;8;0;3;3;11;5;2;0;0;21
436*00;Tageswohnungseinbruch;15002000;Halle (Saale);M;33;0;0;0;1;0;1;1;2;3;4;8;1;3;4;7;10;3;1;0;25
436*00;Tageswohnungseinbruch;15002000;Halle (Saale);W;4;0;0;0;1;0;1;0;0;0;0;1;0;1;1;2;0;0;0;0;3
436*00;Tageswohnungseinbruch;15002000;Halle (Saale);X;37;0;0;0;2;0;2;1;2;3;4;9;1;4;5;9;10;3;1;0;28
436*00;Tageswohnungseinbruch;2000000;Hamburg;M;269;0;1;1;1;1;4;18;22;40;27;71;14;15;29;53;73;31;8;4;198
436*00;Tageswohnungseinbruch;2000000;Hamburg;W;34;0;0;0;0;4;4;4;5;9;6;19;0;2;2;3;5;3;2;0;15
436*00;Tageswohnungseinbruch;2000000;Hamburg;X;303;0;1;1;1;5;8;22;27;49;33;90;14;17;31;56;78;34;10;4;213
436*00;Tageswohnungseinbruch;5915000;Hamm;M;10;0;0;0;0;0;0;1;0;1;1;2;1;1;2;3;2;0;1;0;8
436*00;Tageswohnungseinbruch;5915000;Hamm;W;1;0;0;0;0;0;0;1;0;1;0;1;0;0;0;0;0;0;0;0;0
436*00;Tageswohnungseinbruch;5915000;Hamm;X;11;0;0;0;0;0;0;2;0;2;1;3;1;1;2;3;2;0;1;0;8
436*00;Tageswohnungseinbruch;3241001;Hannover;M;91;0;0;0;1;2;3;3;5;8;14;25;13;4;17;22;15;8;3;1;66
436*00;Tageswohnungseinbruch;3241001;Hannover;W;32;0;0;0;1;0;1;7;7;14;3;18;5;0;5;4;3;1;1;0;14
436*00;Tageswohnungseinbruch;3241001;Hannover;X;123;0;0;0;2;2;4;10;12;22;17;43;18;4;22;26;18;9;4;1;80
436*00;Tageswohnungseinbruch;8221000;Heidelberg;M;9;0;0;0;0;0;0;0;0;0;1;1;0;0;0;3;5;0;0;0;8
436*00;Tageswohnungseinbruch;8221000;Heidelberg;W;10;0;0;0;0;0;0;2;1;3;2;5;2;1;3;2;0;0;0;0;5
436*00;Tageswohnungseinbruch;8221000;Heidelberg;X;19;0;0;0;0;0;0;2;1;3;3;6;2;1;3;5;5;0;0;0;13
436*00;Tageswohnungseinbruch;8121000;Heilbronn;M;8;0;0;0;0;0;0;0;0;0;1;1;0;3;3;2;2;0;0;0;7
436*00;Tageswohnungseinbruch;8121000;Heilbronn;W;1;0;0;0;0;0;0;0;0;0;0;0;0;1;1;0;0;0;0;0;1
436*00;Tageswohnungseinbruch;8121000;Heilbronn;X;9;0;0;0;0;0;0;0;0;0;1;1;0;4;4;2;2;0;0;0;8
436*00;Tageswohnungseinbruch;5916000;Herne;M;35;0;0;0;0;0;0;1;2;3;1;4;1;2;3;7;12;6;3;0;31
436*00;Tageswohnungseinbruch;5916000;Herne;W;13;0;0;0;0;0;0;1;2;3;0;3;1;0;1;1;5;3;0;0;10
436*00;Tageswohnungseinbruch;5916000;Herne;X;48;0;0;0;0;0;0;2;4;6;1;7;2;2;4;8;17;9;3;0;41
436*00;Tageswohnungseinbruch;9161000;Ingolstadt;M;8;0;0;0;0;0;0;0;0;0;1;1;1;0;1;0;4;2;0;0;7
436*00;Tageswohnungseinbruch;9161000;Ingolstadt;W;0;0;0;0;0;0;0;0;0;0;0;0;0;0;0;0;0;0;0;0;0
436*00;Tageswohnungseinbruch;9161000;Ingolstadt;X;8;0;0;0;0;0;0;0;0;0;1;1;1;0;1;0;4;2;0;0;7
436*00;Tageswohnungseinbruch;16053000;Jena;M;7;0;0;0;0;0;0;0;0;0;0;0;2;0;2;2;1;1;0;1;7
436*00;Tageswohnungseinbruch;16053000;Jena;W;0;0;0;0;0;0;0;0;0;0;0;0;0;0;0;0;0;0;0;0;0
436*00;Tageswohnungseinbruch;16053000;Jena;X;7;0;0;0;0;0;0;0;0;0;0;0;2;0;2;2;1;1;0;1;7
436*00;Tageswohnungseinbruch;8212000;Karlsruhe;M;40;0;0;0;0;0;0;1;2;3;3;6;4;5;9;10;11;3;1;0;34
436*00;Tageswohnungseinbruch;8212000;Karlsruhe;W;1;0;0;0;0;0;0;0;0;0;0;0;0;0;0;0;1;0;0;0;1
436*00;Tageswohnungseinbruch;8212000;Karlsruhe;X;41;0;0;0;0;0;0;1;2;3;3;6;4;5;9;10;12;3;1;0;35
436*00;Tageswohnungseinbruch;6611000;Kassel;M;19;0;0;0;0;0;0;1;0;1;3;4;2;0;2;3;5;4;1;0;15
436*00;Tageswohnungseinbruch;6611000;Kassel;W;2;0;0;0;0;0;0;0;0;0;0;0;2;0;2;0;0;0;0;0;2
436*00;Tageswohnungseinbruch;6611000;Kassel;X;21;0;0;0;0;0;0;1;0;1;3;4;4;0;4;3;5;4;1;0;17
436*00;Tageswohnungseinbruch;1002000;Kiel;M;22;0;0;0;0;0;0;0;0;0;1;1;5;2;7;4;6;3;1;0;21
436*00;Tageswohnungseinbruch;1002000;Kiel;W;4;0;0;0;0;0;0;0;0;0;1;1;0;0;0;1;1;1;0;0;3
436*00;Tageswohnungseinbruch;1002000;Kiel;X;26;0;0;0;0;0;0;0;0;0;2;2;5;2;7;5;7;4;1;0;24
436*00;Tageswohnungseinbruch;7111000;Koblenz;M;5;0;0;0;0;0;0;0;0;0;0;0;1;1;2;1;0;1;0;1;5
436*00;Tageswohnungseinbruch;7111000;Koblenz;W;0;0;0;0;0;0;0;0;0;0;0;0;0;0;0;0;0;0;0;0;0
436*00;Tageswohnungseinbruch;7111000;Koblenz;X;5;0;0;0;0;0;0;0;0;0;0;0;1;1;2;1;0;1;0;1;5
436*00;Tageswohnungseinbruch;5315000;Köln;M;140;0;0;0;0;1;1;7;14;21;20;42;13;10;23;21;35;14;3;2;98
436*00;Tageswohnungseinbruch;5315000;Köln;W;60;0;0;0;0;1;1;15;6;21;11;33;1;6;7;9;8;3;0;0;27
436*00;Tageswohnungseinbruch;5315000;Köln;X;200;0;0;0;0;2;2;22;20;42;31;75;14;16;30;30;43;17;3;2;125
436*00;Tageswohnungseinbruch;5114000;Krefeld;M;60;0;0;0;0;0;0;0;1;1;6;7;9;0;9;13;18;11;2;0;53
436*00;Tageswohnungseinbruch;5114000;Krefeld;W;13;0;0;0;0;0;0;0;1;1;2;3;1;0;1;3;5;1;0;0;10
436*00;Tageswohnungseinbruch;5114000;Krefeld;X;73;0;0;0;0;0;0;0;2;2;8;10;10;0;10;16;23;12;2;0;63
436*00;Tageswohnungseinbruch;14713000;Leipzig;M;132;0;0;0;1;4;5;11;9;20;10;35;9;13;22;33;27;9;5;1;97
436*00;Tageswohnungseinbruch;14713000;Leipzig;W;17;0;0;0;0;0;0;3;0;3;1;4;2;1;3;0;5;4;1;0;13
436*00;Tageswohnungseinbruch;14713000;Leipzig;X;149;0;0;0;1;4;5;14;9;23;11;39;11;14;25;33;32;13;6;1;110
436*00;Tageswohnungseinbruch;5316000;Leverkusen;M;25;0;0;0;0;0;0;0;2;2;4;6;4;1;5;3;8;2;1;0;19
436*00;Tageswohnungseinbruch;5316000;Leverkusen;W;12;0;0;0;0;3;3;0;3;3;1;7;0;0;0;3;1;0;0;1;5
436*00;Tageswohnungseinbruch;5316000;Leverkusen;X;37;0;0;0;0;3;3;0;5;5;5;13;4;1;5;6;9;2;1;1;24
436*00;Tageswohnungseinbruch;1003000;Lübeck;M;22;0;0;0;0;0;0;0;0;0;0;0;1;0;1;8;6;6;0;1;22
436*00;Tageswohnungseinbruch;1003000;Lübeck;W;5;0;0;0;0;1;1;1;2;3;0;4;0;0;0;0;1;0;0;0;1
436*00;Tageswohnungseinbruch;1003000;Lübeck;X;27;0;0;0;0;1;1;1;2;3;0;4;1;0;1;8;7;6;0;1;23
436*00;Tageswohnungseinbruch;7314000;Ludwigshafen am Rhein;M;9;0;0;0;0;0;0;0;0;0;3;3;1;0;1;2;2;0;1;0;6
436*00;Tageswohnungseinbruch;7314000;Ludwigshafen am Rhein;W;2;0;0;0;0;0;0;0;1;1;0;1;0;0;0;1;0;0;0;0;1
436*00;Tageswohnungseinbruch;7314000;Ludwigshafen am Rhein;X;11;0;0;0;0;0;0;0;1;1;3;4;1;0;1;3;2;0;1;0;7
436*00;Tageswohnungseinbruch;15003000;Magdeburg;M;21;0;0;0;0;1;1;1;3;4;3;8;3;1;4;2;3;2;2;0;13
436*00;Tageswohnungseinbruch;15003000;Magdeburg;W;2;0;0;0;0;0;0;0;0;0;0;0;0;0;0;0;1;1;0;0;2
436*00;Tageswohnungseinbruch;15003000;Magdeburg;X;23;0;0;0;0;1;1;1;3;4;3;8;3;1;4;2;4;3;2;0;15
436*00;Tageswohnungseinbruch;7315000;Mainz;M;9;0;0;0;0;0;0;0;0;0;0;0;3;1;4;0;3;1;0;1;9
436*00;Tageswohnungseinbruch;7315000;Mainz;W;2;0;0;0;0;0;0;0;0;0;1;1;1;0;1;0;0;0;0;0;1
436*00;Tageswohnungseinbruch;7315000;Mainz;X;11;0;0;0;0;0;0;0;0;0;1;1;4;1;5;0;3;1;0;1;10
436*00;Tageswohnungseinbruch;8222000;Mannheim;M;44;0;0;0;0;0;0;0;4;4;5;9;6;6;12;8;10;3;1;1;35
436*00;Tageswohnungseinbruch;8222000;Mannheim;W;10;0;0;0;0;0;0;1;0;1;2;3;2;1;3;2;1;1;0;0;7
436*00;Tageswohnungseinbruch;8222000;Mannheim;X;54;0;0;0;0;0;0;1;4;5;7;12;8;7;15;10;11;4;1;1;42
436*00;Tageswohnungseinbruch;5170024;Moers;M;24;0;0;0;0;0;0;1;3;4;1;5;2;4;6;4;5;3;1;0;19
436*00;Tageswohnungseinbruch;5170024;Moers;W;5;0;0;0;0;0;0;0;1;1;1;2;2;0;2;0;0;1;0;0;3
436*00;Tageswohnungseinbruch;5170024;Moers;X;29;0;0;0;0;0;0;1;4;5;2;7;4;4;8;4;5;4;1;0;22
436*00;Tageswohnungseinbruch;5116000;Mönchengladbach;M;24;0;0;0;0;0;0;0;2;2;3;5;3;3;6;2;9;2;0;0;19
436*00;Tageswohnungseinbruch;5116000;Mönchengladbach;W;5;0;0;0;0;0;0;3;0;3;0;3;0;0;0;0;2;0;0;0;2
436*00;Tageswohnungseinbruch;5116000;Mönchengladbach;X;29;0;0;0;0;0;0;3;2;5;3;8;3;3;6;2;11;2;0;0;21
436*00;Tageswohnungseinbruch;5117000;Mülheim an der Ruhr;M;20;0;0;0;0;1;1;1;0;1;2;4;4;2;6;3;7;0;0;0;16
436*00;Tageswohnungseinbruch;5117000;Mülheim an der Ruhr;W;7;0;0;0;0;1;1;1;1;2;1;4;0;1;1;2;0;0;0;0;3
436*00;Tageswohnungseinbruch;5117000;Mülheim an der Ruhr;X;27;0;0;0;0;2;2;2;1;3;3;8;4;3;7;5;7;0;0;0;19
436*00;Tageswohnungseinbruch;9162000;München;M;104;0;0;0;0;0;0;0;5;5;11;16;3;11;14;16;32;16;8;2;88
436*00;Tageswohnungseinbruch;9162000;München;W;29;0;0;0;0;1;1;6;3;9;5;15;2;2;4;4;4;1;1;0;14
436*00;Tageswohnungseinbruch;9162000;München;X;133;0;0;0;0;1;1;6;8;14;16;31;5;13;18;20;36;17;9;2;102
436*00;Tageswohnungseinbruch;5515000;Münster;M;33;0;0;0;0;0;0;0;10;10;4;14;1;3;4;1;8;6;0;0;19
436*00;Tageswohnungseinbruch;5515000;Münster;W;7;0;0;0;0;0;0;2;1;3;3;6;0;0;0;0;1;0;0;0;1
436*00;Tageswohnungseinbruch;5515000;Münster;X;40;0;0;0;0;0;0;2;11;13;7;20;1;3;4;1;9;6;0;0;20
436*00;Tageswohnungseinbruch;5162024;Neuss;M;33;0;0;0;0;0;0;0;1;1;7;8;3;3;6;8;6;1;3;1;25
436*00;Tageswohnungseinbruch;5162024;Neuss;W;5;0;0;0;0;1;1;1;1;2;0;3;0;0;0;0;2;0;0;0;2
436*00;Tageswohnungseinbruch;5162024;Neuss;X;38;0;0;0;0;1;1;1;2;3;7;11;3;3;6;8;8;1;3;1;27
436*00;Tageswohnungseinbruch;9564000;Nürnberg;M;43;0;0;0;0;2;2;0;3;3;2;7;3;1;4;11;16;3;2;0;36
436*00;Tageswohnungseinbruch;9564000;Nürnberg;W;2;0;0;0;0;0;0;0;0;0;0;0;0;0;0;0;1;1;0;0;2
436*00;Tageswohnungseinbruch;9564000;Nürnberg;X;45;0;0;0;0;2;2;0;3;3;2;7;3;1;4;11;17;4;2;0;38
436*00;Tageswohnungseinbruch;5119000;Oberhausen;M;38;0;0;0;0;0;0;0;1;1;4;5;5;3;8;7;9;7;2;0;33
436*00;Tageswohnungseinbruch;5119000;Oberhausen;W;9;0;0;0;0;1;1;3;0;3;2;6;0;0;0;1;1;1;0;0;3
436*00;Tageswohnungseinbruch;5119000;Oberhausen;X;47;0;0;0;0;1;1;3;1;4;6;11;5;3;8;8;10;8;2;0;36
436*00;Tageswohnungseinbruch;6413000;Offenbach am Main;M;38;0;0;0;0;0;0;0;5;5;9;14;3;1;4;9;7;3;0;1;24
436*00;Tageswohnungseinbruch;6413000;Offenbach am Main;W;3;0;0;0;0;0;0;1;0;1;0;1;0;1;1;0;1;0;0;0;2
436*00;Tageswohnungseinbruch;6413000;Offenbach am Main;X;41;0;0;0;0;0;0;1;5;6;9;15;3;2;5;9;8;3;0;1;26
436*00;Tageswohnungseinbruch;3403000;Oldenburg (Oldenburg);M;25;0;0;0;0;0;0;2;1;3;3;6;4;3;7;2;4;3;2;1;19
436*00;Tageswohnungseinbruch;3403000;Oldenburg (Oldenburg);W;2;0;0;0;0;0;0;1;1;2;0;2;0;0;0;0;0;0;0;0;0
436*00;Tageswohnungseinbruch;3403000;Oldenburg (Oldenburg);X;27;0;0;0;0;0;0;3;2;5;3;8;4;3;7;2;4;3;2;1;19
436*00;Tageswohnungseinbruch;3404000;Osnabrück;M;23;0;0;0;0;0;0;1;2;3;4;7;1;2;3;3;3;5;2;0;16
436*00;Tageswohnungseinbruch;3404000;Osnabrück;W;8;0;0;0;0;0;0;0;0;0;1;1;0;0;0;0;5;1;1;0;7
436*00;Tageswohnungseinbruch;3404000;Osnabrück;X;31;0;0;0;0;0;0;1;2;3;5;8;1;2;3;3;8;6;3;0;23
436*00;Tageswohnungseinbruch;5774032;Paderborn;M;10;0;0;0;0;0;0;1;1;2;2;4;0;1;1;2;2;0;0;1;6
436*00;Tageswohnungseinbruch;5774032;Paderborn;W;0;0;0;0;0;0;0;0;0;0;0;0;0;0;0;0;0;0;0;0;0
436*00;Tageswohnungseinbruch;5774032;Paderborn;X;10;0;0;0;0;0;0;1;1;2;2;4;0;1;1;2;2;0;0;1;6
436*00;Tageswohnungseinbruch;8231000;Pforzheim;M;19;0;0;0;0;0;0;0;0;0;1;1;1;1;2;7;5;3;1;0;18
436*00;Tageswohnungseinbruch;8231000;Pforzheim;W;0;0;0;0;0;0;0;0;0;0;0;0;0;0;0;0;0;0;0;0;0
436*00;Tageswohnungseinbruch;8231000;Pforzheim;X;19;0;0;0;0;0;0;0;0;0;1;1;1;1;2;7;5;3;1;0;18
436*00;Tageswohnungseinbruch;12054000;Potsdam;M;18;0;0;0;0;0;0;0;4;4;4;8;3;4;7;0;1;2;0;0;10
436*00;Tageswohnungseinbruch;12054000;Potsdam;W;5;0;0;0;0;0;0;0;0;0;0;0;0;0;0;2;1;0;1;1;5
436*00;Tageswohnungseinbruch;12054000;Potsdam;X;23;0;0;0;0;0;0;0;4;4;4;8;3;4;7;2;2;2;1;1;15
436*00;Tageswohnungseinbruch;5562032;Recklinghausen;M;26;0;0;0;0;0;0;0;0;0;5;5;5;1;6;9;4;2;0;0;21
436*00;Tageswohnungseinbruch;5562032;Recklinghausen;W;2;0;0;0;0;0;0;1;0;1;1;2;0;0;0;0;0;0;0;0;0
436*00;Tageswohnungseinbruch;5562032;Recklinghausen;X;28;0;0;0;0;0;0;1;0;1;6;7;5;1;6;9;4;2;0;0;21
436*00;Tageswohnungseinbruch;9362000;Regensburg;M;5;0;0;0;0;0;0;1;0;1;0;1;1;0;1;0;1;1;1;0;4
436*00;Tageswohnungseinbruch;9362000;Regensburg;W;1;0;0;0;0;0;0;0;1;1;0;1;0;0;0;0;0;0;0;0;0
436*00;Tageswohnungseinbruch;9362000;Regensburg;X;6;0;0;0;0;0;0;1;1;2;0;2;1;0;1;0;1;1;1;0;4
436*00;Tageswohnungseinbruch;5120000;Remscheid;M;12;0;0;0;0;0;0;0;0;0;2;2;1;2;3;3;2;0;2;0;10
436*00;Tageswohnungseinbruch;5120000;Remscheid;W;2;0;0;0;0;0;0;0;0;0;0;0;0;0;0;0;2;0;0;0;2
436*00;Tageswohnungseinbruch;5120000;Remscheid;X;14;0;0;0;0;0;0;0;0;0;2;2;1;2;3;3;4;0;2;0;12
436*00;Tageswohnungseinbruch;8415061;Reutlingen;M;0;0;0;0;0;0;0;0;0;0;0;0;0;0;0;0;0;0;0;0;0
436*00;Tageswohnungseinbruch;8415061;Reutlingen;W;0;0;0;0;0;0;0;0;0;0;0;0;0;0;0;0;0;0;0;0;0
436*00;Tageswohnungseinbruch;8415061;Reutlingen;X;0;0;0;0;0;0;0;0;0;0;0;0;0;0;0;0;0;0;0;0;0
436*00;Tageswohnungseinbruch;13003000;Rostock;M;21;0;0;2;0;1;3;4;1;5;1;9;1;0;1;5;6;0;0;0;12
436*00;Tageswohnungseinbruch;13003000;Rostock;W;3;0;0;0;0;0;0;0;0;0;1;1;0;0;0;1;1;0;0;0;2
436*00;Tageswohnungseinbruch;13003000;Rostock;X;24;0;0;2;0;1;3;4;1;5;2;10;1;0;1;6;7;0;0;0;14
436*00;Tageswohnungseinbruch;10041100;Saarbrücken;M;30;0;0;0;1;0;1;7;2;9;3;13;0;1;1;4;5;4;1;2;17
436*00;Tageswohnungseinbruch;10041100;Saarbrücken;W;10;0;0;0;0;2;2;0;0;0;1;3;0;2;2;1;2;1;1;0;7
436*00;Tageswohnungseinbruch;10041100;Saarbrücken;X;40;0;0;0;1;2;3;7;2;9;4;16;0;3;3;5;7;5;2;2;24
436*00;Tageswohnungseinbruch;5122000;Solingen;M;6;0;0;0;0;0;0;0;0;0;0;0;3;0;3;1;2;0;0;0;6
436*00;Tageswohnungseinbruch;5122000;Solingen;W;3;0;0;0;0;2;2;0;0;0;0;2;0;1;1;0;0;0;0;0;1
436*00;Tageswohnungseinbruch;5122000;Solingen;X;9;0;0;0;0;2;2;0;0;0;0;2;3;1;4;1;2;0;0;0;7
436*00;Tageswohnungseinbruch;8111000;Stuttgart;M;51;0;0;0;0;2;2;1;0;1;3;6;3;5;8;10;15;10;2;0;45
436*00;Tageswohnungseinbruch;8111000;Stuttgart;W;8;0;0;0;0;0;0;0;0;0;3;3;0;0;0;2;2;1;0;0;5
436*00;Tageswohnungseinbruch;8111000;Stuttgart;X;59;0;0;0;0;2;2;1;0;1;6;9;3;5;8;12;17;11;2;0;50
436*00;Tageswohnungseinbruch;7211000;Trier;M;15;0;0;0;0;1;1;0;1;1;5;7;0;2;2;1;1;4;0;0;8
436*00;Tageswohnungseinbruch;7211000;Trier;W;2;0;0;0;0;0;0;0;0;0;0;0;0;1;1;0;1;0;0;0;2
436*00;Tageswohnungseinbruch;7211000;Trier;X;17;0;0;0;0;1;1;0;1;1;5;7;0;3;3;1;2;4;0;0;10
436*00;Tageswohnungseinbruch;8421000;Ulm;M;7;0;0;0;0;0;0;2;0;2;0;2;1;1;2;1;2;0;0;0;5
436*00;Tageswohnungseinbruch;8421000;Ulm;W;0;0;0;0;0;0;0;0;0;0;0;0;0;0;0;0;0;0;0;0;0
436*00;Tageswohnungseinbruch;8421000;Ulm;X;7;0;0;0;0;0;0;2;0;2;0;2;1;1;2;1;2;0;0;0;5
436*00;Tageswohnungseinbruch;6414000;Wiesbaden;M;25;0;0;0;0;0;0;2;1;3;1;4;5;2;7;1;8;3;1;1;21
436*00;Tageswohnungseinbruch;6414000;Wiesbaden;W;5;0;0;0;0;1;1;0;1;1;0;2;1;1;2;1;0;0;0;0;3
436*00;Tageswohnungseinbruch;6414000;Wiesbaden;X;30;0;0;0;0;1;1;2;2;4;1;6;6;3;9;2;8;3;1;1;24
436*00;Tageswohnungseinbruch;3103000;Wolfsburg;M;14;0;0;0;0;0;0;0;2;2;4;6;2;0;2;2;3;1;0;0;8
436*00;Tageswohnungseinbruch;3103000;Wolfsburg;W;1;0;0;0;0;0;0;0;0;0;0;0;0;0;0;1;0;0;0;0;1
436*00;Tageswohnungseinbruch;3103000;Wolfsburg;X;15;0;0;0;0;0;0;0;2;2;4;6;2;0;2;3;3;1;0;0;9
436*00;Tageswohnungseinbruch;5124000;Wuppertal;M;25;0;0;0;0;0;0;3;2;5;2;7;2;3;5;4;7;2;0;0;18
436*00;Tageswohnungseinbruch;5124000;Wuppertal;W;9;0;0;0;0;0;0;2;1;3;1;4;2;1;3;0;1;1;0;0;5
436*00;Tageswohnungseinbruch;5124000;Wuppertal;X;34;0;0;0;0;0;0;5;3;8;3;11;4;4;8;4;8;3;0;0;23
436*00;Tageswohnungseinbruch;9663000;Würzburg;M;11;0;0;0;0;0;0;0;1;1;2;3;0;0;0;4;3;1;0;0;8
436*00;Tageswohnungseinbruch;9663000;Würzburg;W;2;0;0;0;0;0;0;0;0;0;0;0;0;1;1;0;0;1;0;0;2
436*00;Tageswohnungseinbruch;9663000;Würzburg;X;13;0;0;0;0;0;0;0;1;1;2;3;0;1;1;4;3;2;0;0;10
****00;Diebstahl insgesamt und zwar:;5334002;Aachen;M;1598;0;1;5;29;36;71;117;131;248;164;483;89;89;178;206;317;200;141;73;1115
****00;Diebstahl insgesamt und zwar:;5334002;Aachen;W;649;0;0;2;5;20;27;63;57;120;63;210;32;34;66;62;89;89;72;61;439
****00;Diebstahl insgesamt und zwar:;5334002;Aachen;X;2247;0;1;7;34;56;98;180;188;368;227;693;121;123;244;268;406;289;213;134;1554
****00;Diebstahl insgesamt und zwar:;9761000;Augsburg;M;1410;0;4;13;21;51;89;102;92;194;118;401;74;74;148;197;291;171;110;92;1009
****00;Diebstahl insgesamt und zwar:;9761000;Augsburg;W;692;0;1;1;10;47;59;71;46;117;54;230;26;32;58;61;99;82;77;85;462
****00;Diebstahl insgesamt und zwar:;9761000;Augsburg;X;2102;0;5;14;31;98;148;173;138;311;172;631;100;106;206;258;390;253;187;177;1471
****00;Diebstahl insgesamt und zwar:;5378004;Bergisch Gladbach;M;512;0;0;0;5;13;18;18;28;46;63;127;26;21;47;77;107;74;36;44;385
****00;Diebstahl insgesamt und zwar:;5378004;Bergisch Gladbach;W;201;0;0;0;0;4;4;19;17;36;15;55;12;13;25;12;36;27;25;21;146
****00;Diebstahl insgesamt und zwar:;5378004;Bergisch Gladbach;X;713;0;0;0;5;17;22;37;45;82;78;182;38;34;72;89;143;101;61;65;531
****00;Diebstahl insgesamt und zwar:;11000000;Berlin;M;21825;7;31;155;276;576;1045;972;1153;2125;2000;5170;1263;1309;2572;3066;4647;2958;1816;1596;16655
****00;Diebstahl insgesamt und zwar:;11000000;Berlin;W;9384;6;27;62;150;505;750;882;619;1501;741;2992;430;474;904;1025;1432;1033;860;1138;6392
****00;Diebstahl insgesamt und zwar:;11000000;Berlin;X;31209;13;58;217;426;1081;1795;1854;1772;3626;2741;8162;1693;1783;3476;4091;6079;3991;2676;2734;23047
****00;Diebstahl insgesamt und zwar:;5711000;Bielefeld;M;1971;0;0;10;24;38;72;75;151;226;174;472;116;137;253;292;444;248;136;126;1499
****00;Diebstahl insgesamt und zwar:;5711000;Bielefeld;W;744;0;0;7;4;22;33;90;76;166;64;263;34;37;71;67;104;94;75;70;481
****00;Diebstahl insgesamt und zwar:;5711000;Bielefeld;X;2715;0;0;17;28;60;105;165;227;392;238;735;150;174;324;359;548;342;211;196;1980
****00;Diebstahl insgesamt und zwar:;5911000;Bochum;M;2123;0;5;12;26;57;100;83;129;212;181;493;137;142;279;280;480;284;173;134;1630
****00;Diebstahl insgesamt und zwar:;5911000;Bochum;W;944;3;2;5;11;38;59;64;67;131;80;270;41;59;100;91;161;114;89;119;674
****00;Diebstahl insgesamt und zwar:;5911000;Bochum;X;3067;3;7;17;37;95;159;147;196;343;261;763;178;201;379;371;641;398;262;253;2304
****00;Diebstahl insgesamt und zwar:;5314000;Bonn;M;1797;0;4;8;21;72;105;120;138;258;166;529;104;83;187;204;404;249;139;85;1268
****00;Diebstahl insgesamt und zwar:;5314000;Bonn;W;769;0;0;0;6;44;50;108;75;183;55;288;25;33;58;77;120;88;65;73;481
****00;Diebstahl insgesamt und zwar:;5314000;Bonn;X;2566;0;4;8;27;116;155;228;213;441;221;817;129;116;245;281;524;337;204;158;1749
****00;Diebstahl insgesamt und zwar:;5512000;Bottrop;M;511;0;1;6;6;16;29;25;19;44;42;115;28;33;61;81;123;70;36;25;396
****00;Diebstahl insgesamt und zwar:;5512000;Bottrop;W;260;0;1;2;2;20;25;31;12;43;21;89;11;10;21;18;46;30;29;27;171
****00;Diebstahl insgesamt und zwar:;5512000;Bottrop;X;771;0;2;8;8;36;54;56;31;87;63;204;39;43;82;99;169;100;65;52;567
****00;Diebstahl insgesamt und zwar:;3101000;Braunschweig;M;1816;0;0;2;15;30;47;60;87;147;223;417;130;141;271;303;397;200;129;99;1399
****00;Diebstahl insgesamt und zwar:;3101000;Braunschweig;W;575;0;0;2;8;39;49;62;61;123;42;214;23;28;51;47;79;57;60;67;361
****00;Diebstahl insgesamt und zwar:;3101000;Braunschweig;X;2391;0;0;4;23;69;96;122;148;270;265;631;153;169;322;350;476;257;189;166;1760
****00;Diebstahl insgesamt und zwar:;4011000;Bremen;M;3272;2;7;22;41;74;146;181;280;461;348;955;201;187;388;423;694;431;235;146;2317
****00;Diebstahl insgesamt und zwar:;4011000;Bremen;W;1464;4;3;5;13;80;105;183;167;350;123;578;79;73;152;147;199;178;109;101;886
****00;Diebstahl insgesamt und zwar:;4011000;Bremen;X;4736;6;10;27;54;154;251;364;447;811;471;1533;280;260;540;570;893;609;344;247;3203
****00;Diebstahl insgesamt und zwar:;4012000;Bremerhaven;M;909;0;4;8;13;15;40;37;46;83;87;210;55;50;105;143;187;130;73;61;699
****00;Diebstahl insgesamt und zwar:;4012000;Bremerhaven;W;341;0;1;4;2;16;23;21;12;33;29;85;24;15;39;34;50;47;50;36;256
****00;Diebstahl insgesamt und zwar:;4012000;Bremerhaven;X;1250;0;5;12;15;31;63;58;58;116;116;295;79;65;144;177;237;177;123;97;955
****00;Diebstahl insgesamt und zwar:;14511000;Chemnitz;M;1795;1;7;4;20;32;64;64;45;109;151;324;128;131;259;383;434;174;104;117;1471
****00;Diebstahl insgesamt und zwar:;14511000;Chemnitz;W;495;0;1;3;7;33;44;41;39;80;40;164;15;24;39;46;75;46;44;81;331
****00;Diebstahl insgesamt und zwar:;14511000;Chemnitz;X;2290;1;8;7;27;65;108;105;84;189;191;488;143;155;298;429;509;220;148;198;1802
****00;Diebstahl insgesamt und zwar:;6411000;Darmstadt;M;1025;0;2;7;6;20;35;71;87;158;109;302;56;53;109;101;225;154;76;58;723
****00;Diebstahl insgesamt und zwar:;6411000;Darmstadt;W;516;0;1;0;3;30;34;66;55;121;56;211;18;25;43;51;70;48;41;52;305
****00;Diebstahl insgesamt und zwar:;6411000;Darmstadt;X;1541;0;3;7;9;50;69;137;142;279;165;513;74;78;152;152;295;202;117;110;1028
****00;Diebstahl insgesamt und zwar:;5913000;Dortmund;M;4983;2;4;29;69;132;236;237;388;625;645;1506;330;295;625;668;1013;609;321;241;3477
****00;Diebstahl insgesamt und zwar:;5913000;Dortmund;W;2095;1;4;12;36;109;162;252;219;471;190;823;110;106;216;225;290;236;135;170;1272
****00;Diebstahl insgesamt und zwar:;5913000;Dortmund;X;7078;3;8;41;105;241;398;489;607;1096;835;2329;440;401;841;893;1303;845;456;411;4749
****00;Diebstahl insgesamt und zwar:;14612000;Dresden;M;3433;0;11;19;35;65;130;102;121;223;240;593;185;243;428;629;918;380;220;265;2840
****00;Diebstahl insgesamt und zwar:;14612000;Dresden;W;1236;0;2;10;18;52;82;98;73;171;70;323;48;62;110;165;179;98;109;252;913
****00;Diebstahl insgesamt und zwar:;14612000;Dresden;X;4669;0;13;29;53;117;212;200;194;394;310;916;233;305;538;794;1097;478;329;517;3753
****00;Diebstahl insgesamt und zwar:;5112000;Duisburg;M;2932;2;14;37;65;111;229;168;161;329;237;795;181;155;336;382;614;404;237;164;2137
****00;Diebstahl insgesamt und zwar:;5112000;Duisburg;W;1210;4;6;18;30;58;116;85;77;162;104;382;70;50;120;139;207;148;100;114;828
****00;Diebstahl insgesamt und zwar:;5112000;Duisburg;X;4142;6;20;55;95;169;345;253;238;491;341;1177;251;205;456;521;821;552;337;278;2965
****00;Diebstahl insgesamt und zwar:;5111000;Düsseldorf;M;4376;1;4;10;33;85;133;174;240;414;423;970;269;291;560;604;989;616;347;290;3406
****00;Diebstahl insgesamt und zwar:;5111000;Düsseldorf;W;1848;0;1;6;21;102;130;213;179;392;157;679;73;83;156;183;283;217;151;179;1169
****00;Diebstahl insgesamt und zwar:;5111000;Düsseldorf;X;6224;1;5;16;54;187;263;387;419;806;580;1649;342;374;716;787;1272;833;498;469;4575
****00;Diebstahl insgesamt und zwar:;16051000;Erfurt;M;1430;1;2;13;35;35;86;64;67;131;93;310;73;84;157;191;327;168;127;150;1120
****00;Diebstahl insgesamt und zwar:;16051000;Erfurt;W;645;1;4;10;20;28;63;59;45;104;36;203;33;21;54;73;93;46;65;111;442
****00;Diebstahl insgesamt und zwar:;16051000;Erfurt;X;2075;2;6;23;55;63;149;123;112;235;129;513;106;105;211;264;420;214;192;261;1562
****00;Diebstahl insgesamt und zwar:;9562000;Erlangen;M;662;0;1;2;7;15;25;43;43;86;92;203;50;53;103;87;129;79;40;21;459
****00;Diebstahl insgesamt und zwar:;9562000;Erlangen;W;260;0;0;1;3;21;25;38;29;67;12;104;10;12;22;27;39;24;24;20;156
****00;Diebstahl insgesamt und zwar:;9562000;Erlangen;X;922;0;1;3;10;36;50;81;72;153;104;307;60;65;125;114;168;103;64;41;615
****00;Diebstahl insgesamt und zwar:;5113000;Essen;M;3506;1;2;8;43;120;174;202;245;447;334;955;223;225;448;442;717;513;256;175;2551
****00;Diebstahl insgesamt und zwar:;5113000;Essen;W;1712;1;0;5;18;108;132;246;201;447;152;731;61;61;122;152;268;170;129;140;981
****00;Diebstahl insgesamt und zwar:;5113000;Essen;X;5218;2;2;13;61;228;306;448;446;894;486;1686;284;286;570;594;985;683;385;315;3532
****00;Diebstahl insgesamt und zwar:;6412000;Frankfurt am Main;M;5202;4;2;7;29;61;103;176;286;462;506;1071;292;288;580;737;1320;791;413;290;4131
****00;Diebstahl insgesamt und zwar:;6412000;Frankfurt am Main;W;2133;3;1;5;16;99;124;260;191;451;204;779;114;103;217;201;363;256;148;169;1354
****00;Diebstahl insgesamt und zwar:;6412000;Frankfurt am Main;X;7335;7;3;12;45;160;227;436;477;913;710;1850;406;391;797;938;1683;1047;561;459;5485
****00;Diebstahl insgesamt und zwar:;8311000;Freiburg im Breisgau;M;1577;1;3;7;21;49;81;102;167;269;179;529;102;95;197;181;279;184;117;90;1048
****00;Diebstahl insgesamt und zwar:;8311000;Freiburg im Breisgau;W;774;0;3;8;18;50;79;117;90;207;75;361;39;27;66;57;85;69;65;71;413
****00;Diebstahl insgesamt und zwar:;8311000;Freiburg im Breisgau;X;2351;1;6;15;39;99;160;219;257;476;254;890;141;122;263;238;364;253;182;161;1461
****00;Diebstahl insgesamt und zwar:;9563000;Fürth;M;677;0;1;5;14;31;51;27;25;52;64;167;36;43;79;109;149;101;42;30;510
****00;Diebstahl insgesamt und zwar:;9563000;Fürth;W;279;0;1;2;4;9;16;19;23;42;23;81;11;12;23;22;42;40;28;43;198
****00;Diebstahl insgesamt und zwar:;9563000;Fürth;X;956;0;2;7;18;40;67;46;48;94;87;248;47;55;102;131;191;141;70;73;708
****00;Diebstahl insgesamt und zwar:;5513000;Gelsenkirchen;M;1800;4;1;18;45;87;155;99;107;206;163;524;111;109;220;244;362;240;113;97;1276
****00;Diebstahl insgesamt und zwar:;5513000;Gelsenkirchen;W;1018;0;5;8;21;59;93;77;77;154;112;359;54;65;119;114;157;109;81;79;659
****00;Diebstahl insgesamt und zwar:;5513000;Gelsenkirchen;X;2818;4;6;26;66;146;248;176;184;360;275;883;165;174;339;358;519;349;194;176;1935
****00;Diebstahl insgesamt und zwar:;3152012;Göttingen;M;927;0;3;8;11;29;51;41;48;89;94;234;74;52;126;133;189;117;57;71;693
****00;Diebstahl insgesamt und zwar:;3152012;Göttingen;W;430;0;2;4;8;24;38;46;24;70;36;144;22;23;45;39;62;46;44;50;286
****00;Diebstahl insgesamt und zwar:;3152012;Göttingen;X;1357;0;5;12;19;53;89;87;72;159;130;378;96;75;171;172;251;163;101;121;979
****00;Diebstahl insgesamt und zwar:;5914000;Hagen;M;1342;0;4;6;17;55;82;71;64;135;120;337;76;68;144;180;311;187;103;80;1005
****00;Diebstahl insgesamt und zwar:;5914000;Hagen;W;565;0;1;0;6;18;25;63;55;118;42;185;26;39;65;56;88;61;53;57;380
****00;Diebstahl insgesamt und zwar:;5914000;Hagen;X;1907;0;5;6;23;73;107;134;119;253;162;522;102;107;209;236;399;248;156;137;1385
****00;Diebstahl insgesamt und zwar:;15002000;Halle (Saale);M;1612;1;8;16;29;63;117;70;72;142;93;352;75;98;173;271;353;176;152;135;1260
****00;Diebstahl insgesamt und zwar:;15002000;Halle (Saale);W;599;0;4;6;17;36;63;47;49;96;34;193;17;22;39;75;80;54;62;96;406
****00;Diebstahl insgesamt und zwar:;15002000;Halle (Saale);X;2211;1;12;22;46;99;180;117;121;238;127;545;92;120;212;346;433;230;214;231;1666
****00;Diebstahl insgesamt und zwar:;2000000;Hamburg;M;12412;1;16;65;142;302;526;623;891;1514;1133;3173;662;665;1327;1643;2584;1883;1010;792;9239
****00;Diebstahl insgesamt und zwar:;2000000;Hamburg;W;4938;2;11;25;58;268;364;474;311;785;341;1490;214;272;486;477;795;641;503;546;3448
****00;Diebstahl insgesamt und zwar:;2000000;Hamburg;X;17350;3;27;90;200;570;890;1097;1202;2299;1474;4663;876;937;1813;2120;3379;2524;1513;1338;12687
****00;Diebstahl insgesamt und zwar:;5915000;Hamm;M;920;1;2;3;6;21;33;52;56;108;100;241;43;61;104;114;202;138;71;50;679
****00;Diebstahl insgesamt und zwar:;5915000;Hamm;W;384;0;0;1;8;28;37;33;36;69;41;147;27;22;49;30;54;46;29;29;237
****00;Diebstahl insgesamt und zwar:;5915000;Hamm;X;1304;1;2;4;14;49;70;85;92;177;141;388;70;83;153;144;256;184;100;79;916
****00;Diebstahl insgesamt und zwar:;3241001;Hannover;M;4476;2;9;28;36;81;156;176;231;407;466;1029;311;275;586;616;972;650;351;272;3447
****00;Diebstahl insgesamt und zwar:;3241001;Hannover;W;2114;2;5;6;19;117;149;268;211;479;176;804;109;96;205;193;277;245;178;212;1310
****00;Diebstahl insgesamt und zwar:;3241001;Hannover;X;6590;4;14;34;55;198;305;444;442;886;642;1833;420;371;791;809;1249;895;529;484;4757
****00;Diebstahl insgesamt und zwar:;8221000;Heidelberg;M;1006;0;2;3;3;33;41;65;63;128;90;259;54;62;116;128;218;130;84;71;747
****00;Diebstahl insgesamt und zwar:;8221000;Heidelberg;W;557;0;0;3;7;32;42;92;41;133;65;240;23;20;43;49;67;58;42;58;317
****00;Diebstahl insgesamt und zwar:;8221000;Heidelberg;X;1563;0;2;6;10;65;83;157;104;261;155;499;77;82;159;177;285;188;126;129;1064
****00;Diebstahl insgesamt und zwar:;8121000;Heilbronn;M;694;1;0;5;10;13;29;50;40;90;52;171;37;37;74;104;144;95;50;56;523
****00;Diebstahl insgesamt und zwar:;8121000;Heilbronn;W;329;0;2;0;4;20;26;62;31;93;17;136;12;25;37;36;47;24;18;31;193
****00;Diebstahl insgesamt und zwar:;8121000;Heilbronn;X;1023;1;2;5;14;33;55;112;71;183;69;307;49;62;111;140;191;119;68;87;716
****00;Diebstahl insgesamt und zwar:;5916000;Herne;M;953;0;2;8;17;43;70;53;72;125;91;286;67;49;116;133;193;111;69;45;667
****00;Diebstahl insgesamt und zwar:;5916000;Herne;W;394;1;1;0;5;22;29;33;29;62;29;120;26;22;48;34;60;60;34;38;274
****00;Diebstahl insgesamt und zwar:;5916000;Herne;X;1347;1;3;8;22;65;99;86;101;187;120;406;93;71;164;167;253;171;103;83;941
****00;Diebstahl insgesamt und zwar:;9161000;Ingolstadt;M;554;0;0;2;10;19;31;38;35;73;41;145;30;33;63;71;115;85;39;36;409
****00;Diebstahl insgesamt und zwar:;9161000;Ingolstadt;W;317;0;0;0;1;13;14;49;25;74;17;105;13;18;31;24;34;44;36;43;212
****00;Diebstahl insgesamt und zwar:;9161000;Ingolstadt;X;871;0;0;2;11;32;45;87;60;147;58;250;43;51;94;95;149;129;75;79;621
****00;Diebstahl insgesamt und zwar:;16053000;Jena;M;444;0;1;4;8;7;20;14;16;30;45;95;24;40;64;65;102;47;32;39;349
****00;Diebstahl insgesamt und zwar:;16053000;Jena;W;194;0;2;1;2;11;16;9;6;15;18;49;8;17;25;19;30;16;17;38;145
****00;Diebstahl insgesamt und zwar:;16053000;Jena;X;638;0;3;5;10;18;36;23;22;45;63;144;32;57;89;84;132;63;49;77;494
****00;Diebstahl insgesamt und zwar:;8212000;Karlsruhe;M;2175;0;1;9;11;52;73;95;174;269;228;570;171;174;345;358;440;213;134;115;1605
****00;Diebstahl insgesamt und zwar:;8212000;Karlsruhe;W;855;1;0;11;9;34;55;113;85;198;72;325;34;36;70;70;127;101;72;90;530
****00;Diebstahl insgesamt und zwar:;8212000;Karlsruhe;X;3030;1;1;20;20;86;128;208;259;467;300;895;205;210;415;428;567;314;206;205;2135
****00;Diebstahl insgesamt und zwar:;6611000;Kassel;M;1404;0;3;5;9;22;39;62;79;141;118;298;104;71;175;184;296;203;133;115;1106
****00;Diebstahl insgesamt und zwar:;6611000;Kassel;W;610;0;0;0;5;23;28;69;54;123;54;205;24;23;47;64;101;79;49;65;405
****00;Diebstahl insgesamt und zwar:;6611000;Kassel;X;2014;0;3;5;14;45;67;131;133;264;172;503;128;94;222;248;397;282;182;180;1511
****00;Diebstahl insgesamt und zwar:;1002000;Kiel;M;1380;0;9;13;20;34;76;76;81;157;116;349;90;62;152;181;282;214;124;78;1031
****00;Diebstahl insgesamt und zwar:;1002000;Kiel;W;595;1;0;4;9;22;36;59;50;109;52;197;32;23;55;50;104;75;44;70;398
****00;Diebstahl insgesamt und zwar:;1002000;Kiel;X;1975;1;9;17;29;56;112;135;131;266;168;546;122;85;207;231;386;289;168;148;1429
****00;Diebstahl insgesamt und zwar:;7111000;Koblenz;M;648;0;0;1;10;17;28;35;50;85;64;177;42;28;70;86;138;80;63;34;471
****00;Diebstahl insgesamt und zwar:;7111000;Koblenz;W;355;0;0;0;10;20;30;44;28;72;29;131;20;11;31;35;51;47;30;30;224
****00;Diebstahl insgesamt und zwar:;7111000;Koblenz;X;1003;0;0;1;20;37;58;79;78;157;93;308;62;39;101;121;189;127;93;64;695
****00;Diebstahl insgesamt und zwar:;5315000;Köln;M;7386;3;8;33;56;203;303;400;588;988;783;2074;458;453;911;983;1571;974;495;378;5312
****00;Diebstahl insgesamt und zwar:;5315000;Köln;W;3050;1;8;17;46;157;229;360;302;662;251;1142;131;159;290;309;443;324;249;293;1908
****00;Diebstahl insgesamt und zwar:;5315000;Köln;X;10436;4;16;50;102;360;532;760;890;1650;1034;3216;589;612;1201;1292;2014;1298;744;671;7220
****00;Diebstahl insgesamt und zwar:;5114000;Krefeld;M;1329;0;3;7;12;43;65;65;70;135;124;324;81;88;169;210;301;186;69;70;1005
****00;Diebstahl insgesamt und zwar:;5114000;Krefeld;W;578;0;0;2;11;32;45;64;47;111;41;197;36;29;65;54;95;62;57;48;381
****00;Diebstahl insgesamt und zwar:;5114000;Krefeld;X;1907;0;3;9;23;75;110;129;117;246;165;521;117;117;234;264;396;248;126;118;1386
****00;Diebstahl insgesamt und zwar:;14713000;Leipzig;M;4457;1;5;10;45;87;148;148;159;307;334;789;256;348;604;800;1108;517;302;337;3668
****00;Diebstahl insgesamt und zwar:;14713000;Leipzig;W;1604;1;2;10;26;62;101;131;77;208;92;401;85;97;182;210;236;137;175;263;1203
****00;Diebstahl insgesamt und zwar:;14713000;Leipzig;X;6061;2;7;20;71;149;249;279;236;515;426;1190;341;445;786;1010;1344;654;477;600;4871
****00;Diebstahl insgesamt und zwar:;5316000;Leverkusen;M;728;1;4;4;11;23;43;39;36;75;84;202;48;34;82;95;140;96;63;50;526
****00;Diebstahl insgesamt und zwar:;5316000;Leverkusen;W;311;1;2;2;13;14;32;27;21;48;20;100;12;16;28;28;43;36;37;39;211
****00;Diebstahl insgesamt und zwar:;5316000;Leverkusen;X;1039;2;6;6;24;37;75;66;57;123;104;302;60;50;110;123;183;132;100;89;737
****00;Diebstahl insgesamt und zwar:;1003000;Lübeck;M;1588;1;3;15;12;42;73;74;93;167;122;362;97;87;184;193;300;251;143;155;1226
****00;Diebstahl insgesamt und zwar:;1003000;Lübeck;W;678;0;1;6;13;35;55;72;63;135;59;249;28;35;63;63;82;72;63;86;429
****00;Diebstahl insgesamt und zwar:;1003000;Lübeck;X;2266;1;4;21;25;77;128;146;156;302;181;611;125;122;247;256;382;323;206;241;1655
****00;Diebstahl insgesamt und zwar:;7314000;Ludwigshafen am Rhein;M;1150;2;10;10;13;34;69;54;67;121;90;280;66;62;128;159;243;188;81;71;870
****00;Diebstahl insgesamt und zwar:;7314000;Ludwigshafen am Rhein;W;552;0;1;3;12;40;56;54;34;88;52;196;28;20;48;52;82;73;50;51;356
****00;Diebstahl insgesamt und zwar:;7314000;Ludwigshafen am Rhein;X;1702;2;11;13;25;74;125;108;101;209;142;476;94;82;176;211;325;261;131;122;1226
****00;Diebstahl insgesamt und zwar:;15003000;Magdeburg;M;1853;0;3;14;26;43;86;78;104;182;178;446;107;122;229;283;334;250;151;160;1407
****00;Diebstahl insgesamt und zwar:;15003000;Magdeburg;W;787;0;2;5;15;35;57;55;35;90;52;199;40;44;84;77;90;83;81;173;588
****00;Diebstahl insgesamt und zwar:;15003000;Magdeburg;X;2640;0;5;19;41;78;143;133;139;272;230;645;147;166;313;360;424;333;232;333;1995
****00;Diebstahl insgesamt und zwar:;7315000;Mainz;M;1180;0;1;5;13;22;41;63;78;141;120;302;77;68;145;168;235;150;95;85;878
****00;Diebstahl insgesamt und zwar:;7315000;Mainz;W;528;0;0;1;9;32;42;75;47;122;46;210;26;27;53;48;66;66;37;48;318
****00;Diebstahl insgesamt und zwar:;7315000;Mainz;X;1708;0;1;6;22;54;83;138;125;263;166;512;103;95;198;216;301;216;132;133;1196
****00;Diebstahl insgesamt und zwar:;8222000;Mannheim;M;1815;1;3;6;20;46;76;77;113;190;183;449;120;124;244;250;354;263;147;108;1366
****00;Diebstahl insgesamt und zwar:;8222000;Mannheim;W;855;1;0;3;16;38;58;96;77;173;82;313;39;42;81;79;138;100;65;79;542
****00;Diebstahl insgesamt und zwar:;8222000;Mannheim;X;2670;2;3;9;36;84;134;173;190;363;265;762;159;166;325;329;492;363;212;187;1908
****00;Diebstahl insgesamt und zwar:;5170024;Moers;M;458;0;0;3;5;17;25;17;28;45;46;116;26;38;64;69;106;62;19;22;342
****00;Diebstahl insgesamt und zwar:;5170024;Moers;W;164;0;0;0;1;7;8;11;11;22;11;41;10;11;21;18;27;23;13;21;123
****00;Diebstahl insgesamt und zwar:;5170024;Moers;X;622;0;0;3;6;24;33;28;39;67;57;157;36;49;85;87;133;85;32;43;465
****00;Diebstahl insgesamt und zwar:;5116000;Mönchengladbach;M;1464;0;0;7;19;36;62;47;74;121;160;343;95;107;202;207;333;189;108;82;1121
****00;Diebstahl insgesamt und zwar:;5116000;Mönchengladbach;W;676;0;0;4;6;28;38;76;58;134;48;220;32;27;59;82;92;90;57;76;456
****00;Diebstahl insgesamt und zwar:;5116000;Mönchengladbach;X;2140;0;0;11;25;64;100;123;132;255;208;563;127;134;261;289;425;279;165;158;1577
****00;Diebstahl insgesamt und zwar:;5117000;Mülheim an der Ruhr;M;688;0;0;1;8;25;34;46;46;92;66;192;44;43;87;72;135;108;46;48;496
****00;Diebstahl insgesamt und zwar:;5117000;Mülheim an der Ruhr;W;295;0;0;0;6;15;21;24;21;45;29;95;8;16;24;24;45;38;29;40;200
****00;Diebstahl insgesamt und zwar:;5117000;Mülheim an der Ruhr;X;983;0;0;1;14;40;55;70;67;137;95;287;52;59;111;96;180;146;75;88;696
****00;Diebstahl insgesamt und zwar:;9162000;München;M;6895;0;12;27;83;183;305;397;458;855;728;1888;386;404;790;839;1352;955;545;526;5007
****00;Diebstahl insgesamt und zwar:;9162000;München;W;3465;2;3;6;27;189;227;316;286;602;281;1110;161;138;299;327;486;412;344;487;2355
****00;Diebstahl insgesamt und zwar:;9162000;München;X;10360;2;15;33;110;372;532;713;744;1457;1009;2998;547;542;1089;1166;1838;1367;889;1013;7362
****00;Diebstahl insgesamt und zwar:;5515000;Münster;M;1849;0;0;4;26;62;92;128;146;274;256;622;147;130;277;241;313;193;111;92;1227
****00;Diebstahl insgesamt und zwar:;5515000;Münster;W;800;0;0;4;18;51;73;93;86;179;67;319;30;33;63;70;130;78;65;75;481
****00;Diebstahl insgesamt und zwar:;5515000;Münster;X;2649;0;0;8;44;113;165;221;232;453;323;941;177;163;340;311;443;271;176;167;1708
****00;Diebstahl insgesamt und zwar:;5162024;Neuss;M;972;0;0;2;12;19;33;39;58;97;124;254;56;77;133;149;215;109;64;48;718
****00;Diebstahl insgesamt und zwar:;5162024;Neuss;W;359;0;0;0;4;23;27;41;26;67;24;118;11;12;23;40;45;47;40;46;241
****00;Diebstahl insgesamt und zwar:;5162024;Neuss;X;1331;0;0;2;16;42;60;80;84;164;148;372;67;89;156;189;260;156;104;94;959
****00;Diebstahl insgesamt und zwar:;9564000;Nürnberg;M;3647;0;3;10;42;88;143;152;180;332;296;771;218;217;435;618;850;473;266;234;2876
****00;Diebstahl insgesamt und zwar:;9564000;Nürnberg;W;1610;0;3;9;16;80;108;158;105;263;124;495;77;86;163;146;235;218;158;195;1115
****00;Diebstahl insgesamt und zwar:;9564000;Nürnberg;X;5257;0;6;19;58;168;251;310;285;595;420;1266;295;303;598;764;1085;691;424;429;3991
****00;Diebstahl insgesamt und zwar:;5119000;Oberhausen;M;1188;0;3;3;9;31;46;69;77;146;130;322;73;74;147;173;253;160;67;66;866
****00;Diebstahl insgesamt und zwar:;5119000;Oberhausen;W;684;0;0;5;8;42;55;98;79;177;71;303;34;28;62;62;92;73;42;50;381
****00;Diebstahl insgesamt und zwar:;5119000;Oberhausen;X;1872;0;3;8;17;73;101;167;156;323;201;625;107;102;209;235;345;233;109;116;1247
****00;Diebstahl insgesamt und zwar:;6413000;Offenbach am Main;M;886;0;0;6;14;31;51;50;61;111;111;273;68;46;114;118;166;117;52;46;613
****00;Diebstahl insgesamt und zwar:;6413000;Offenbach am Main;W;382;0;0;0;2;15;17;32;33;65;34;116;24;15;39;48;67;46;36;30;266
****00;Diebstahl insgesamt und zwar:;6413000;Offenbach am Main;X;1268;0;0;6;16;46;68;82;94;176;145;389;92;61;153;166;233;163;88;76;879
****00;Diebstahl insgesamt und zwar:;3403000;Oldenburg (Oldenburg);M;964;0;0;3;7;29;39;56;67;123;125;287;96;64;160;128;172;87;81;49;677
****00;Diebstahl insgesamt und zwar:;3403000;Oldenburg (Oldenburg);W;388;1;2;2;1;17;23;38;42;80;33;136;22;15;37;36;58;51;38;32;252
****00;Diebstahl insgesamt und zwar:;3403000;Oldenburg (Oldenburg);X;1352;1;2;5;8;46;62;94;109;203;158;423;118;79;197;164;230;138;119;81;929
****00;Diebstahl insgesamt und zwar:;3404000;Osnabrück;M;1373;1;0;1;9;25;36;61;63;124;137;297;75;111;186;224;300;184;111;71;1076
****00;Diebstahl insgesamt und zwar:;3404000;Osnabrück;W;545;0;0;1;4;16;21;47;34;81;55;157;28;18;46;53;92;74;57;66;388
****00;Diebstahl insgesamt und zwar:;3404000;Osnabrück;X;1918;1;0;2;13;41;57;108;97;205;192;454;103;129;232;277;392;258;168;137;1464
****00;Diebstahl insgesamt und zwar:;5774032;Paderborn;M;924;1;2;4;5;22;34;45;66;111;108;253;59;64;123;135;202;103;63;45;671
****00;Diebstahl insgesamt und zwar:;5774032;Paderborn;W;295;0;0;0;6;15;21;23;28;51;26;98;12;11;23;21;43;38;35;37;197
****00;Diebstahl insgesamt und zwar:;5774032;Paderborn;X;1219;1;2;4;11;37;55;68;94;162;134;351;71;75;146;156;245;141;98;82;868
****00;Diebstahl insgesamt und zwar:;8231000;Pforzheim;M;870;0;1;4;18;29;52;64;58;122;66;240;50;48;98;129;165;118;62;58;630
****00;Diebstahl insgesamt und zwar:;8231000;Pforzheim;W;457;0;1;2;2;29;34;42;31;73;38;145;21;17;38;53;63;54;45;59;312
****00;Diebstahl insgesamt und zwar:;8231000;Pforzheim;X;1327;0;2;6;20;58;86;106;89;195;104;385;71;65;136;182;228;172;107;117;942
****00;Diebstahl insgesamt und zwar:;12054000;Potsdam;M;1039;0;2;2;8;30;42;67;53;120;90;252;66;80;146;129;211;130;93;78;787
****00;Diebstahl insgesamt und zwar:;12054000;Potsdam;W;396;0;0;4;3;21;28;38;29;67;29;124;24;17;41;39;49;27;52;64;272
****00;Diebstahl insgesamt und zwar:;12054000;Potsdam;X;1435;0;2;6;11;51;70;105;82;187;119;376;90;97;187;168;260;157;145;142;1059
****00;Diebstahl insgesamt und zwar:;5562032;Recklinghausen;M;699;0;1;6;10;22;39;46;46;92;69;200;49;44;93;97;148;82;40;39;499
****00;Diebstahl insgesamt und zwar:;5562032;Recklinghausen;W;276;0;0;0;5;9;14;24;15;39;21;74;16;15;31;30;46;38;31;26;202
****00;Diebstahl insgesamt und zwar:;5562032;Recklinghausen;X;975;0;1;6;15;31;53;70;61;131;90;274;65;59;124;127;194;120;71;65;701
****00;Diebstahl insgesamt und zwar:;9362000;Regensburg;M;1092;0;1;2;15;36;54;52;55;107;97;258;76;62;138;158;247;147;78;66;834
****00;Diebstahl insgesamt und zwar:;9362000;Regensburg;W;512;0;0;0;7;24;31;54;35;89;47;167;23;16;39;60;92;52;41;61;345
****00;Diebstahl insgesamt und zwar:;9362000;Regensburg;X;1604;0;1;2;22;60;85;106;90;196;144;425;99;78;177;218;339;199;119;127;1179
****00;Diebstahl insgesamt und zwar:;5120000;Remscheid;M;588;0;1;3;5;18;27;35;34;69;56;152;34;34;68;79;119;57;66;47;436
****00;Diebstahl insgesamt und zwar:;5120000;Remscheid;W;247;0;0;0;6;13;19;13;15;28;13;60;4;8;12;28;48;45;23;31;187
****00;Diebstahl insgesamt und zwar:;5120000;Remscheid;X;835;0;1;3;11;31;46;48;49;97;69;212;38;42;80;107;167;102;89;78;623
****00;Diebstahl insgesamt und zwar:;8415061;Reutlingen;M;424;0;1;0;9;29;39;45;34;79;40;158;29;19;48;47;75;44;32;20;266
****00;Diebstahl insgesamt und zwar:;8415061;Reutlingen;W;256;0;0;1;3;13;17;34;34;68;35;120;8;4;12;24;40;20;22;18;136
****00;Diebstahl insgesamt und zwar:;8415061;Reutlingen;X;680;0;1;1;12;42;56;79;68;147;75;278;37;23;60;71;115;64;54;38;402
****00;Diebstahl insgesamt und zwar:;13003000;Rostock;M;1158;0;14;28;26;43;111;48;64;112;86;309;64;65;129;182;237;115;84;102;849
****00;Diebstahl insgesamt und zwar:;13003000;Rostock;W;516;2;1;9;23;38;73;51;29;80;25;178;14;22;36;44;49;47;58;104;338
****00;Diebstahl insgesamt und zwar:;13003000;Rostock;X;1674;2;15;37;49;81;184;99;93;192;111;487;78;87;165;226;286;162;142;206;1187
****00;Diebstahl insgesamt und zwar:;10041100;Saarbrücken;M;1515;1;4;11;15;46;77;100;101;201;140;418;81;83;164;223;322;187;116;85;1097
****00;Diebstahl insgesamt und zwar:;10041100;Saarbrücken;W;1104;3;1;6;16;82;108;150;111;261;130;499;47;35;82;92;147;95;78;111;605
****00;Diebstahl insgesamt und zwar:;10041100;Saarbrücken;X;2619;4;5;17;31;128;185;250;212;462;270;917;128;118;246;315;469;282;194;196;1702
****00;Diebstahl insgesamt und zwar:;5122000;Solingen;M;770;0;1;3;10;20;34;31;48;79;66;179;32;37;69;82;175;111;69;85;591
****00;Diebstahl insgesamt und zwar:;5122000;Solingen;W;334;0;0;1;3;27;31;22;24;46;14;91;11;16;27;40;61;42;35;38;243
****00;Diebstahl insgesamt und zwar:;5122000;Solingen;X;1104;0;1;4;13;47;65;53;72;125;80;270;43;53;96;122;236;153;104;123;834
****00;Diebstahl insgesamt und zwar:;8111000;Stuttgart;M;3482;0;15;17;48;94;174;176;248;424;352;950;203;212;415;439;706;443;273;256;2532
****00;Diebstahl insgesamt und zwar:;8111000;Stuttgart;W;1560;0;2;6;19;73;100;211;146;357;131;588;66;53;119;148;242;165;134;164;972
****00;Diebstahl insgesamt und zwar:;8111000;Stuttgart;X;5042;0;17;23;67;167;274;387;394;781;483;1538;269;265;534;587;948;608;407;420;3504
****00;Diebstahl insgesamt und zwar:;7211000;Trier;M;774;0;0;7;18;19;44;43;62;105;75;224;54;64;118;115;158;89;46;24;550
****00;Diebstahl insgesamt und zwar:;7211000;Trier;W;330;0;0;0;5;19;24;40;27;67;24;115;19;19;38;36;47;31;36;27;215
****00;Diebstahl insgesamt und zwar:;7211000;Trier;X;1104;0;0;7;23;38;68;83;89;172;99;339;73;83;156;151;205;120;82;51;765
****00;Diebstahl insgesamt und zwar:;8421000;Ulm;M;757;1;0;4;11;36;52;33;59;92;62;206;71;45;116;101;166;82;48;38;551
****00;Diebstahl insgesamt und zwar:;8421000;Ulm;W;427;0;0;1;5;27;33;73;49;122;36;191;25;16;41;45;55;29;23;43;236
****00;Diebstahl insgesamt und zwar:;8421000;Ulm;X;1184;1;0;5;16;63;85;106;108;214;98;397;96;61;157;146;221;111;71;81;787
****00;Diebstahl insgesamt und zwar:;6414000;Wiesbaden;M;1473;0;5;8;14;41;68;109;101;210;151;429;88;72;160;155;304;194;117;114;1044
****00;Diebstahl insgesamt und zwar:;6414000;Wiesbaden;W;731;0;1;4;10;36;51;52;55;107;53;211;31;39;70;62;124;85;67;112;520
****00;Diebstahl insgesamt und zwar:;6414000;Wiesbaden;X;2204;0;6;12;24;77;119;161;156;317;204;640;119;111;230;217;428;279;184;226;1564
****00;Diebstahl insgesamt und zwar:;3103000;Wolfsburg;M;572;1;0;1;6;29;37;25;43;68;46;151;27;39;66;78;130;61;42;44;421
****00;Diebstahl insgesamt und zwar:;3103000;Wolfsburg;W;254;0;1;0;5;23;29;24;13;37;10;76;8;9;17;23;45;22;31;40;178
****00;Diebstahl insgesamt und zwar:;3103000;Wolfsburg;X;826;1;1;1;11;52;66;49;56;105;56;227;35;48;83;101;175;83;73;84;599
****00;Diebstahl insgesamt und zwar:;5124000;Wuppertal;M;2246;1;6;18;47;72;144;132;115;247;166;557;113;125;238;270;497;330;197;157;1689
****00;Diebstahl insgesamt und zwar:;5124000;Wuppertal;W;913;1;5;7;18;60;91;89;79;168;75;334;42;45;87;89;150;96;77;80;579
****00;Diebstahl insgesamt und zwar:;5124000;Wuppertal;X;3159;2;11;25;65;132;235;221;194;415;241;891;155;170;325;359;647;426;274;237;2268
****00;Diebstahl insgesamt und zwar:;9663000;Würzburg;M;803;0;1;9;11;34;55;40;41;81;80;216;63;57;120;115;139;84;63;66;587
****00;Diebstahl insgesamt und zwar:;9663000;Würzburg;W;336;0;0;1;3;32;36;46;21;67;26;129;15;15;30;28;29;26;38;56;207
****00;Diebstahl insgesamt und zwar:;9663000;Würzburg;X;1139;0;1;10;14;66;91;86;62;148;106;345;78;72;150;143;168;110;101;122;794
***100;Diebstahl insgesamt von Kraftwagen einschl. unbefugte Ingebrauchnahme;5334002;Aachen;M;42;0;0;0;0;0;0;0;0;0;8;8;4;4;8;3;15;5;2;1;34
***100;Diebstahl insgesamt von Kraftwagen einschl. unbefugte Ingebrauchnahme;5334002;Aachen;W;3;0;0;0;0;0;0;0;0;0;0;0;0;0;0;1;0;1;1;0;3
***100;Diebstahl insgesamt von Kraftwagen einschl. unbefugte Ingebrauchnahme;5334002;Aachen;X;45;0;0;0;0;0;0;0;0;0;8;8;4;4;8;4;15;6;3;1;37
***100;Diebstahl insgesamt von Kraftwagen einschl. unbefugte Ingebrauchnahme;9761000;Augsburg;M;29;0;0;0;0;0;0;3;6;9;6;15;2;3;5;1;7;0;1;0;14
***100;Diebstahl insgesamt von Kraftwagen einschl. unbefugte Ingebrauchnahme;9761000;Augsburg;W;2;0;0;0;0;0;0;1;0;1;0;1;0;1;1;0;0;0;0;0;1
***100;Diebstahl insgesamt von Kraftwagen einschl. unbefugte Ingebrauchnahme;9761000;Augsburg;X;31;0;0;0;0;0;0;4;6;10;6;16;2;4;6;1;7;0;1;0;15
***100;Diebstahl insgesamt von Kraftwagen einschl. unbefugte Ingebrauchnahme;5378004;Bergisch Gladbach;M;5;0;0;0;0;0;0;0;0;0;2;2;0;1;1;1;0;1;0;0;3
***100;Diebstahl insgesamt von Kraftwagen einschl. unbefugte Ingebrauchnahme;5378004;Bergisch Gladbach;W;1;0;0;0;0;0;0;0;1;1;0;1;0;0;0;0;0;0;0;0;0
***100;Diebstahl insgesamt von Kraftwagen einschl. unbefugte Ingebrauchnahme;5378004;Bergisch Gladbach;X;6;0;0;0;0;0;0;0;1;1;2;3;0;1;1;1;0;1;0;0;3
***100;Diebstahl insgesamt von Kraftwagen einschl. unbefugte Ingebrauchnahme;11000000;Berlin;M;724;0;0;0;0;0;0;23;50;73;72;145;42;54;96;120;235;88;31;9;579
***100;Diebstahl insgesamt von Kraftwagen einschl. unbefugte Ingebrauchnahme;11000000;Berlin;W;42;0;0;0;0;0;0;4;4;8;2;10;5;4;9;6;8;6;2;1;32
***100;Diebstahl insgesamt von Kraftwagen einschl. unbefugte Ingebrauchnahme;11000000;Berlin;X;766;0;0;0;0;0;0;27;54;81;74;155;47;58;105;126;243;94;33;10;611
***100;Diebstahl insgesamt von Kraftwagen einschl. unbefugte Ingebrauchnahme;5711000;Bielefeld;M;30;0;0;0;0;0;0;1;2;3;4;7;0;3;3;4;9;4;3;0;23
***100;Diebstahl insgesamt von Kraftwagen einschl. unbefugte Ingebrauchnahme;5711000;Bielefeld;W;0;0;0;0;0;0;0;0;0;0;0;0;0;0;0;0;0;0;0;0;0
***100;Diebstahl insgesamt von Kraftwagen einschl. unbefugte Ingebrauchnahme;5711000;Bielefeld;X;30;0;0;0;0;0;0;1;2;3;4;7;0;3;3;4;9;4;3;0;23
***100;Diebstahl insgesamt von Kraftwagen einschl. unbefugte Ingebrauchnahme;5911000;Bochum;M;28;0;0;0;0;0;0;1;2;3;4;7;2;3;5;3;7;2;3;1;21
***100;Diebstahl insgesamt von Kraftwagen einschl. unbefugte Ingebrauchnahme;5911000;Bochum;W;1;0;0;0;0;0;0;0;0;0;0;0;0;0;0;0;0;0;0;1;1
***100;Diebstahl insgesamt von Kraftwagen einschl. unbefugte Ingebrauchnahme;5911000;Bochum;X;29;0;0;0;0;0;0;1;2;3;4;7;2;3;5;3;7;2;3;2;22
***100;Diebstahl insgesamt von Kraftwagen einschl. unbefugte Ingebrauchnahme;5314000;Bonn;M;50;0;0;0;0;0;0;2;4;6;5;11;3;0;3;6;18;7;3;2;39
***100;Diebstahl insgesamt von Kraftwagen einschl. unbefugte Ingebrauchnahme;5314000;Bonn;W;3;0;0;0;0;0;0;0;0;0;1;1;0;0;0;1;1;0;0;0;2
***100;Diebstahl insgesamt von Kraftwagen einschl. unbefugte Ingebrauchnahme;5314000;Bonn;X;53;0;0;0;0;0;0;2;4;6;6;12;3;0;3;7;19;7;3;2;41
***100;Diebstahl insgesamt von Kraftwagen einschl. unbefugte Ingebrauchnahme;5512000;Bottrop;M;7;0;0;0;0;0;0;0;0;0;0;0;1;1;2;3;1;0;1;0;7
***100;Diebstahl insgesamt von Kraftwagen einschl. unbefugte Ingebrauchnahme;5512000;Bottrop;W;0;0;0;0;0;0;0;0;0;0;0;0;0;0;0;0;0;0;0;0;0
***100;Diebstahl insgesamt von Kraftwagen einschl. unbefugte Ingebrauchnahme;5512000;Bottrop;X;7;0;0;0;0;0;0;0;0;0;0;0;1;1;2;3;1;0;1;0;7
***100;Diebstahl insgesamt von Kraftwagen einschl. unbefugte Ingebrauchnahme;3101000;Braunschweig;M;27;0;0;0;0;0;0;0;2;2;5;7;0;2;2;2;11;5;0;0;20
***100;Diebstahl insgesamt von Kraftwagen einschl. unbefugte Ingebrauchnahme;3101000;Braunschweig;W;1;0;0;0;0;0;0;0;0;0;0;0;0;0;0;0;0;1;0;0;1
***100;Diebstahl insgesamt von Kraftwagen einschl. unbefugte Ingebrauchnahme;3101000;Braunschweig;X;28;0;0;0;0;0;0;0;2;2;5;7;0;2;2;2;11;6;0;0;21
***100;Diebstahl insgesamt von Kraftwagen einschl. unbefugte Ingebrauchnahme;4011000;Bremen;M;43;0;0;0;0;0;0;2;1;3;3;6;4;2;6;8;18;4;1;0;37
***100;Diebstahl insgesamt von Kraftwagen einschl. unbefugte Ingebrauchnahme;4011000;Bremen;W;4;0;0;0;0;0;0;0;0;0;0;0;0;1;1;2;0;1;0;0;4
***100;Diebstahl insgesamt von Kraftwagen einschl. unbefugte Ingebrauchnahme;4011000;Bremen;X;47;0;0;0;0;0;0;2;1;3;3;6;4;3;7;10;18;5;1;0;41
***100;Diebstahl insgesamt von Kraftwagen einschl. unbefugte Ingebrauchnahme;4012000;Bremerhaven;M;12;0;0;0;0;0;0;0;0;0;1;1;0;0;0;3;5;1;1;1;11
***100;Diebstahl insgesamt von Kraftwagen einschl. unbefugte Ingebrauchnahme;4012000;Bremerhaven;W;0;0;0;0;0;0;0;0;0;0;0;0;0;0;0;0;0;0;0;0;0
***100;Diebstahl insgesamt von Kraftwagen einschl. unbefugte Ingebrauchnahme;4012000;Bremerhaven;X;12;0;0;0;0;0;0;0;0;0;1;1;0;0;0;3;5;1;1;1;11
***100;Diebstahl insgesamt von Kraftwagen einschl. unbefugte Ingebrauchnahme;14511000;Chemnitz;M;40;0;0;0;0;0;0;1;1;2;1;3;2;2;4;4;18;9;1;1;37
***100;Diebstahl insgesamt von Kraftwagen einschl. unbefugte Ingebrauchnahme;14511000;Chemnitz;W;1;0;0;0;0;0;0;0;1;1;0;1;0;0;0;0;0;0;0;0;0
***100;Diebstahl insgesamt von Kraftwagen einschl. unbefugte Ingebrauchnahme;14511000;Chemnitz;X;41;0;0;0;0;0;0;1;2;3;1;4;2;2;4;4;18;9;1;1;37
***100;Diebstahl insgesamt von Kraftwagen einschl. unbefugte Ingebrauchnahme;6411000;Darmstadt;M;22;0;0;0;0;0;0;5;4;9;4;13;2;1;3;4;1;1;0;0;9
***100;Diebstahl insgesamt von Kraftwagen einschl. unbefugte Ingebrauchnahme;6411000;Darmstadt;W;1;0;0;0;0;0;0;1;0;1;0;1;0;0;0;0;0;0;0;0;0
***100;Diebstahl insgesamt von Kraftwagen einschl. unbefugte Ingebrauchnahme;6411000;Darmstadt;X;23;0;0;0;0;0;0;6;4;10;4;14;2;1;3;4;1;1;0;0;9
***100;Diebstahl insgesamt von Kraftwagen einschl. unbefugte Ingebrauchnahme;5913000;Dortmund;M;56;0;0;0;0;2;2;1;7;8;8;18;4;2;6;10;15;6;0;1;38
***100;Diebstahl insgesamt von Kraftwagen einschl. unbefugte Ingebrauchnahme;5913000;Dortmund;W;6;0;0;0;0;0;0;0;0;0;0;0;2;0;2;1;1;2;0;0;6
***100;Diebstahl insgesamt von Kraftwagen einschl. unbefugte Ingebrauchnahme;5913000;Dortmund;X;62;0;0;0;0;2;2;1;7;8;8;18;6;2;8;11;16;8;0;1;44
***100;Diebstahl insgesamt von Kraftwagen einschl. unbefugte Ingebrauchnahme;14612000;Dresden;M;192;0;0;0;0;0;0;0;1;1;9;10;9;17;26;31;79;34;11;1;182
***100;Diebstahl insgesamt von Kraftwagen einschl. unbefugte Ingebrauchnahme;14612000;Dresden;W;7;0;0;0;0;0;0;0;0;0;0;0;0;2;2;2;2;1;0;0;7
***100;Diebstahl insgesamt von Kraftwagen einschl. unbefugte Ingebrauchnahme;14612000;Dresden;X;199;0;0;0;0;0;0;0;1;1;9;10;9;19;28;33;81;35;11;1;189
***100;Diebstahl insgesamt von Kraftwagen einschl. unbefugte Ingebrauchnahme;5112000;Duisburg;M;39;0;0;0;0;0;0;3;1;4;7;11;2;1;3;4;13;6;1;1;28
***100;Diebstahl insgesamt von Kraftwagen einschl. unbefugte Ingebrauchnahme;5112000;Duisburg;W;7;0;0;0;0;0;0;0;0;0;0;0;1;1;2;1;4;0;0;0;7
***100;Diebstahl insgesamt von Kraftwagen einschl. unbefugte Ingebrauchnahme;5112000;Duisburg;X;46;0;0;0;0;0;0;3;1;4;7;11;3;2;5;5;17;6;1;1;35
***100;Diebstahl insgesamt von Kraftwagen einschl. unbefugte Ingebrauchnahme;5111000;Düsseldorf;M;98;0;0;0;0;1;1;3;4;7;11;19;7;8;15;26;24;13;1;0;79
***100;Diebstahl insgesamt von Kraftwagen einschl. unbefugte Ingebrauchnahme;5111000;Düsseldorf;W;6;0;0;0;0;0;0;1;0;1;0;1;0;1;1;1;2;1;0;0;5
***100;Diebstahl insgesamt von Kraftwagen einschl. unbefugte Ingebrauchnahme;5111000;Düsseldorf;X;104;0;0;0;0;1;1;4;4;8;11;20;7;9;16;27;26;14;1;0;84
***100;Diebstahl insgesamt von Kraftwagen einschl. unbefugte Ingebrauchnahme;16051000;Erfurt;M;18;0;0;0;0;0;0;0;1;1;1;2;1;4;5;1;6;3;1;0;16
***100;Diebstahl insgesamt von Kraftwagen einschl. unbefugte Ingebrauchnahme;16051000;Erfurt;W;0;0;0;0;0;0;0;0;0;0;0;0;0;0;0;0;0;0;0;0;0
***100;Diebstahl insgesamt von Kraftwagen einschl. unbefugte Ingebrauchnahme;16051000;Erfurt;X;18;0;0;0;0;0;0;0;1;1;1;2;1;4;5;1;6;3;1;0;16
***100;Diebstahl insgesamt von Kraftwagen einschl. unbefugte Ingebrauchnahme;9562000;Erlangen;M;18;0;0;0;0;0;0;2;0;2;4;6;1;2;3;1;6;1;1;0;12
***100;Diebstahl insgesamt von Kraftwagen einschl. unbefugte Ingebrauchnahme;9562000;Erlangen;W;2;0;0;0;0;0;0;0;0;0;0;0;0;1;1;0;1;0;0;0;2
***100;Diebstahl insgesamt von Kraftwagen einschl. unbefugte Ingebrauchnahme;9562000;Erlangen;X;20;0;0;0;0;0;0;2;0;2;4;6;1;3;4;1;7;1;1;0;14
***100;Diebstahl insgesamt von Kraftwagen einschl. unbefugte Ingebrauchnahme;5113000;Essen;M;93;0;0;0;0;2;2;1;9;10;9;21;10;7;17;16;23;13;2;1;72
***100;Diebstahl insgesamt von Kraftwagen einschl. unbefugte Ingebrauchnahme;5113000;Essen;W;8;0;0;0;0;0;0;0;0;0;0;0;0;0;0;4;1;2;1;0;8
***100;Diebstahl insgesamt von Kraftwagen einschl. unbefugte Ingebrauchnahme;5113000;Essen;X;101;0;0;0;0;2;2;1;9;10;9;21;10;7;17;20;24;15;3;1;80
***100;Diebstahl insgesamt von Kraftwagen einschl. unbefugte Ingebrauchnahme;6412000;Frankfurt am Main;M;73;0;0;0;0;0;0;0;0;0;11;11;7;7;14;15;15;12;6;0;62
***100;Diebstahl insgesamt von Kraftwagen einschl. unbefugte Ingebrauchnahme;6412000;Frankfurt am Main;W;9;0;0;0;0;0;0;1;2;3;1;4;0;0;0;0;4;1;0;0;5
***100;Diebstahl insgesamt von Kraftwagen einschl. unbefugte Ingebrauchnahme;6412000;Frankfurt am Main;X;82;0;0;0;0;0;0;1;2;3;12;15;7;7;14;15;19;13;6;0;67
***100;Diebstahl insgesamt von Kraftwagen einschl. unbefugte Ingebrauchnahme;8311000;Freiburg im Breisgau;M;22;0;0;0;0;0;0;0;1;1;5;6;4;1;5;2;4;2;3;0;16
***100;Diebstahl insgesamt von Kraftwagen einschl. unbefugte Ingebrauchnahme;8311000;Freiburg im Breisgau;W;1;0;0;0;0;0;0;0;0;0;0;0;0;0;0;0;0;1;0;0;1
***100;Diebstahl insgesamt von Kraftwagen einschl. unbefugte Ingebrauchnahme;8311000;Freiburg im Breisgau;X;23;0;0;0;0;0;0;0;1;1;5;6;4;1;5;2;4;3;3;0;17
***100;Diebstahl insgesamt von Kraftwagen einschl. unbefugte Ingebrauchnahme;9563000;Fürth;M;13;0;0;0;0;0;0;3;0;3;1;4;2;1;3;0;4;2;0;0;9
***100;Diebstahl insgesamt von Kraftwagen einschl. unbefugte Ingebrauchnahme;9563000;Fürth;W;4;0;0;0;0;0;0;0;0;0;1;1;0;1;1;0;1;1;0;0;3
***100;Diebstahl insgesamt von Kraftwagen einschl. unbefugte Ingebrauchnahme;9563000;Fürth;X;17;0;0;0;0;0;0;3;0;3;2;5;2;2;4;0;5;3;0;0;12
***100;Diebstahl insgesamt von Kraftwagen einschl. unbefugte Ingebrauchnahme;5513000;Gelsenkirchen;M;33;0;0;0;0;1;1;0;1;1;0;2;4;2;6;3;11;7;3;1;31
***100;Diebstahl insgesamt von Kraftwagen einschl. unbefugte Ingebrauchnahme;5513000;Gelsenkirchen;W;3;0;0;0;0;0;0;0;0;0;1;1;0;1;1;0;0;0;0;1;2
***100;Diebstahl insgesamt von Kraftwagen einschl. unbefugte Ingebrauchnahme;5513000;Gelsenkirchen;X;36;0;0;0;0;1;1;0;1;1;1;3;4;3;7;3;11;7;3;2;33
***100;Diebstahl insgesamt von Kraftwagen einschl. unbefugte Ingebrauchnahme;3152012;Göttingen;M;10;0;0;0;0;0;0;0;0;0;1;1;2;2;4;2;2;1;0;0;9
***100;Diebstahl insgesamt von Kraftwagen einschl. unbefugte Ingebrauchnahme;3152012;Göttingen;W;0;0;0;0;0;0;0;0;0;0;0;0;0;0;0;0;0;0;0;0;0
***100;Diebstahl insgesamt von Kraftwagen einschl. unbefugte Ingebrauchnahme;3152012;Göttingen;X;10;0;0;0;0;0;0;0;0;0;1;1;2;2;4;2;2;1;0;0;9
***100;Diebstahl insgesamt von Kraftwagen einschl. unbefugte Ingebrauchnahme;5914000;Hagen;M;12;0;0;0;0;0;0;0;0;0;5;5;0;2;2;1;1;2;1;0;7
***100;Diebstahl insgesamt von Kraftwagen einschl. unbefugte Ingebrauchnahme;5914000;Hagen;W;1;0;0;0;0;0;0;0;0;0;0;0;0;0;0;0;0;1;0;0;1
***100;Diebstahl insgesamt von Kraftwagen einschl. unbefugte Ingebrauchnahme;5914000;Hagen;X;13;0;0;0;0;0;0;0;0;0;5;5;0;2;2;1;1;3;1;0;8
***100;Diebstahl insgesamt von Kraftwagen einschl. unbefugte Ingebrauchnahme;15002000;Halle (Saale);M;46;0;0;0;0;0;0;0;3;3;2;5;2;5;7;16;10;5;3;0;41
***100;Diebstahl insgesamt von Kraftwagen einschl. unbefugte Ingebrauchnahme;15002000;Halle (Saale);W;4;0;0;0;0;0;0;0;0;0;2;2;1;0;1;0;0;1;0;0;2
***100;Diebstahl insgesamt von Kraftwagen einschl. unbefugte Ingebrauchnahme;15002000;Halle (Saale);X;50;0;0;0;0;0;0;0;3;3;4;7;3;5;8;16;10;6;3;0;43
***100;Diebstahl insgesamt von Kraftwagen einschl. unbefugte Ingebrauchnahme;2000000;Hamburg;M;203;0;0;0;0;0;0;2;19;21;18;39;17;19;36;27;53;30;15;3;164
***100;Diebstahl insgesamt von Kraftwagen einschl. unbefugte Ingebrauchnahme;2000000;Hamburg;W;15;0;0;0;0;0;0;0;0;0;1;1;1;3;4;3;3;3;1;0;14
***100;Diebstahl insgesamt von Kraftwagen einschl. unbefugte Ingebrauchnahme;2000000;Hamburg;X;218;0;0;0;0;0;0;2;19;21;19;40;18;22;40;30;56;33;16;3;178
***100;Diebstahl insgesamt von Kraftwagen einschl. unbefugte Ingebrauchnahme;5915000;Hamm;M;15;0;0;0;0;0;0;1;5;6;2;8;0;0;0;0;6;1;0;0;7
***100;Diebstahl insgesamt von Kraftwagen einschl. unbefugte Ingebrauchnahme;5915000;Hamm;W;2;0;0;0;0;0;0;0;0;0;0;0;0;0;0;0;1;1;0;0;2
***100;Diebstahl insgesamt von Kraftwagen einschl. unbefugte Ingebrauchnahme;5915000;Hamm;X;17;0;0;0;0;0;0;1;5;6;2;8;0;0;0;0;7;2;0;0;9
***100;Diebstahl insgesamt von Kraftwagen einschl. unbefugte Ingebrauchnahme;3241001;Hannover;M;81;0;0;0;0;1;1;2;3;5;7;13;9;8;17;14;16;16;4;1;68
***100;Diebstahl insgesamt von Kraftwagen einschl. unbefugte Ingebrauchnahme;3241001;Hannover;W;11;0;0;0;0;0;0;1;1;2;5;7;1;0;1;0;2;0;1;0;4
***100;Diebstahl insgesamt von Kraftwagen einschl. unbefugte Ingebrauchnahme;3241001;Hannover;X;92;0;0;0;0;1;1;3;4;7;12;20;10;8;18;14;18;16;5;1;72
***100;Diebstahl insgesamt von Kraftwagen einschl. unbefugte Ingebrauchnahme;8221000;Heidelberg;M;16;0;0;0;0;0;0;0;2;2;2;4;0;1;1;4;5;1;1;0;12
***100;Diebstahl insgesamt von Kraftwagen einschl. unbefugte Ingebrauchnahme;8221000;Heidelberg;W;1;0;0;0;0;0;0;0;0;0;0;0;1;0;1;0;0;0;0;0;1
***100;Diebstahl insgesamt von Kraftwagen einschl. unbefugte Ingebrauchnahme;8221000;Heidelberg;X;17;0;0;0;0;0;0;0;2;2;2;4;1;1;2;4;5;1;1;0;13
***100;Diebstahl insgesamt von Kraftwagen einschl. unbefugte Ingebrauchnahme;8121000;Heilbronn;M;12;0;0;0;0;0;0;0;1;1;1;2;2;1;3;1;3;2;0;1;10
***100;Diebstahl insgesamt von Kraftwagen einschl. unbefugte Ingebrauchnahme;8121000;Heilbronn;W;1;0;0;0;0;0;0;0;0;0;0;0;0;0;0;0;1;0;0;0;1
***100;Diebstahl insgesamt von Kraftwagen einschl. unbefugte Ingebrauchnahme;8121000;Heilbronn;X;13;0;0;0;0;0;0;0;1;1;1;2;2;1;3;1;4;2;0;1;11
***100;Diebstahl insgesamt von Kraftwagen einschl. unbefugte Ingebrauchnahme;5916000;Herne;M;13;0;0;0;0;0;0;0;0;0;4;4;2;2;4;2;2;1;0;0;9
***100;Diebstahl insgesamt von Kraftwagen einschl. unbefugte Ingebrauchnahme;5916000;Herne;W;2;0;0;0;0;0;0;0;0;0;0;0;1;0;1;1;0;0;0;0;2
***100;Diebstahl insgesamt von Kraftwagen einschl. unbefugte Ingebrauchnahme;5916000;Herne;X;15;0;0;0;0;0;0;0;0;0;4;4;3;2;5;3;2;1;0;0;11
***100;Diebstahl insgesamt von Kraftwagen einschl. unbefugte Ingebrauchnahme;9161000;Ingolstadt;M;30;0;0;0;0;0;0;1;0;1;5;6;3;0;3;3;11;5;1;1;24
***100;Diebstahl insgesamt von Kraftwagen einschl. unbefugte Ingebrauchnahme;9161000;Ingolstadt;W;3;0;0;0;0;0;0;0;0;0;2;2;0;0;0;0;0;1;0;0;1
***100;Diebstahl insgesamt von Kraftwagen einschl. unbefugte Ingebrauchnahme;9161000;Ingolstadt;X;33;0;0;0;0;0;0;1;0;1;7;8;3;0;3;3;11;6;1;1;25
***100;Diebstahl insgesamt von Kraftwagen einschl. unbefugte Ingebrauchnahme;16053000;Jena;M;11;0;0;0;0;0;0;0;0;0;2;2;1;1;2;1;3;2;0;1;9
***100;Diebstahl insgesamt von Kraftwagen einschl. unbefugte Ingebrauchnahme;16053000;Jena;W;1;0;0;0;0;0;0;0;0;0;0;0;0;0;0;1;0;0;0;0;1
***100;Diebstahl insgesamt von Kraftwagen einschl. unbefugte Ingebrauchnahme;16053000;Jena;X;12;0;0;0;0;0;0;0;0;0;2;2;1;1;2;2;3;2;0;1;10
***100;Diebstahl insgesamt von Kraftwagen einschl. unbefugte Ingebrauchnahme;8212000;Karlsruhe;M;19;0;0;0;0;0;0;1;0;1;3;4;2;3;5;3;4;2;1;0;15
***100;Diebstahl insgesamt von Kraftwagen einschl. unbefugte Ingebrauchnahme;8212000;Karlsruhe;W;2;0;0;0;0;0;0;0;0;0;0;0;0;2;2;0;0;0;0;0;2
***100;Diebstahl insgesamt von Kraftwagen einschl. unbefugte Ingebrauchnahme;8212000;Karlsruhe;X;21;0;0;0;0;0;0;1;0;1;3;4;2;5;7;3;4;2;1;0;17
***100;Diebstahl insgesamt von Kraftwagen einschl. unbefugte Ingebrauchnahme;6611000;Kassel;M;20;0;0;0;0;0;0;0;2;2;4;6;4;0;4;3;5;2;0;0;14
***100;Diebstahl insgesamt von Kraftwagen einschl. unbefugte Ingebrauchnahme;6611000;Kassel;W;2;0;0;0;0;0;0;1;0;1;0;1;0;0;0;0;0;1;0;0;1
***100;Diebstahl insgesamt von Kraftwagen einschl. unbefugte Ingebrauchnahme;6611000;Kassel;X;22;0;0;0;0;0;0;1;2;3;4;7;4;0;4;3;5;3;0;0;15
***100;Diebstahl insgesamt von Kraftwagen einschl. unbefugte Ingebrauchnahme;1002000;Kiel;M;28;0;0;0;0;0;0;0;2;2;4;6;2;1;3;9;5;4;1;0;22
***100;Diebstahl insgesamt von Kraftwagen einschl. unbefugte Ingebrauchnahme;1002000;Kiel;W;1;0;0;0;0;0;0;0;0;0;0;0;0;0;0;0;0;1;0;0;1
***100;Diebstahl insgesamt von Kraftwagen einschl. unbefugte Ingebrauchnahme;1002000;Kiel;X;29;0;0;0;0;0;0;0;2;2;4;6;2;1;3;9;5;5;1;0;23
***100;Diebstahl insgesamt von Kraftwagen einschl. unbefugte Ingebrauchnahme;7111000;Koblenz;M;20;0;0;0;0;0;0;0;2;2;6;8;3;1;4;1;7;0;0;0;12
***100;Diebstahl insgesamt von Kraftwagen einschl. unbefugte Ingebrauchnahme;7111000;Koblenz;W;3;0;0;0;0;0;0;0;0;0;1;1;1;0;1;0;1;0;0;0;2
***100;Diebstahl insgesamt von Kraftwagen einschl. unbefugte Ingebrauchnahme;7111000;Koblenz;X;23;0;0;0;0;0;0;0;2;2;7;9;4;1;5;1;8;0;0;0;14
***100;Diebstahl insgesamt von Kraftwagen einschl. unbefugte Ingebrauchnahme;5315000;Köln;M;126;0;0;0;0;1;1;7;14;21;22;44;8;9;17;19;27;13;5;1;82
***100;Diebstahl insgesamt von Kraftwagen einschl. unbefugte Ingebrauchnahme;5315000;Köln;W;6;0;0;0;0;0;0;0;0;0;1;1;0;0;0;0;1;2;2;0;5
***100;Diebstahl insgesamt von Kraftwagen einschl. unbefugte Ingebrauchnahme;5315000;Köln;X;132;0;0;0;0;1;1;7;14;21;23;45;8;9;17;19;28;15;7;1;87
***100;Diebstahl insgesamt von Kraftwagen einschl. unbefugte Ingebrauchnahme;5114000;Krefeld;M;21;0;0;0;0;0;0;1;2;3;3;6;1;4;5;3;7;0;0;0;15
***100;Diebstahl insgesamt von Kraftwagen einschl. unbefugte Ingebrauchnahme;5114000;Krefeld;W;1;0;0;0;0;0;0;0;0;0;0;0;0;0;0;0;1;0;0;0;1
***100;Diebstahl insgesamt von Kraftwagen einschl. unbefugte Ingebrauchnahme;5114000;Krefeld;X;22;0;0;0;0;0;0;1;2;3;3;6;1;4;5;3;8;0;0;0;16
***100;Diebstahl insgesamt von Kraftwagen einschl. unbefugte Ingebrauchnahme;14713000;Leipzig;M;137;0;0;0;0;1;1;8;3;11;8;20;5;15;20;24;54;12;6;1;117
***100;Diebstahl insgesamt von Kraftwagen einschl. unbefugte Ingebrauchnahme;14713000;Leipzig;W;5;0;0;0;0;0;0;0;0;0;1;1;0;0;0;1;2;1;0;0;4
***100;Diebstahl insgesamt von Kraftwagen einschl. unbefugte Ingebrauchnahme;14713000;Leipzig;X;142;0;0;0;0;1;1;8;3;11;9;21;5;15;20;25;56;13;6;1;121
***100;Diebstahl insgesamt von Kraftwagen einschl. unbefugte Ingebrauchnahme;5316000;Leverkusen;M;19;0;0;0;0;0;0;1;2;3;1;4;1;2;3;3;8;1;0;0;15
***100;Diebstahl insgesamt von Kraftwagen einschl. unbefugte Ingebrauchnahme;5316000;Leverkusen;W;2;0;0;0;0;0;0;0;0;0;0;0;0;0;0;1;1;0;0;0;2
***100;Diebstahl insgesamt von Kraftwagen einschl. unbefugte Ingebrauchnahme;5316000;Leverkusen;X;21;0;0;0;0;0;0;1;2;3;1;4;1;2;3;4;9;1;0;0;17
***100;Diebstahl insgesamt von Kraftwagen einschl. unbefugte Ingebrauchnahme;1003000;Lübeck;M;21;0;0;0;0;0;0;2;1;3;1;4;1;2;3;1;5;6;2;0;17
***100;Diebstahl insgesamt von Kraftwagen einschl. unbefugte Ingebrauchnahme;1003000;Lübeck;W;0;0;0;0;0;0;0;0;0;0;0;0;0;0;0;0;0;0;0;0;0
***100;Diebstahl insgesamt von Kraftwagen einschl. unbefugte Ingebrauchnahme;1003000;Lübeck;X;21;0;0;0;0;0;0;2;1;3;1;4;1;2;3;1;5;6;2;0;17
***100;Diebstahl insgesamt von Kraftwagen einschl. unbefugte Ingebrauchnahme;7314000;Ludwigshafen am Rhein;M;28;0;0;0;0;0;0;0;1;1;2;3;7;4;11;3;3;6;2;0;25
***100;Diebstahl insgesamt von Kraftwagen einschl. unbefugte Ingebrauchnahme;7314000;Ludwigshafen am Rhein;W;6;0;0;0;0;0;0;0;0;0;0;0;1;1;2;0;1;1;2;0;6
***100;Diebstahl insgesamt von Kraftwagen einschl. unbefugte Ingebrauchnahme;7314000;Ludwigshafen am Rhein;X;34;0;0;0;0;0;0;0;1;1;2;3;8;5;13;3;4;7;4;0;31
***100;Diebstahl insgesamt von Kraftwagen einschl. unbefugte Ingebrauchnahme;15003000;Magdeburg;M;88;0;0;0;0;0;0;2;2;4;10;14;11;11;22;18;19;9;5;1;74
***100;Diebstahl insgesamt von Kraftwagen einschl. unbefugte Ingebrauchnahme;15003000;Magdeburg;W;5;0;0;0;0;0;0;0;1;1;1;2;2;0;2;0;1;0;0;0;3
***100;Diebstahl insgesamt von Kraftwagen einschl. unbefugte Ingebrauchnahme;15003000;Magdeburg;X;93;0;0;0;0;0;0;2;3;5;11;16;13;11;24;18;20;9;5;1;77
***100;Diebstahl insgesamt von Kraftwagen einschl. unbefugte Ingebrauchnahme;7315000;Mainz;M;29;0;0;0;0;1;1;3;1;4;7;12;4;1;5;2;6;4;0;0;17
***100;Diebstahl insgesamt von Kraftwagen einschl. unbefugte Ingebrauchnahme;7315000;Mainz;W;5;0;0;0;0;0;0;0;0;0;0;0;0;0;0;1;1;2;1;0;5
***100;Diebstahl insgesamt von Kraftwagen einschl. unbefugte Ingebrauchnahme;7315000;Mainz;X;34;0;0;0;0;1;1;3;1;4;7;12;4;1;5;3;7;6;1;0;22
***100;Diebstahl insgesamt von Kraftwagen einschl. unbefugte Ingebrauchnahme;8222000;Mannheim;M;41;0;0;0;0;0;0;2;3;5;5;10;7;3;10;9;7;4;1;0;31
***100;Diebstahl insgesamt von Kraftwagen einschl. unbefugte Ingebrauchnahme;8222000;Mannheim;W;2;0;0;0;0;0;0;0;0;0;0;0;0;1;1;1;0;0;0;0;2
***100;Diebstahl insgesamt von Kraftwagen einschl. unbefugte Ingebrauchnahme;8222000;Mannheim;X;43;0;0;0;0;0;0;2;3;5;5;10;7;4;11;10;7;4;1;0;33
***100;Diebstahl insgesamt von Kraftwagen einschl. unbefugte Ingebrauchnahme;5170024;Moers;M;2;0;0;0;0;0;0;0;0;0;1;1;0;0;0;0;1;0;0;0;1
***100;Diebstahl insgesamt von Kraftwagen einschl. unbefugte Ingebrauchnahme;5170024;Moers;W;1;0;0;0;0;0;0;0;0;0;0;0;0;0;0;1;0;0;0;0;1
***100;Diebstahl insgesamt von Kraftwagen einschl. unbefugte Ingebrauchnahme;5170024;Moers;X;3;0;0;0;0;0;0;0;0;0;1;1;0;0;0;1;1;0;0;0;2
***100;Diebstahl insgesamt von Kraftwagen einschl. unbefugte Ingebrauchnahme;5116000;Mönchengladbach;M;25;0;0;0;0;0;0;1;2;3;3;6;4;4;8;4;1;5;1;0;19
***100;Diebstahl insgesamt von Kraftwagen einschl. unbefugte Ingebrauchnahme;5116000;Mönchengladbach;W;2;0;0;0;0;0;0;2;0;2;0;2;0;0;0;0;0;0;0;0;0
***100;Diebstahl insgesamt von Kraftwagen einschl. unbefugte Ingebrauchnahme;5116000;Mönchengladbach;X;27;0;0;0;0;0;0;3;2;5;3;8;4;4;8;4;1;5;1;0;19
***100;Diebstahl insgesamt von Kraftwagen einschl. unbefugte Ingebrauchnahme;5117000;Mülheim an der Ruhr;M;13;0;0;0;0;0;0;0;1;1;4;5;1;2;3;0;4;1;0;0;8
***100;Diebstahl insgesamt von Kraftwagen einschl. unbefugte Ingebrauchnahme;5117000;Mülheim an der Ruhr;W;0;0;0;0;0;0;0;0;0;0;0;0;0;0;0;0;0;0;0;0;0
***100;Diebstahl insgesamt von Kraftwagen einschl. unbefugte Ingebrauchnahme;5117000;Mülheim an der Ruhr;X;13;0;0;0;0;0;0;0;1;1;4;5;1;2;3;0;4;1;0;0;8
***100;Diebstahl insgesamt von Kraftwagen einschl. unbefugte Ingebrauchnahme;9162000;München;M;100;0;0;0;0;3;3;2;10;12;12;27;5;8;13;17;21;16;4;2;73
***100;Diebstahl insgesamt von Kraftwagen einschl. unbefugte Ingebrauchnahme;9162000;München;W;5;0;0;0;0;1;1;0;0;0;1;2;0;0;0;2;0;1;0;0;3
***100;Diebstahl insgesamt von Kraftwagen einschl. unbefugte Ingebrauchnahme;9162000;München;X;105;0;0;0;0;4;4;2;10;12;13;29;5;8;13;19;21;17;4;2;76
***100;Diebstahl insgesamt von Kraftwagen einschl. unbefugte Ingebrauchnahme;5515000;Münster;M;44;0;0;0;0;1;1;7;6;13;5;19;5;2;7;6;5;5;1;1;25
***100;Diebstahl insgesamt von Kraftwagen einschl. unbefugte Ingebrauchnahme;5515000;Münster;W;2;0;0;0;0;0;0;0;0;0;0;0;0;0;0;0;1;1;0;0;2
***100;Diebstahl insgesamt von Kraftwagen einschl. unbefugte Ingebrauchnahme;5515000;Münster;X;46;0;0;0;0;1;1;7;6;13;5;19;5;2;7;6;6;6;1;1;27
***100;Diebstahl insgesamt von Kraftwagen einschl. unbefugte Ingebrauchnahme;5162024;Neuss;M;28;0;0;0;0;0;0;2;1;3;5;8;3;4;7;4;7;0;2;0;20
***100;Diebstahl insgesamt von Kraftwagen einschl. unbefugte Ingebrauchnahme;5162024;Neuss;W;0;0;0;0;0;0;0;0;0;0;0;0;0;0;0;0;0;0;0;0;0
***100;Diebstahl insgesamt von Kraftwagen einschl. unbefugte Ingebrauchnahme;5162024;Neuss;X;28;0;0;0;0;0;0;2;1;3;5;8;3;4;7;4;7;0;2;0;20
***100;Diebstahl insgesamt von Kraftwagen einschl. unbefugte Ingebrauchnahme;9564000;Nürnberg;M;51;0;0;0;0;0;0;1;2;3;4;7;2;6;8;11;15;7;1;2;44
***100;Diebstahl insgesamt von Kraftwagen einschl. unbefugte Ingebrauchnahme;9564000;Nürnberg;W;0;0;0;0;0;0;0;0;0;0;0;0;0;0;0;0;0;0;0;0;0
***100;Diebstahl insgesamt von Kraftwagen einschl. unbefugte Ingebrauchnahme;9564000;Nürnberg;X;51;0;0;0;0;0;0;1;2;3;4;7;2;6;8;11;15;7;1;2;44
***100;Diebstahl insgesamt von Kraftwagen einschl. unbefugte Ingebrauchnahme;5119000;Oberhausen;M;16;0;0;0;0;0;0;1;0;1;4;5;0;1;1;2;7;0;0;1;11
***100;Diebstahl insgesamt von Kraftwagen einschl. unbefugte Ingebrauchnahme;5119000;Oberhausen;W;3;0;0;0;0;0;0;0;0;0;0;0;0;0;0;0;0;3;0;0;3
***100;Diebstahl insgesamt von Kraftwagen einschl. unbefugte Ingebrauchnahme;5119000;Oberhausen;X;19;0;0;0;0;0;0;1;0;1;4;5;0;1;1;2;7;3;0;1;14
***100;Diebstahl insgesamt von Kraftwagen einschl. unbefugte Ingebrauchnahme;6413000;Offenbach am Main;M;13;0;0;0;0;0;0;0;0;0;2;2;0;1;1;6;3;0;1;0;11
***100;Diebstahl insgesamt von Kraftwagen einschl. unbefugte Ingebrauchnahme;6413000;Offenbach am Main;W;1;0;0;0;0;0;0;0;0;0;0;0;0;1;1;0;0;0;0;0;1
***100;Diebstahl insgesamt von Kraftwagen einschl. unbefugte Ingebrauchnahme;6413000;Offenbach am Main;X;14;0;0;0;0;0;0;0;0;0;2;2;0;2;2;6;3;0;1;0;12
***100;Diebstahl insgesamt von Kraftwagen einschl. unbefugte Ingebrauchnahme;3403000;Oldenburg (Oldenburg);M;8;0;0;0;0;0;0;0;0;0;3;3;0;1;1;1;2;0;1;0;5
***100;Diebstahl insgesamt von Kraftwagen einschl. unbefugte Ingebrauchnahme;3403000;Oldenburg (Oldenburg);W;2;0;0;0;0;0;0;0;0;0;1;1;0;0;0;1;0;0;0;0;1
***100;Diebstahl insgesamt von Kraftwagen einschl. unbefugte Ingebrauchnahme;3403000;Oldenburg (Oldenburg);X;10;0;0;0;0;0;0;0;0;0;4;4;0;1;1;2;2;0;1;0;6
***100;Diebstahl insgesamt von Kraftwagen einschl. unbefugte Ingebrauchnahme;3404000;Osnabrück;M;23;0;0;0;0;0;0;0;0;0;3;3;2;4;6;4;6;1;2;1;20
***100;Diebstahl insgesamt von Kraftwagen einschl. unbefugte Ingebrauchnahme;3404000;Osnabrück;W;2;0;0;0;0;0;0;0;0;0;0;0;1;0;1;0;1;0;0;0;2
***100;Diebstahl insgesamt von Kraftwagen einschl. unbefugte Ingebrauchnahme;3404000;Osnabrück;X;25;0;0;0;0;0;0;0;0;0;3;3;3;4;7;4;7;1;2;1;22
***100;Diebstahl insgesamt von Kraftwagen einschl. unbefugte Ingebrauchnahme;5774032;Paderborn;M;4;0;0;0;0;0;0;0;0;0;1;1;0;0;0;0;1;2;0;0;3
***100;Diebstahl insgesamt von Kraftwagen einschl. unbefugte Ingebrauchnahme;5774032;Paderborn;W;1;0;0;0;0;0;0;0;0;0;1;1;0;0;0;0;0;0;0;0;0
***100;Diebstahl insgesamt von Kraftwagen einschl. unbefugte Ingebrauchnahme;5774032;Paderborn;X;5;0;0;0;0;0;0;0;0;0;2;2;0;0;0;0;1;2;0;0;3
***100;Diebstahl insgesamt von Kraftwagen einschl. unbefugte Ingebrauchnahme;8231000;Pforzheim;M;12;0;0;0;0;0;0;0;1;1;1;2;1;2;3;1;3;1;2;0;10
***100;Diebstahl insgesamt von Kraftwagen einschl. unbefugte Ingebrauchnahme;8231000;Pforzheim;W;3;0;0;0;0;0;0;0;0;0;0;0;0;0;0;2;0;0;1;0;3
***100;Diebstahl insgesamt von Kraftwagen einschl. unbefugte Ingebrauchnahme;8231000;Pforzheim;X;15;0;0;0;0;0;0;0;1;1;1;2;1;2;3;3;3;1;3;0;13
***100;Diebstahl insgesamt von Kraftwagen einschl. unbefugte Ingebrauchnahme;12054000;Potsdam;M;55;0;0;0;0;1;1;1;1;2;6;9;6;2;8;7;23;3;4;1;46
***100;Diebstahl insgesamt von Kraftwagen einschl. unbefugte Ingebrauchnahme;12054000;Potsdam;W;3;0;0;0;0;0;0;0;0;0;0;0;0;0;0;2;1;0;0;0;3
***100;Diebstahl insgesamt von Kraftwagen einschl. unbefugte Ingebrauchnahme;12054000;Potsdam;X;58;0;0;0;0;1;1;1;1;2;6;9;6;2;8;9;24;3;4;1;49
***100;Diebstahl insgesamt von Kraftwagen einschl. unbefugte Ingebrauchnahme;5562032;Recklinghausen;M;8;0;0;0;0;0;0;0;0;0;2;2;2;0;2;2;2;0;0;0;6
***100;Diebstahl insgesamt von Kraftwagen einschl. unbefugte Ingebrauchnahme;5562032;Recklinghausen;W;1;0;0;0;0;0;0;0;0;0;0;0;0;0;0;0;1;0;0;0;1
***100;Diebstahl insgesamt von Kraftwagen einschl. unbefugte Ingebrauchnahme;5562032;Recklinghausen;X;9;0;0;0;0;0;0;0;0;0;2;2;2;0;2;2;3;0;0;0;7
***100;Diebstahl insgesamt von Kraftwagen einschl. unbefugte Ingebrauchnahme;9362000;Regensburg;M;42;0;0;0;0;0;0;0;2;2;3;5;5;4;9;8;14;2;3;1;37
***100;Diebstahl insgesamt von Kraftwagen einschl. unbefugte Ingebrauchnahme;9362000;Regensburg;W;3;0;0;0;0;0;0;0;0;0;1;1;0;0;0;0;1;1;0;0;2
***100;Diebstahl insgesamt von Kraftwagen einschl. unbefugte Ingebrauchnahme;9362000;Regensburg;X;45;0;0;0;0;0;0;0;2;2;4;6;5;4;9;8;15;3;3;1;39
***100;Diebstahl insgesamt von Kraftwagen einschl. unbefugte Ingebrauchnahme;5120000;Remscheid;M;5;0;0;0;0;0;0;0;1;1;0;1;0;0;0;0;0;3;1;0;4
***100;Diebstahl insgesamt von Kraftwagen einschl. unbefugte Ingebrauchnahme;5120000;Remscheid;W;0;0;0;0;0;0;0;0;0;0;0;0;0;0;0;0;0;0;0;0;0
***100;Diebstahl insgesamt von Kraftwagen einschl. unbefugte Ingebrauchnahme;5120000;Remscheid;X;5;0;0;0;0;0;0;0;1;1;0;1;0;0;0;0;0;3;1;0;4
***100;Diebstahl insgesamt von Kraftwagen einschl. unbefugte Ingebrauchnahme;8415061;Reutlingen;M;7;0;0;0;0;0;0;0;0;0;1;1;3;1;4;1;1;0;0;0;6
***100;Diebstahl insgesamt von Kraftwagen einschl. unbefugte Ingebrauchnahme;8415061;Reutlingen;W;0;0;0;0;0;0;0;0;0;0;0;0;0;0;0;0;0;0;0;0;0
***100;Diebstahl insgesamt von Kraftwagen einschl. unbefugte Ingebrauchnahme;8415061;Reutlingen;X;7;0;0;0;0;0;0;0;0;0;1;1;3;1;4;1;1;0;0;0;6
***100;Diebstahl insgesamt von Kraftwagen einschl. unbefugte Ingebrauchnahme;13003000;Rostock;M;23;0;0;0;0;0;0;0;0;0;2;2;3;2;5;5;10;1;0;0;21
***100;Diebstahl insgesamt von Kraftwagen einschl. unbefugte Ingebrauchnahme;13003000;Rostock;W;0;0;0;0;0;0;0;0;0;0;0;0;0;0;0;0;0;0;0;0;0
***100;Diebstahl insgesamt von Kraftwagen einschl. unbefugte Ingebrauchnahme;13003000;Rostock;X;23;0;0;0;0;0;0;0;0;0;2;2;3;2;5;5;10;1;0;0;21
***100;Diebstahl insgesamt von Kraftwagen einschl. unbefugte Ingebrauchnahme;10041100;Saarbrücken;M;24;0;0;0;1;1;2;1;2;3;2;7;1;5;6;2;4;5;0;0;17
***100;Diebstahl insgesamt von Kraftwagen einschl. unbefugte Ingebrauchnahme;10041100;Saarbrücken;W;1;0;0;0;0;0;0;0;0;0;0;0;0;0;0;0;0;1;0;0;1
***100;Diebstahl insgesamt von Kraftwagen einschl. unbefugte Ingebrauchnahme;10041100;Saarbrücken;X;25;0;0;0;1;1;2;1;2;3;2;7;1;5;6;2;4;6;0;0;18
***100;Diebstahl insgesamt von Kraftwagen einschl. unbefugte Ingebrauchnahme;5122000;Solingen;M;22;0;0;0;0;0;0;1;4;5;3;8;0;2;2;2;6;3;1;0;14
***100;Diebstahl insgesamt von Kraftwagen einschl. unbefugte Ingebrauchnahme;5122000;Solingen;W;2;0;0;0;0;0;0;0;0;0;0;0;0;1;1;0;0;0;1;0;2
***100;Diebstahl insgesamt von Kraftwagen einschl. unbefugte Ingebrauchnahme;5122000;Solingen;X;24;0;0;0;0;0;0;1;4;5;3;8;0;3;3;2;6;3;2;0;16
***100;Diebstahl insgesamt von Kraftwagen einschl. unbefugte Ingebrauchnahme;8111000;Stuttgart;M;37;0;0;0;0;0;0;1;2;3;9;12;2;3;5;1;9;8;1;1;25
***100;Diebstahl insgesamt von Kraftwagen einschl. unbefugte Ingebrauchnahme;8111000;Stuttgart;W;7;0;0;0;0;1;1;2;0;2;0;3;0;2;2;2;0;0;0;0;4
***100;Diebstahl insgesamt von Kraftwagen einschl. unbefugte Ingebrauchnahme;8111000;Stuttgart;X;44;0;0;0;0;1;1;3;2;5;9;15;2;5;7;3;9;8;1;1;29
***100;Diebstahl insgesamt von Kraftwagen einschl. unbefugte Ingebrauchnahme;7211000;Trier;M;4;0;0;0;0;0;0;1;0;1;0;1;1;0;1;2;0;0;0;0;3
***100;Diebstahl insgesamt von Kraftwagen einschl. unbefugte Ingebrauchnahme;7211000;Trier;W;0;0;0;0;0;0;0;0;0;0;0;0;0;0;0;0;0;0;0;0;0
***100;Diebstahl insgesamt von Kraftwagen einschl. unbefugte Ingebrauchnahme;7211000;Trier;X;4;0;0;0;0;0;0;1;0;1;0;1;1;0;1;2;0;0;0;0;3
***100;Diebstahl insgesamt von Kraftwagen einschl. unbefugte Ingebrauchnahme;8421000;Ulm;M;12;0;0;0;0;0;0;0;0;0;1;1;2;4;6;0;5;0;0;0;11
***100;Diebstahl insgesamt von Kraftwagen einschl. unbefugte Ingebrauchnahme;8421000;Ulm;W;0;0;0;0;0;0;0;0;0;0;0;0;0;0;0;0;0;0;0;0;0
***100;Diebstahl insgesamt von Kraftwagen einschl. unbefugte Ingebrauchnahme;8421000;Ulm;X;12;0;0;0;0;0;0;0;0;0;1;1;2;4;6;0;5;0;0;0;11
***100;Diebstahl insgesamt von Kraftwagen einschl. unbefugte Ingebrauchnahme;6414000;Wiesbaden;M;37;0;0;0;0;0;0;0;3;3;5;8;6;1;7;9;9;4;0;0;29
***100;Diebstahl insgesamt von Kraftwagen einschl. unbefugte Ingebrauchnahme;6414000;Wiesbaden;W;5;0;0;0;0;0;0;1;1;2;0;2;0;0;0;0;1;2;0;0;3
***100;Diebstahl insgesamt von Kraftwagen einschl. unbefugte Ingebrauchnahme;6414000;Wiesbaden;X;42;0;0;0;0;0;0;1;4;5;5;10;6;1;7;9;10;6;0;0;32
***100;Diebstahl insgesamt von Kraftwagen einschl. unbefugte Ingebrauchnahme;3103000;Wolfsburg;M;31;0;0;0;0;0;0;0;0;0;0;0;1;3;4;5;14;3;4;1;31
***100;Diebstahl insgesamt von Kraftwagen einschl. unbefugte Ingebrauchnahme;3103000;Wolfsburg;W;1;0;0;0;0;0;0;0;0;0;0;0;0;0;0;0;1;0;0;0;1
***100;Diebstahl insgesamt von Kraftwagen einschl. unbefugte Ingebrauchnahme;3103000;Wolfsburg;X;32;0;0;0;0;0;0;0;0;0;0;0;1;3;4;5;15;3;4;1;32
***100;Diebstahl insgesamt von Kraftwagen einschl. unbefugte Ingebrauchnahme;5124000;Wuppertal;M;28;0;0;0;0;0;0;3;1;4;1;5;2;2;4;3;6;8;0;2;23
***100;Diebstahl insgesamt von Kraftwagen einschl. unbefugte Ingebrauchnahme;5124000;Wuppertal;W;4;0;0;0;0;0;0;0;0;0;2;2;0;0;0;0;0;1;1;0;2
***100;Diebstahl insgesamt von Kraftwagen einschl. unbefugte Ingebrauchnahme;5124000;Wuppertal;X;32;0;0;0;0;0;0;3;1;4;3;7;2;2;4;3;6;9;1;2;25
***100;Diebstahl insgesamt von Kraftwagen einschl. unbefugte Ingebrauchnahme;9663000;Würzburg;M;7;0;0;0;0;0;0;0;0;0;0;0;1;0;1;1;3;1;0;1;7
***100;Diebstahl insgesamt von Kraftwagen einschl. unbefugte Ingebrauchnahme;9663000;Würzburg;W;0;0;0;0;0;0;0;0;0;0;0;0;0;0;0;0;0;0;0;0;0
***100;Diebstahl insgesamt von Kraftwagen einschl. unbefugte Ingebrauchnahme;9663000;Würzburg;X;7;0;0;0;0;0;0;0;0;0;0;0;1;0;1;1;3;1;0;1;7
***200;Diebstahl insgesamt von Mopeds und Krafträdern einschl. unbefugte Ingebrauchnahme;5334002;Aachen;M;54;0;0;0;0;1;1;6;14;20;11;32;2;2;4;4;6;5;1;2;22
***200;Diebstahl insgesamt von Mopeds und Krafträdern einschl. unbefugte Ingebrauchnahme;5334002;Aachen;W;0;0;0;0;0;0;0;0;0;0;0;0;0;0;0;0;0;0;0;0;0
***200;Diebstahl insgesamt von Mopeds und Krafträdern einschl. unbefugte Ingebrauchnahme;5334002;Aachen;X;54;0;0;0;0;1;1;6;14;20;11;32;2;2;4;4;6;5;1;2;22
***200;Diebstahl insgesamt von Mopeds und Krafträdern einschl. unbefugte Ingebrauchnahme;9761000;Augsburg;M;13;0;0;0;0;0;0;4;2;6;0;6;2;2;4;2;1;0;0;0;7
***200;Diebstahl insgesamt von Mopeds und Krafträdern einschl. unbefugte Ingebrauchnahme;9761000;Augsburg;W;0;0;0;0;0;0;0;0;0;0;0;0;0;0;0;0;0;0;0;0;0
***200;Diebstahl insgesamt von Mopeds und Krafträdern einschl. unbefugte Ingebrauchnahme;9761000;Augsburg;X;13;0;0;0;0;0;0;4;2;6;0;6;2;2;4;2;1;0;0;0;7
***200;Diebstahl insgesamt von Mopeds und Krafträdern einschl. unbefugte Ingebrauchnahme;5378004;Bergisch Gladbach;M;6;0;0;0;0;0;0;0;0;0;1;1;1;2;3;1;0;1;0;0;5
***200;Diebstahl insgesamt von Mopeds und Krafträdern einschl. unbefugte Ingebrauchnahme;5378004;Bergisch Gladbach;W;0;0;0;0;0;0;0;0;0;0;0;0;0;0;0;0;0;0;0;0;0
***200;Diebstahl insgesamt von Mopeds und Krafträdern einschl. unbefugte Ingebrauchnahme;5378004;Bergisch Gladbach;X;6;0;0;0;0;0;0;0;0;0;1;1;1;2;3;1;0;1;0;0;5
***200;Diebstahl insgesamt von Mopeds und Krafträdern einschl. unbefugte Ingebrauchnahme;11000000;Berlin;M;246;0;0;0;0;8;8;32;48;80;43;131;22;14;36;27;39;8;5;0;115
***200;Diebstahl insgesamt von Mopeds und Krafträdern einschl. unbefugte Ingebrauchnahme;11000000;Berlin;W;3;0;0;0;0;0;0;1;1;2;0;2;0;0;0;1;0;0;0;0;1
***200;Diebstahl insgesamt von Mopeds und Krafträdern einschl. unbefugte Ingebrauchnahme;11000000;Berlin;X;249;0;0;0;0;8;8;33;49;82;43;133;22;14;36;28;39;8;5;0;116
***200;Diebstahl insgesamt von Mopeds und Krafträdern einschl. unbefugte Ingebrauchnahme;5711000;Bielefeld;M;29;0;0;0;0;0;0;11;9;20;4;24;1;2;3;0;1;1;0;0;5
***200;Diebstahl insgesamt von Mopeds und Krafträdern einschl. unbefugte Ingebrauchnahme;5711000;Bielefeld;W;1;0;0;0;0;0;0;0;0;0;0;0;1;0;1;0;0;0;0;0;1
***200;Diebstahl insgesamt von Mopeds und Krafträdern einschl. unbefugte Ingebrauchnahme;5711000;Bielefeld;X;30;0;0;0;0;0;0;11;9;20;4;24;2;2;4;0;1;1;0;0;6
***200;Diebstahl insgesamt von Mopeds und Krafträdern einschl. unbefugte Ingebrauchnahme;5911000;Bochum;M;18;0;0;0;0;0;0;0;2;2;3;5;1;1;2;5;4;1;1;0;13
***200;Diebstahl insgesamt von Mopeds und Krafträdern einschl. unbefugte Ingebrauchnahme;5911000;Bochum;W;1;0;0;0;0;0;0;0;1;1;0;1;0;0;0;0;0;0;0;0;0
***200;Diebstahl insgesamt von Mopeds und Krafträdern einschl. unbefugte Ingebrauchnahme;5911000;Bochum;X;19;0;0;0;0;0;0;0;3;3;3;6;1;1;2;5;4;1;1;0;13
***200;Diebstahl insgesamt von Mopeds und Krafträdern einschl. unbefugte Ingebrauchnahme;5314000;Bonn;M;51;0;1;0;5;9;15;5;7;12;5;32;5;3;8;4;6;0;1;0;19
***200;Diebstahl insgesamt von Mopeds und Krafträdern einschl. unbefugte Ingebrauchnahme;5314000;Bonn;W;0;0;0;0;0;0;0;0;0;0;0;0;0;0;0;0;0;0;0;0;0
***200;Diebstahl insgesamt von Mopeds und Krafträdern einschl. unbefugte Ingebrauchnahme;5314000;Bonn;X;51;0;1;0;5;9;15;5;7;12;5;32;5;3;8;4;6;0;1;0;19
***200;Diebstahl insgesamt von Mopeds und Krafträdern einschl. unbefugte Ingebrauchnahme;5512000;Bottrop;M;8;0;0;0;0;0;0;2;3;5;2;7;0;0;0;0;0;1;0;0;1
***200;Diebstahl insgesamt von Mopeds und Krafträdern einschl. unbefugte Ingebrauchnahme;5512000;Bottrop;W;1;0;0;0;0;0;0;0;1;1;0;1;0;0;0;0;0;0;0;0;0
***200;Diebstahl insgesamt von Mopeds und Krafträdern einschl. unbefugte Ingebrauchnahme;5512000;Bottrop;X;9;0;0;0;0;0;0;2;4;6;2;8;0;0;0;0;0;1;0;0;1
***200;Diebstahl insgesamt von Mopeds und Krafträdern einschl. unbefugte Ingebrauchnahme;3101000;Braunschweig;M;9;0;0;0;0;0;0;1;0;1;2;3;0;2;2;1;1;1;0;1;6
***200;Diebstahl insgesamt von Mopeds und Krafträdern einschl. unbefugte Ingebrauchnahme;3101000;Braunschweig;W;0;0;0;0;0;0;0;0;0;0;0;0;0;0;0;0;0;0;0;0;0
***200;Diebstahl insgesamt von Mopeds und Krafträdern einschl. unbefugte Ingebrauchnahme;3101000;Braunschweig;X;9;0;0;0;0;0;0;1;0;1;2;3;0;2;2;1;1;1;0;1;6
***200;Diebstahl insgesamt von Mopeds und Krafträdern einschl. unbefugte Ingebrauchnahme;4011000;Bremen;M;27;0;0;0;0;0;0;5;5;10;7;17;3;3;6;1;2;0;1;0;10
***200;Diebstahl insgesamt von Mopeds und Krafträdern einschl. unbefugte Ingebrauchnahme;4011000;Bremen;W;1;0;0;0;0;0;0;0;0;0;0;0;0;0;0;0;0;1;0;0;1
***200;Diebstahl insgesamt von Mopeds und Krafträdern einschl. unbefugte Ingebrauchnahme;4011000;Bremen;X;28;0;0;0;0;0;0;5;5;10;7;17;3;3;6;1;2;1;1;0;11
***200;Diebstahl insgesamt von Mopeds und Krafträdern einschl. unbefugte Ingebrauchnahme;4012000;Bremerhaven;M;8;0;0;0;0;0;0;1;4;5;2;7;0;0;0;0;1;0;0;0;1
***200;Diebstahl insgesamt von Mopeds und Krafträdern einschl. unbefugte Ingebrauchnahme;4012000;Bremerhaven;W;0;0;0;0;0;0;0;0;0;0;0;0;0;0;0;0;0;0;0;0;0
***200;Diebstahl insgesamt von Mopeds und Krafträdern einschl. unbefugte Ingebrauchnahme;4012000;Bremerhaven;X;8;0;0;0;0;0;0;1;4;5;2;7;0;0;0;0;1;0;0;0;1
***200;Diebstahl insgesamt von Mopeds und Krafträdern einschl. unbefugte Ingebrauchnahme;14511000;Chemnitz;M;13;0;0;0;0;0;0;0;1;1;0;1;3;0;3;1;6;2;0;0;12
***200;Diebstahl insgesamt von Mopeds und Krafträdern einschl. unbefugte Ingebrauchnahme;14511000;Chemnitz;W;0;0;0;0;0;0;0;0;0;0;0;0;0;0;0;0;0;0;0;0;0
***200;Diebstahl insgesamt von Mopeds und Krafträdern einschl. unbefugte Ingebrauchnahme;14511000;Chemnitz;X;13;0;0;0;0;0;0;0;1;1;0;1;3;0;3;1;6;2;0;0;12
***200;Diebstahl insgesamt von Mopeds und Krafträdern einschl. unbefugte Ingebrauchnahme;6411000;Darmstadt;M;31;0;0;0;0;1;1;11;7;18;7;26;3;1;4;0;1;0;0;0;5
***200;Diebstahl insgesamt von Mopeds und Krafträdern einschl. unbefugte Ingebrauchnahme;6411000;Darmstadt;W;0;0;0;0;0;0;0;0;0;0;0;0;0;0;0;0;0;0;0;0;0
***200;Diebstahl insgesamt von Mopeds und Krafträdern einschl. unbefugte Ingebrauchnahme;6411000;Darmstadt;X;31;0;0;0;0;1;1;11;7;18;7;26;3;1;4;0;1;0;0;0;5
***200;Diebstahl insgesamt von Mopeds und Krafträdern einschl. unbefugte Ingebrauchnahme;5913000;Dortmund;M;33;0;0;0;0;0;0;5;6;11;5;16;5;2;7;4;3;2;1;0;17
***200;Diebstahl insgesamt von Mopeds und Krafträdern einschl. unbefugte Ingebrauchnahme;5913000;Dortmund;W;0;0;0;0;0;0;0;0;0;0;0;0;0;0;0;0;0;0;0;0;0
***200;Diebstahl insgesamt von Mopeds und Krafträdern einschl. unbefugte Ingebrauchnahme;5913000;Dortmund;X;33;0;0;0;0;0;0;5;6;11;5;16;5;2;7;4;3;2;1;0;17
***200;Diebstahl insgesamt von Mopeds und Krafträdern einschl. unbefugte Ingebrauchnahme;14612000;Dresden;M;40;0;0;0;0;0;0;0;1;1;1;2;3;6;9;11;17;1;0;0;38
***200;Diebstahl insgesamt von Mopeds und Krafträdern einschl. unbefugte Ingebrauchnahme;14612000;Dresden;W;1;0;0;0;0;0;0;0;0;0;0;0;0;0;0;0;0;1;0;0;1
***200;Diebstahl insgesamt von Mopeds und Krafträdern einschl. unbefugte Ingebrauchnahme;14612000;Dresden;X;41;0;0;0;0;0;0;0;1;1;1;2;3;6;9;11;17;2;0;0;39
***200;Diebstahl insgesamt von Mopeds und Krafträdern einschl. unbefugte Ingebrauchnahme;5112000;Duisburg;M;36;0;0;0;0;2;2;4;6;10;8;20;1;2;3;8;3;2;0;0;16
***200;Diebstahl insgesamt von Mopeds und Krafträdern einschl. unbefugte Ingebrauchnahme;5112000;Duisburg;W;1;0;0;0;0;0;0;0;0;0;0;0;0;0;0;0;0;1;0;0;1
***200;Diebstahl insgesamt von Mopeds und Krafträdern einschl. unbefugte Ingebrauchnahme;5112000;Duisburg;X;37;0;0;0;0;2;2;4;6;10;8;20;1;2;3;8;3;3;0;0;17
***200;Diebstahl insgesamt von Mopeds und Krafträdern einschl. unbefugte Ingebrauchnahme;5111000;Düsseldorf;M;63;0;0;0;0;5;5;10;11;21;12;38;3;5;8;6;4;4;3;0;25
***200;Diebstahl insgesamt von Mopeds und Krafträdern einschl. unbefugte Ingebrauchnahme;5111000;Düsseldorf;W;6;0;0;0;0;0;0;0;2;2;0;2;0;1;1;0;2;1;0;0;4
***200;Diebstahl insgesamt von Mopeds und Krafträdern einschl. unbefugte Ingebrauchnahme;5111000;Düsseldorf;X;69;0;0;0;0;5;5;10;13;23;12;40;3;6;9;6;6;5;3;0;29
***200;Diebstahl insgesamt von Mopeds und Krafträdern einschl. unbefugte Ingebrauchnahme;16051000;Erfurt;M;15;0;0;0;0;0;0;1;4;5;1;6;1;2;3;0;3;3;0;0;9
***200;Diebstahl insgesamt von Mopeds und Krafträdern einschl. unbefugte Ingebrauchnahme;16051000;Erfurt;W;0;0;0;0;0;0;0;0;0;0;0;0;0;0;0;0;0;0;0;0;0
***200;Diebstahl insgesamt von Mopeds und Krafträdern einschl. unbefugte Ingebrauchnahme;16051000;Erfurt;X;15;0;0;0;0;0;0;1;4;5;1;6;1;2;3;0;3;3;0;0;9
***200;Diebstahl insgesamt von Mopeds und Krafträdern einschl. unbefugte Ingebrauchnahme;9562000;Erlangen;M;8;0;0;0;0;0;0;3;1;4;1;5;1;0;1;1;1;0;0;0;3
***200;Diebstahl insgesamt von Mopeds und Krafträdern einschl. unbefugte Ingebrauchnahme;9562000;Erlangen;W;0;0;0;0;0;0;0;0;0;0;0;0;0;0;0;0;0;0;0;0;0
***200;Diebstahl insgesamt von Mopeds und Krafträdern einschl. unbefugte Ingebrauchnahme;9562000;Erlangen;X;8;0;0;0;0;0;0;3;1;4;1;5;1;0;1;1;1;0;0;0;3
***200;Diebstahl insgesamt von Mopeds und Krafträdern einschl. unbefugte Ingebrauchnahme;5113000;Essen;M;84;0;0;0;0;8;8;21;24;45;12;65;6;2;8;2;4;4;0;1;19
***200;Diebstahl insgesamt von Mopeds und Krafträdern einschl. unbefugte Ingebrauchnahme;5113000;Essen;W;3;0;0;0;0;0;0;1;0;1;0;1;1;0;1;0;1;0;0;0;2
***200;Diebstahl insgesamt von Mopeds und Krafträdern einschl. unbefugte Ingebrauchnahme;5113000;Essen;X;87;0;0;0;0;8;8;22;24;46;12;66;7;2;9;2;5;4;0;1;21
***200;Diebstahl insgesamt von Mopeds und Krafträdern einschl. unbefugte Ingebrauchnahme;6412000;Frankfurt am Main;M;36;0;0;0;1;3;4;10;6;16;11;31;1;0;1;2;0;1;1;0;5
***200;Diebstahl insgesamt von Mopeds und Krafträdern einschl. unbefugte Ingebrauchnahme;6412000;Frankfurt am Main;W;2;0;0;0;0;0;0;1;0;1;1;2;0;0;0;0;0;0;0;0;0
***200;Diebstahl insgesamt von Mopeds und Krafträdern einschl. unbefugte Ingebrauchnahme;6412000;Frankfurt am Main;X;38;0;0;0;1;3;4;11;6;17;12;33;1;0;1;2;0;1;1;0;5
***200;Diebstahl insgesamt von Mopeds und Krafträdern einschl. unbefugte Ingebrauchnahme;8311000;Freiburg im Breisgau;M;42;0;0;0;0;0;0;7;14;21;12;33;1;3;4;1;1;3;0;0;9
***200;Diebstahl insgesamt von Mopeds und Krafträdern einschl. unbefugte Ingebrauchnahme;8311000;Freiburg im Breisgau;W;2;0;0;0;0;0;0;0;0;0;1;1;0;1;1;0;0;0;0;0;1
***200;Diebstahl insgesamt von Mopeds und Krafträdern einschl. unbefugte Ingebrauchnahme;8311000;Freiburg im Breisgau;X;44;0;0;0;0;0;0;7;14;21;13;34;1;4;5;1;1;3;0;0;10
***200;Diebstahl insgesamt von Mopeds und Krafträdern einschl. unbefugte Ingebrauchnahme;9563000;Fürth;M;3;0;0;0;0;0;0;0;1;1;0;1;0;1;1;0;1;0;0;0;2
***200;Diebstahl insgesamt von Mopeds und Krafträdern einschl. unbefugte Ingebrauchnahme;9563000;Fürth;W;0;0;0;0;0;0;0;0;0;0;0;0;0;0;0;0;0;0;0;0;0
***200;Diebstahl insgesamt von Mopeds und Krafträdern einschl. unbefugte Ingebrauchnahme;9563000;Fürth;X;3;0;0;0;0;0;0;0;1;1;0;1;0;1;1;0;1;0;0;0;2
***200;Diebstahl insgesamt von Mopeds und Krafträdern einschl. unbefugte Ingebrauchnahme;5513000;Gelsenkirchen;M;19;0;0;0;0;0;0;4;5;9;6;15;0;1;1;1;1;0;0;1;4
***200;Diebstahl insgesamt von Mopeds und Krafträdern einschl. unbefugte Ingebrauchnahme;5513000;Gelsenkirchen;W;1;0;0;0;0;0;0;1;0;1;0;1;0;0;0;0;0;0;0;0;0
***200;Diebstahl insgesamt von Mopeds und Krafträdern einschl. unbefugte Ingebrauchnahme;5513000;Gelsenkirchen;X;20;0;0;0;0;0;0;5;5;10;6;16;0;1;1;1;1;0;0;1;4
***200;Diebstahl insgesamt von Mopeds und Krafträdern einschl. unbefugte Ingebrauchnahme;3152012;Göttingen;M;8;0;0;0;0;0;0;1;2;3;0;3;2;0;2;0;0;2;1;0;5
***200;Diebstahl insgesamt von Mopeds und Krafträdern einschl. unbefugte Ingebrauchnahme;3152012;Göttingen;W;0;0;0;0;0;0;0;0;0;0;0;0;0;0;0;0;0;0;0;0;0
***200;Diebstahl insgesamt von Mopeds und Krafträdern einschl. unbefugte Ingebrauchnahme;3152012;Göttingen;X;8;0;0;0;0;0;0;1;2;3;0;3;2;0;2;0;0;2;1;0;5
***200;Diebstahl insgesamt von Mopeds und Krafträdern einschl. unbefugte Ingebrauchnahme;5914000;Hagen;M;14;0;0;0;0;0;0;3;1;4;5;9;1;0;1;2;2;0;0;0;5
***200;Diebstahl insgesamt von Mopeds und Krafträdern einschl. unbefugte Ingebrauchnahme;5914000;Hagen;W;1;0;0;0;0;0;0;0;0;0;1;1;0;0;0;0;0;0;0;0;0
***200;Diebstahl insgesamt von Mopeds und Krafträdern einschl. unbefugte Ingebrauchnahme;5914000;Hagen;X;15;0;0;0;0;0;0;3;1;4;6;10;1;0;1;2;2;0;0;0;5
***200;Diebstahl insgesamt von Mopeds und Krafträdern einschl. unbefugte Ingebrauchnahme;15002000;Halle (Saale);M;14;0;0;0;0;0;0;2;0;2;0;2;2;0;2;4;6;0;0;0;12
***200;Diebstahl insgesamt von Mopeds und Krafträdern einschl. unbefugte Ingebrauchnahme;15002000;Halle (Saale);W;1;0;0;0;0;0;0;0;0;0;0;0;0;0;0;1;0;0;0;0;1
***200;Diebstahl insgesamt von Mopeds und Krafträdern einschl. unbefugte Ingebrauchnahme;15002000;Halle (Saale);X;15;0;0;0;0;0;0;2;0;2;0;2;2;0;2;5;6;0;0;0;13
***200;Diebstahl insgesamt von Mopeds und Krafträdern einschl. unbefugte Ingebrauchnahme;2000000;Hamburg;M;61;0;0;0;2;2;4;6;14;20;11;35;3;3;6;9;10;1;0;0;26
***200;Diebstahl insgesamt von Mopeds und Krafträdern einschl. unbefugte Ingebrauchnahme;2000000;Hamburg;W;1;0;0;0;0;0;0;0;0;0;0;0;0;0;0;0;0;0;1;0;1
***200;Diebstahl insgesamt von Mopeds und Krafträdern einschl. unbefugte Ingebrauchnahme;2000000;Hamburg;X;62;0;0;0;2;2;4;6;14;20;11;35;3;3;6;9;10;1;1;0;27
***200;Diebstahl insgesamt von Mopeds und Krafträdern einschl. unbefugte Ingebrauchnahme;5915000;Hamm;M;23;0;0;0;0;0;0;9;3;12;6;18;1;0;1;1;2;1;0;0;5
***200;Diebstahl insgesamt von Mopeds und Krafträdern einschl. unbefugte Ingebrauchnahme;5915000;Hamm;W;0;0;0;0;0;0;0;0;0;0;0;0;0;0;0;0;0;0;0;0;0
***200;Diebstahl insgesamt von Mopeds und Krafträdern einschl. unbefugte Ingebrauchnahme;5915000;Hamm;X;23;0;0;0;0;0;0;9;3;12;6;18;1;0;1;1;2;1;0;0;5
***200;Diebstahl insgesamt von Mopeds und Krafträdern einschl. unbefugte Ingebrauchnahme;3241001;Hannover;M;53;0;0;0;0;4;4;8;11;19;10;33;3;2;5;4;4;7;0;0;20
***200;Diebstahl insgesamt von Mopeds und Krafträdern einschl. unbefugte Ingebrauchnahme;3241001;Hannover;W;1;0;0;0;0;0;0;0;1;1;0;1;0;0;0;0;0;0;0;0;0
***200;Diebstahl insgesamt von Mopeds und Krafträdern einschl. unbefugte Ingebrauchnahme;3241001;Hannover;X;54;0;0;0;0;4;4;8;12;20;10;34;3;2;5;4;4;7;0;0;20
***200;Diebstahl insgesamt von Mopeds und Krafträdern einschl. unbefugte Ingebrauchnahme;8221000;Heidelberg;M;7;0;0;0;0;1;1;1;3;4;1;6;1;0;1;0;0;0;0;0;1
***200;Diebstahl insgesamt von Mopeds und Krafträdern einschl. unbefugte Ingebrauchnahme;8221000;Heidelberg;W;0;0;0;0;0;0;0;0;0;0;0;0;0;0;0;0;0;0;0;0;0
***200;Diebstahl insgesamt von Mopeds und Krafträdern einschl. unbefugte Ingebrauchnahme;8221000;Heidelberg;X;7;0;0;0;0;1;1;1;3;4;1;6;1;0;1;0;0;0;0;0;1
***200;Diebstahl insgesamt von Mopeds und Krafträdern einschl. unbefugte Ingebrauchnahme;8121000;Heilbronn;M;12;0;0;0;0;0;0;0;2;2;1;3;2;2;4;0;3;2;0;0;9
***200;Diebstahl insgesamt von Mopeds und Krafträdern einschl. unbefugte Ingebrauchnahme;8121000;Heilbronn;W;2;0;0;0;0;0;0;0;0;0;1;1;0;0;0;0;1;0;0;0;1
***200;Diebstahl insgesamt von Mopeds und Krafträdern einschl. unbefugte Ingebrauchnahme;8121000;Heilbronn;X;14;0;0;0;0;0;0;0;2;2;2;4;2;2;4;0;4;2;0;0;10
***200;Diebstahl insgesamt von Mopeds und Krafträdern einschl. unbefugte Ingebrauchnahme;5916000;Herne;M;23;0;0;0;0;0;0;6;4;10;8;18;0;1;1;2;0;1;1;0;5
***200;Diebstahl insgesamt von Mopeds und Krafträdern einschl. unbefugte Ingebrauchnahme;5916000;Herne;W;1;0;0;0;0;0;0;0;0;0;0;0;0;1;1;0;0;0;0;0;1
***200;Diebstahl insgesamt von Mopeds und Krafträdern einschl. unbefugte Ingebrauchnahme;5916000;Herne;X;24;0;0;0;0;0;0;6;4;10;8;18;0;2;2;2;0;1;1;0;6
***200;Diebstahl insgesamt von Mopeds und Krafträdern einschl. unbefugte Ingebrauchnahme;9161000;Ingolstadt;M;14;0;0;0;0;0;0;5;4;9;2;11;0;1;1;2;0;0;0;0;3
***200;Diebstahl insgesamt von Mopeds und Krafträdern einschl. unbefugte Ingebrauchnahme;9161000;Ingolstadt;W;0;0;0;0;0;0;0;0;0;0;0;0;0;0;0;0;0;0;0;0;0
***200;Diebstahl insgesamt von Mopeds und Krafträdern einschl. unbefugte Ingebrauchnahme;9161000;Ingolstadt;X;14;0;0;0;0;0;0;5;4;9;2;11;0;1;1;2;0;0;0;0;3
***200;Diebstahl insgesamt von Mopeds und Krafträdern einschl. unbefugte Ingebrauchnahme;16053000;Jena;M;4;0;0;0;0;0;0;0;0;0;0;0;1;0;1;2;1;0;0;0;4
***200;Diebstahl insgesamt von Mopeds und Krafträdern einschl. unbefugte Ingebrauchnahme;16053000;Jena;W;0;0;0;0;0;0;0;0;0;0;0;0;0;0;0;0;0;0;0;0;0
***200;Diebstahl insgesamt von Mopeds und Krafträdern einschl. unbefugte Ingebrauchnahme;16053000;Jena;X;4;0;0;0;0;0;0;0;0;0;0;0;1;0;1;2;1;0;0;0;4
***200;Diebstahl insgesamt von Mopeds und Krafträdern einschl. unbefugte Ingebrauchnahme;8212000;Karlsruhe;M;15;0;0;0;0;1;1;4;6;10;1;12;1;1;2;0;1;0;0;0;3
***200;Diebstahl insgesamt von Mopeds und Krafträdern einschl. unbefugte Ingebrauchnahme;8212000;Karlsruhe;W;0;0;0;0;0;0;0;0;0;0;0;0;0;0;0;0;0;0;0;0;0
***200;Diebstahl insgesamt von Mopeds und Krafträdern einschl. unbefugte Ingebrauchnahme;8212000;Karlsruhe;X;15;0;0;0;0;1;1;4;6;10;1;12;1;1;2;0;1;0;0;0;3
***200;Diebstahl insgesamt von Mopeds und Krafträdern einschl. unbefugte Ingebrauchnahme;6611000;Kassel;M;15;0;0;0;0;1;1;2;3;5;1;7;2;2;4;1;1;2;0;0;8
***200;Diebstahl insgesamt von Mopeds und Krafträdern einschl. unbefugte Ingebrauchnahme;6611000;Kassel;W;0;0;0;0;0;0;0;0;0;0;0;0;0;0;0;0;0;0;0;0;0
***200;Diebstahl insgesamt von Mopeds und Krafträdern einschl. unbefugte Ingebrauchnahme;6611000;Kassel;X;15;0;0;0;0;1;1;2;3;5;1;7;2;2;4;1;1;2;0;0;8
***200;Diebstahl insgesamt von Mopeds und Krafträdern einschl. unbefugte Ingebrauchnahme;1002000;Kiel;M;21;0;0;0;1;4;5;1;2;3;5;13;0;0;0;1;4;2;1;0;8
***200;Diebstahl insgesamt von Mopeds und Krafträdern einschl. unbefugte Ingebrauchnahme;1002000;Kiel;W;0;0;0;0;0;0;0;0;0;0;0;0;0;0;0;0;0;0;0;0;0
***200;Diebstahl insgesamt von Mopeds und Krafträdern einschl. unbefugte Ingebrauchnahme;1002000;Kiel;X;21;0;0;0;1;4;5;1;2;3;5;13;0;0;0;1;4;2;1;0;8
***200;Diebstahl insgesamt von Mopeds und Krafträdern einschl. unbefugte Ingebrauchnahme;7111000;Koblenz;M;10;0;0;0;0;0;0;2;0;2;2;4;2;1;3;0;3;0;0;0;6
***200;Diebstahl insgesamt von Mopeds und Krafträdern einschl. unbefugte Ingebrauchnahme;7111000;Koblenz;W;0;0;0;0;0;0;0;0;0;0;0;0;0;0;0;0;0;0;0;0;0
***200;Diebstahl insgesamt von Mopeds und Krafträdern einschl. unbefugte Ingebrauchnahme;7111000;Koblenz;X;10;0;0;0;0;0;0;2;0;2;2;4;2;1;3;0;3;0;0;0;6
***200;Diebstahl insgesamt von Mopeds und Krafträdern einschl. unbefugte Ingebrauchnahme;5315000;Köln;M;186;0;0;0;0;19;19;39;44;83;27;129;8;14;22;12;15;7;1;0;57
***200;Diebstahl insgesamt von Mopeds und Krafträdern einschl. unbefugte Ingebrauchnahme;5315000;Köln;W;3;0;0;0;0;0;0;0;2;2;0;2;0;0;0;0;0;1;0;0;1
***200;Diebstahl insgesamt von Mopeds und Krafträdern einschl. unbefugte Ingebrauchnahme;5315000;Köln;X;189;0;0;0;0;19;19;39;46;85;27;131;8;14;22;12;15;8;1;0;58
***200;Diebstahl insgesamt von Mopeds und Krafträdern einschl. unbefugte Ingebrauchnahme;5114000;Krefeld;M;21;0;0;0;0;0;0;6;3;9;2;11;1;0;1;2;5;1;0;1;10
***200;Diebstahl insgesamt von Mopeds und Krafträdern einschl. unbefugte Ingebrauchnahme;5114000;Krefeld;W;3;0;0;0;0;0;0;3;0;3;0;3;0;0;0;0;0;0;0;0;0
***200;Diebstahl insgesamt von Mopeds und Krafträdern einschl. unbefugte Ingebrauchnahme;5114000;Krefeld;X;24;0;0;0;0;0;0;9;3;12;2;14;1;0;1;2;5;1;0;1;10
***200;Diebstahl insgesamt von Mopeds und Krafträdern einschl. unbefugte Ingebrauchnahme;14713000;Leipzig;M;65;0;0;0;0;0;0;3;4;7;5;12;3;8;11;17;19;2;3;1;53
***200;Diebstahl insgesamt von Mopeds und Krafträdern einschl. unbefugte Ingebrauchnahme;14713000;Leipzig;W;3;0;0;0;0;0;0;0;0;0;0;0;0;0;0;3;0;0;0;0;3
***200;Diebstahl insgesamt von Mopeds und Krafträdern einschl. unbefugte Ingebrauchnahme;14713000;Leipzig;X;68;0;0;0;0;0;0;3;4;7;5;12;3;8;11;20;19;2;3;1;56
***200;Diebstahl insgesamt von Mopeds und Krafträdern einschl. unbefugte Ingebrauchnahme;5316000;Leverkusen;M;36;0;0;0;0;1;1;7;2;9;11;21;4;2;6;3;5;1;0;0;15
***200;Diebstahl insgesamt von Mopeds und Krafträdern einschl. unbefugte Ingebrauchnahme;5316000;Leverkusen;W;0;0;0;0;0;0;0;0;0;0;0;0;0;0;0;0;0;0;0;0;0
***200;Diebstahl insgesamt von Mopeds und Krafträdern einschl. unbefugte Ingebrauchnahme;5316000;Leverkusen;X;36;0;0;0;0;1;1;7;2;9;11;21;4;2;6;3;5;1;0;0;15
***200;Diebstahl insgesamt von Mopeds und Krafträdern einschl. unbefugte Ingebrauchnahme;1003000;Lübeck;M;38;0;0;0;0;1;1;7;5;12;5;18;2;6;8;3;4;5;0;0;20
***200;Diebstahl insgesamt von Mopeds und Krafträdern einschl. unbefugte Ingebrauchnahme;1003000;Lübeck;W;1;0;0;0;0;0;0;0;0;0;1;1;0;0;0;0;0;0;0;0;0
***200;Diebstahl insgesamt von Mopeds und Krafträdern einschl. unbefugte Ingebrauchnahme;1003000;Lübeck;X;39;0;0;0;0;1;1;7;5;12;6;19;2;6;8;3;4;5;0;0;20
***200;Diebstahl insgesamt von Mopeds und Krafträdern einschl. unbefugte Ingebrauchnahme;7314000;Ludwigshafen am Rhein;M;20;0;0;0;0;1;1;2;4;6;4;11;3;2;5;0;3;1;0;0;9
***200;Diebstahl insgesamt von Mopeds und Krafträdern einschl. unbefugte Ingebrauchnahme;7314000;Ludwigshafen am Rhein;W;2;0;0;0;0;0;0;0;0;0;2;2;0;0;0;0;0;0;0;0;0
***200;Diebstahl insgesamt von Mopeds und Krafträdern einschl. unbefugte Ingebrauchnahme;7314000;Ludwigshafen am Rhein;X;22;0;0;0;0;1;1;2;4;6;6;13;3;2;5;0;3;1;0;0;9
***200;Diebstahl insgesamt von Mopeds und Krafträdern einschl. unbefugte Ingebrauchnahme;15003000;Magdeburg;M;27;0;0;0;0;1;1;3;2;5;8;14;3;2;5;4;2;1;1;0;13
***200;Diebstahl insgesamt von Mopeds und Krafträdern einschl. unbefugte Ingebrauchnahme;15003000;Magdeburg;W;0;0;0;0;0;0;0;0;0;0;0;0;0;0;0;0;0;0;0;0;0
***200;Diebstahl insgesamt von Mopeds und Krafträdern einschl. unbefugte Ingebrauchnahme;15003000;Magdeburg;X;27;0;0;0;0;1;1;3;2;5;8;14;3;2;5;4;2;1;1;0;13
***200;Diebstahl insgesamt von Mopeds und Krafträdern einschl. unbefugte Ingebrauchnahme;7315000;Mainz;M;14;0;0;0;0;0;0;4;2;6;2;8;0;2;2;1;1;1;1;0;6
***200;Diebstahl insgesamt von Mopeds und Krafträdern einschl. unbefugte Ingebrauchnahme;7315000;Mainz;W;0;0;0;0;0;0;0;0;0;0;0;0;0;0;0;0;0;0;0;0;0
***200;Diebstahl insgesamt von Mopeds und Krafträdern einschl. unbefugte Ingebrauchnahme;7315000;Mainz;X;14;0;0;0;0;0;0;4;2;6;2;8;0;2;2;1;1;1;1;0;6
***200;Diebstahl insgesamt von Mopeds und Krafträdern einschl. unbefugte Ingebrauchnahme;8222000;Mannheim;M;11;0;0;0;0;0;0;2;1;3;6;9;0;0;0;0;2;0;0;0;2
***200;Diebstahl insgesamt von Mopeds und Krafträdern einschl. unbefugte Ingebrauchnahme;8222000;Mannheim;W;2;0;0;0;0;0;0;1;0;1;0;1;0;0;0;1;0;0;0;0;1
***200;Diebstahl insgesamt von Mopeds und Krafträdern einschl. unbefugte Ingebrauchnahme;8222000;Mannheim;X;13;0;0;0;0;0;0;3;1;4;6;10;0;0;0;1;2;0;0;0;3
***200;Diebstahl insgesamt von Mopeds und Krafträdern einschl. unbefugte Ingebrauchnahme;5170024;Moers;M;4;0;0;0;0;1;1;0;1;1;1;3;0;0;0;1;0;0;0;0;1
***200;Diebstahl insgesamt von Mopeds und Krafträdern einschl. unbefugte Ingebrauchnahme;5170024;Moers;W;0;0;0;0;0;0;0;0;0;0;0;0;0;0;0;0;0;0;0;0;0
***200;Diebstahl insgesamt von Mopeds und Krafträdern einschl. unbefugte Ingebrauchnahme;5170024;Moers;X;4;0;0;0;0;1;1;0;1;1;1;3;0;0;0;1;0;0;0;0;1
***200;Diebstahl insgesamt von Mopeds und Krafträdern einschl. unbefugte Ingebrauchnahme;5116000;Mönchengladbach;M;36;0;0;0;2;1;3;5;6;11;9;23;4;4;8;2;1;2;0;0;13
***200;Diebstahl insgesamt von Mopeds und Krafträdern einschl. unbefugte Ingebrauchnahme;5116000;Mönchengladbach;W;0;0;0;0;0;0;0;0;0;0;0;0;0;0;0;0;0;0;0;0;0
***200;Diebstahl insgesamt von Mopeds und Krafträdern einschl. unbefugte Ingebrauchnahme;5116000;Mönchengladbach;X;36;0;0;0;2;1;3;5;6;11;9;23;4;4;8;2;1;2;0;0;13
***200;Diebstahl insgesamt von Mopeds und Krafträdern einschl. unbefugte Ingebrauchnahme;5117000;Mülheim an der Ruhr;M;11;0;0;0;0;0;0;4;3;7;2;9;0;1;1;0;0;0;1;0;2
***200;Diebstahl insgesamt von Mopeds und Krafträdern einschl. unbefugte Ingebrauchnahme;5117000;Mülheim an der Ruhr;W;0;0;0;0;0;0;0;0;0;0;0;0;0;0;0;0;0;0;0;0;0
***200;Diebstahl insgesamt von Mopeds und Krafträdern einschl. unbefugte Ingebrauchnahme;5117000;Mülheim an der Ruhr;X;11;0;0;0;0;0;0;4;3;7;2;9;0;1;1;0;0;0;1;0;2
***200;Diebstahl insgesamt von Mopeds und Krafträdern einschl. unbefugte Ingebrauchnahme;9162000;München;M;36;0;0;0;0;1;1;9;8;17;4;22;0;2;2;4;4;2;2;0;14
***200;Diebstahl insgesamt von Mopeds und Krafträdern einschl. unbefugte Ingebrauchnahme;9162000;München;W;0;0;0;0;0;0;0;0;0;0;0;0;0;0;0;0;0;0;0;0;0
***200;Diebstahl insgesamt von Mopeds und Krafträdern einschl. unbefugte Ingebrauchnahme;9162000;München;X;36;0;0;0;0;1;1;9;8;17;4;22;0;2;2;4;4;2;2;0;14
***200;Diebstahl insgesamt von Mopeds und Krafträdern einschl. unbefugte Ingebrauchnahme;5515000;Münster;M;15;0;0;0;0;0;0;2;5;7;2;9;2;1;3;1;1;1;0;0;6
***200;Diebstahl insgesamt von Mopeds und Krafträdern einschl. unbefugte Ingebrauchnahme;5515000;Münster;W;2;0;0;0;0;0;0;0;0;0;2;2;0;0;0;0;0;0;0;0;0
***200;Diebstahl insgesamt von Mopeds und Krafträdern einschl. unbefugte Ingebrauchnahme;5515000;Münster;X;17;0;0;0;0;0;0;2;5;7;4;11;2;1;3;1;1;1;0;0;6
***200;Diebstahl insgesamt von Mopeds und Krafträdern einschl. unbefugte Ingebrauchnahme;5162024;Neuss;M;18;0;0;0;0;0;0;4;4;8;4;12;2;0;2;1;3;0;0;0;6
***200;Diebstahl insgesamt von Mopeds und Krafträdern einschl. unbefugte Ingebrauchnahme;5162024;Neuss;W;3;0;0;0;1;2;3;0;0;0;0;3;0;0;0;0;0;0;0;0;0
***200;Diebstahl insgesamt von Mopeds und Krafträdern einschl. unbefugte Ingebrauchnahme;5162024;Neuss;X;21;0;0;0;1;2;3;4;4;8;4;15;2;0;2;1;3;0;0;0;6
***200;Diebstahl insgesamt von Mopeds und Krafträdern einschl. unbefugte Ingebrauchnahme;9564000;Nürnberg;M;26;0;0;0;0;0;0;2;2;4;4;8;3;2;5;3;9;0;1;0;18
***200;Diebstahl insgesamt von Mopeds und Krafträdern einschl. unbefugte Ingebrauchnahme;9564000;Nürnberg;W;3;0;0;0;0;0;0;0;0;0;1;1;0;0;0;1;1;0;0;0;2
***200;Diebstahl insgesamt von Mopeds und Krafträdern einschl. unbefugte Ingebrauchnahme;9564000;Nürnberg;X;29;0;0;0;0;0;0;2;2;4;5;9;3;2;5;4;10;0;1;0;20
***200;Diebstahl insgesamt von Mopeds und Krafträdern einschl. unbefugte Ingebrauchnahme;5119000;Oberhausen;M;25;0;0;0;0;0;0;7;5;12;7;19;2;2;4;2;0;0;0;0;6
***200;Diebstahl insgesamt von Mopeds und Krafträdern einschl. unbefugte Ingebrauchnahme;5119000;Oberhausen;W;2;0;0;0;0;0;0;0;0;0;0;0;0;1;1;0;0;1;0;0;2
***200;Diebstahl insgesamt von Mopeds und Krafträdern einschl. unbefugte Ingebrauchnahme;5119000;Oberhausen;X;27;0;0;0;0;0;0;7;5;12;7;19;2;3;5;2;0;1;0;0;8
***200;Diebstahl insgesamt von Mopeds und Krafträdern einschl. unbefugte Ingebrauchnahme;6413000;Offenbach am Main;M;28;0;0;1;1;3;5;9;8;17;3;25;2;0;2;1;0;0;0;0;3
***200;Diebstahl insgesamt von Mopeds und Krafträdern einschl. unbefugte Ingebrauchnahme;6413000;Offenbach am Main;W;2;0;0;0;0;1;1;0;1;1;0;2;0;0;0;0;0;0;0;0;0
***200;Diebstahl insgesamt von Mopeds und Krafträdern einschl. unbefugte Ingebrauchnahme;6413000;Offenbach am Main;X;30;0;0;1;1;4;6;9;9;18;3;27;2;0;2;1;0;0;0;0;3
***200;Diebstahl insgesamt von Mopeds und Krafträdern einschl. unbefugte Ingebrauchnahme;3403000;Oldenburg (Oldenburg);M;5;0;0;0;0;0;0;0;4;4;1;5;0;0;0;0;0;0;0;0;0
***200;Diebstahl insgesamt von Mopeds und Krafträdern einschl. unbefugte Ingebrauchnahme;3403000;Oldenburg (Oldenburg);W;0;0;0;0;0;0;0;0;0;0;0;0;0;0;0;0;0;0;0;0;0
***200;Diebstahl insgesamt von Mopeds und Krafträdern einschl. unbefugte Ingebrauchnahme;3403000;Oldenburg (Oldenburg);X;5;0;0;0;0;0;0;0;4;4;1;5;0;0;0;0;0;0;0;0;0
***200;Diebstahl insgesamt von Mopeds und Krafträdern einschl. unbefugte Ingebrauchnahme;3404000;Osnabrück;M;5;0;0;0;0;1;1;1;1;2;0;3;0;0;0;0;1;1;0;0;2
***200;Diebstahl insgesamt von Mopeds und Krafträdern einschl. unbefugte Ingebrauchnahme;3404000;Osnabrück;W;0;0;0;0;0;0;0;0;0;0;0;0;0;0;0;0;0;0;0;0;0
***200;Diebstahl insgesamt von Mopeds und Krafträdern einschl. unbefugte Ingebrauchnahme;3404000;Osnabrück;X;5;0;0;0;0;1;1;1;1;2;0;3;0;0;0;0;1;1;0;0;2
***200;Diebstahl insgesamt von Mopeds und Krafträdern einschl. unbefugte Ingebrauchnahme;5774032;Paderborn;M;17;0;0;0;0;0;0;2;8;10;1;11;2;2;4;1;1;0;0;0;6
***200;Diebstahl insgesamt von Mopeds und Krafträdern einschl. unbefugte Ingebrauchnahme;5774032;Paderborn;W;0;0;0;0;0;0;0;0;0;0;0;0;0;0;0;0;0;0;0;0;0
***200;Diebstahl insgesamt von Mopeds und Krafträdern einschl. unbefugte Ingebrauchnahme;5774032;Paderborn;X;17;0;0;0;0;0;0;2;8;10;1;11;2;2;4;1;1;0;0;0;6
***200;Diebstahl insgesamt von Mopeds und Krafträdern einschl. unbefugte Ingebrauchnahme;8231000;Pforzheim;M;17;0;0;0;0;1;1;5;6;11;3;15;1;0;1;1;0;0;0;0;2
***200;Diebstahl insgesamt von Mopeds und Krafträdern einschl. unbefugte Ingebrauchnahme;8231000;Pforzheim;W;0;0;0;0;0;0;0;0;0;0;0;0;0;0;0;0;0;0;0;0;0
***200;Diebstahl insgesamt von Mopeds und Krafträdern einschl. unbefugte Ingebrauchnahme;8231000;Pforzheim;X;17;0;0;0;0;1;1;5;6;11;3;15;1;0;1;1;0;0;0;0;2
***200;Diebstahl insgesamt von Mopeds und Krafträdern einschl. unbefugte Ingebrauchnahme;12054000;Potsdam;M;8;0;0;0;0;0;0;1;0;1;2;3;2;2;4;0;1;0;0;0;5
***200;Diebstahl insgesamt von Mopeds und Krafträdern einschl. unbefugte Ingebrauchnahme;12054000;Potsdam;W;0;0;0;0;0;0;0;0;0;0;0;0;0;0;0;0;0;0;0;0;0
***200;Diebstahl insgesamt von Mopeds und Krafträdern einschl. unbefugte Ingebrauchnahme;12054000;Potsdam;X;8;0;0;0;0;0;0;1;0;1;2;3;2;2;4;0;1;0;0;0;5
***200;Diebstahl insgesamt von Mopeds und Krafträdern einschl. unbefugte Ingebrauchnahme;5562032;Recklinghausen;M;18;0;0;0;1;0;1;4;3;7;1;9;2;0;2;2;2;2;1;0;9
***200;Diebstahl insgesamt von Mopeds und Krafträdern einschl. unbefugte Ingebrauchnahme;5562032;Recklinghausen;W;1;0;0;0;0;0;0;0;1;1;0;1;0;0;0;0;0;0;0;0;0
***200;Diebstahl insgesamt von Mopeds und Krafträdern einschl. unbefugte Ingebrauchnahme;5562032;Recklinghausen;X;19;0;0;0;1;0;1;4;4;8;1;10;2;0;2;2;2;2;1;0;9
***200;Diebstahl insgesamt von Mopeds und Krafträdern einschl. unbefugte Ingebrauchnahme;9362000;Regensburg;M;6;0;0;0;0;0;0;0;1;1;0;1;0;0;0;3;2;0;0;0;5
***200;Diebstahl insgesamt von Mopeds und Krafträdern einschl. unbefugte Ingebrauchnahme;9362000;Regensburg;W;0;0;0;0;0;0;0;0;0;0;0;0;0;0;0;0;0;0;0;0;0
***200;Diebstahl insgesamt von Mopeds und Krafträdern einschl. unbefugte Ingebrauchnahme;9362000;Regensburg;X;6;0;0;0;0;0;0;0;1;1;0;1;0;0;0;3;2;0;0;0;5
***200;Diebstahl insgesamt von Mopeds und Krafträdern einschl. unbefugte Ingebrauchnahme;5120000;Remscheid;M;0;0;0;0;0;0;0;0;0;0;0;0;0;0;0;0;0;0;0;0;0
***200;Diebstahl insgesamt von Mopeds und Krafträdern einschl. unbefugte Ingebrauchnahme;5120000;Remscheid;W;0;0;0;0;0;0;0;0;0;0;0;0;0;0;0;0;0;0;0;0;0
***200;Diebstahl insgesamt von Mopeds und Krafträdern einschl. unbefugte Ingebrauchnahme;5120000;Remscheid;X;0;0;0;0;0;0;0;0;0;0;0;0;0;0;0;0;0;0;0;0;0
***200;Diebstahl insgesamt von Mopeds und Krafträdern einschl. unbefugte Ingebrauchnahme;8415061;Reutlingen;M;5;0;0;0;0;0;0;1;3;4;1;5;0;0;0;0;0;0;0;0;0
***200;Diebstahl insgesamt von Mopeds und Krafträdern einschl. unbefugte Ingebrauchnahme;8415061;Reutlingen;W;0;0;0;0;0;0;0;0;0;0;0;0;0;0;0;0;0;0;0;0;0
***200;Diebstahl insgesamt von Mopeds und Krafträdern einschl. unbefugte Ingebrauchnahme;8415061;Reutlingen;X;5;0;0;0;0;0;0;1;3;4;1;5;0;0;0;0;0;0;0;0;0
***200;Diebstahl insgesamt von Mopeds und Krafträdern einschl. unbefugte Ingebrauchnahme;13003000;Rostock;M;32;0;0;0;0;0;0;7;5;12;7;19;1;2;3;6;3;0;1;0;13
***200;Diebstahl insgesamt von Mopeds und Krafträdern einschl. unbefugte Ingebrauchnahme;13003000;Rostock;W;1;0;0;0;0;0;0;1;0;1;0;1;0;0;0;0;0;0;0;0;0
***200;Diebstahl insgesamt von Mopeds und Krafträdern einschl. unbefugte Ingebrauchnahme;13003000;Rostock;X;33;0;0;0;0;0;0;8;5;13;7;20;1;2;3;6;3;0;1;0;13
***200;Diebstahl insgesamt von Mopeds und Krafträdern einschl. unbefugte Ingebrauchnahme;10041100;Saarbrücken;M;26;0;0;0;0;3;3;6;3;9;3;15;2;1;3;2;3;1;2;0;11
***200;Diebstahl insgesamt von Mopeds und Krafträdern einschl. unbefugte Ingebrauchnahme;10041100;Saarbrücken;W;1;0;0;0;0;0;0;0;0;0;1;1;0;0;0;0;0;0;0;0;0
***200;Diebstahl insgesamt von Mopeds und Krafträdern einschl. unbefugte Ingebrauchnahme;10041100;Saarbrücken;X;27;0;0;0;0;3;3;6;3;9;4;16;2;1;3;2;3;1;2;0;11
***200;Diebstahl insgesamt von Mopeds und Krafträdern einschl. unbefugte Ingebrauchnahme;5122000;Solingen;M;6;0;0;0;0;0;0;0;1;1;1;2;0;1;1;1;2;0;0;0;4
***200;Diebstahl insgesamt von Mopeds und Krafträdern einschl. unbefugte Ingebrauchnahme;5122000;Solingen;W;0;0;0;0;0;0;0;0;0;0;0;0;0;0;0;0;0;0;0;0;0
***200;Diebstahl insgesamt von Mopeds und Krafträdern einschl. unbefugte Ingebrauchnahme;5122000;Solingen;X;6;0;0;0;0;0;0;0;1;1;1;2;0;1;1;1;2;0;0;0;4
***200;Diebstahl insgesamt von Mopeds und Krafträdern einschl. unbefugte Ingebrauchnahme;8111000;Stuttgart;M;19;0;0;0;0;0;0;2;7;9;3;12;3;0;3;2;0;1;0;1;7
***200;Diebstahl insgesamt von Mopeds und Krafträdern einschl. unbefugte Ingebrauchnahme;8111000;Stuttgart;W;1;0;0;0;0;0;0;1;0;1;0;1;0;0;0;0;0;0;0;0;0
***200;Diebstahl insgesamt von Mopeds und Krafträdern einschl. unbefugte Ingebrauchnahme;8111000;Stuttgart;X;20;0;0;0;0;0;0;3;7;10;3;13;3;0;3;2;0;1;0;1;7
***200;Diebstahl insgesamt von Mopeds und Krafträdern einschl. unbefugte Ingebrauchnahme;7211000;Trier;M;15;0;0;0;0;1;1;2;6;8;2;11;1;1;2;0;2;0;0;0;4
***200;Diebstahl insgesamt von Mopeds und Krafträdern einschl. unbefugte Ingebrauchnahme;7211000;Trier;W;1;0;0;0;0;0;0;0;0;0;0;0;0;0;0;0;1;0;0;0;1
***200;Diebstahl insgesamt von Mopeds und Krafträdern einschl. unbefugte Ingebrauchnahme;7211000;Trier;X;16;0;0;0;0;1;1;2;6;8;2;11;1;1;2;0;3;0;0;0;5
***200;Diebstahl insgesamt von Mopeds und Krafträdern einschl. unbefugte Ingebrauchnahme;8421000;Ulm;M;2;0;0;0;0;0;0;0;1;1;0;1;0;1;1;0;0;0;0;0;1
***200;Diebstahl insgesamt von Mopeds und Krafträdern einschl. unbefugte Ingebrauchnahme;8421000;Ulm;W;0;0;0;0;0;0;0;0;0;0;0;0;0;0;0;0;0;0;0;0;0
***200;Diebstahl insgesamt von Mopeds und Krafträdern einschl. unbefugte Ingebrauchnahme;8421000;Ulm;X;2;0;0;0;0;0;0;0;1;1;0;1;0;1;1;0;0;0;0;0;1
***200;Diebstahl insgesamt von Mopeds und Krafträdern einschl. unbefugte Ingebrauchnahme;6414000;Wiesbaden;M;44;0;0;0;1;6;7;12;16;28;4;39;0;1;1;1;2;0;1;0;5
***200;Diebstahl insgesamt von Mopeds und Krafträdern einschl. unbefugte Ingebrauchnahme;6414000;Wiesbaden;W;3;0;0;0;0;2;2;1;0;1;0;3;0;0;0;0;0;0;0;0;0
***200;Diebstahl insgesamt von Mopeds und Krafträdern einschl. unbefugte Ingebrauchnahme;6414000;Wiesbaden;X;47;0;0;0;1;8;9;13;16;29;4;42;0;1;1;1;2;0;1;0;5
***200;Diebstahl insgesamt von Mopeds und Krafträdern einschl. unbefugte Ingebrauchnahme;3103000;Wolfsburg;M;26;0;0;0;0;3;3;5;9;14;7;24;0;1;1;1;0;0;0;0;2
***200;Diebstahl insgesamt von Mopeds und Krafträdern einschl. unbefugte Ingebrauchnahme;3103000;Wolfsburg;W;1;0;0;0;0;0;0;1;0;1;0;1;0;0;0;0;0;0;0;0;0
***200;Diebstahl insgesamt von Mopeds und Krafträdern einschl. unbefugte Ingebrauchnahme;3103000;Wolfsburg;X;27;0;0;0;0;3;3;6;9;15;7;25;0;1;1;1;0;0;0;0;2
***200;Diebstahl insgesamt von Mopeds und Krafträdern einschl. unbefugte Ingebrauchnahme;5124000;Wuppertal;M;5;0;0;0;0;0;0;2;0;2;1;3;0;0;0;1;1;0;0;0;2
***200;Diebstahl insgesamt von Mopeds und Krafträdern einschl. unbefugte Ingebrauchnahme;5124000;Wuppertal;W;0;0;0;0;0;0;0;0;0;0;0;0;0;0;0;0;0;0;0;0;0
***200;Diebstahl insgesamt von Mopeds und Krafträdern einschl. unbefugte Ingebrauchnahme;5124000;Wuppertal;X;5;0;0;0;0;0;0;2;0;2;1;3;0;0;0;1;1;0;0;0;2
***200;Diebstahl insgesamt von Mopeds und Krafträdern einschl. unbefugte Ingebrauchnahme;9663000;Würzburg;M;4;0;0;0;0;0;0;0;1;1;0;1;2;0;2;1;0;0;0;0;3
***200;Diebstahl insgesamt von Mopeds und Krafträdern einschl. unbefugte Ingebrauchnahme;9663000;Würzburg;W;1;0;0;0;0;0;0;0;1;1;0;1;0;0;0;0;0;0;0;0;0
***200;Diebstahl insgesamt von Mopeds und Krafträdern einschl. unbefugte Ingebrauchnahme;9663000;Würzburg;X;5;0;0;0;0;0;0;0;2;2;0;2;2;0;2;1;0;0;0;0;3
***300;Diebstahl insgesamt von Fahrrädern einschl. unbefugte Ingebrauchnahme;5334002;Aachen;M;104;0;0;0;0;4;4;21;20;41;14;59;3;7;10;8;17;6;3;1;45
***300;Diebstahl insgesamt von Fahrrädern einschl. unbefugte Ingebrauchnahme;5334002;Aachen;W;5;0;0;0;0;0;0;0;1;1;0;1;0;0;0;0;0;2;1;1;4
***300;Diebstahl insgesamt von Fahrrädern einschl. unbefugte Ingebrauchnahme;5334002;Aachen;X;109;0;0;0;0;4;4;21;21;42;14;60;3;7;10;8;17;8;4;2;49
***300;Diebstahl insgesamt von Fahrrädern einschl. unbefugte Ingebrauchnahme;9761000;Augsburg;M;72;0;1;2;1;2;6;8;8;16;8;30;2;4;6;12;13;6;1;4;42
***300;Diebstahl insgesamt von Fahrrädern einschl. unbefugte Ingebrauchnahme;9761000;Augsburg;W;7;0;0;0;1;0;1;0;0;0;0;1;0;2;2;0;2;0;2;0;6
***300;Diebstahl insgesamt von Fahrrädern einschl. unbefugte Ingebrauchnahme;9761000;Augsburg;X;79;0;1;2;2;2;7;8;8;16;8;31;2;6;8;12;15;6;3;4;48
***300;Diebstahl insgesamt von Fahrrädern einschl. unbefugte Ingebrauchnahme;5378004;Bergisch Gladbach;M;31;0;0;0;0;0;0;1;7;8;7;15;1;1;2;6;4;4;0;0;16
***300;Diebstahl insgesamt von Fahrrädern einschl. unbefugte Ingebrauchnahme;5378004;Bergisch Gladbach;W;2;0;0;0;0;0;0;0;0;0;0;0;0;0;0;0;1;1;0;0;2
***300;Diebstahl insgesamt von Fahrrädern einschl. unbefugte Ingebrauchnahme;5378004;Bergisch Gladbach;X;33;0;0;0;0;0;0;1;7;8;7;15;1;1;2;6;5;5;0;0;18
***300;Diebstahl insgesamt von Fahrrädern einschl. unbefugte Ingebrauchnahme;11000000;Berlin;M;1074;0;1;7;12;41;61;112;114;226;118;405;59;76;135;145;219;113;41;16;669
***300;Diebstahl insgesamt von Fahrrädern einschl. unbefugte Ingebrauchnahme;11000000;Berlin;W;51;0;0;1;1;1;3;5;3;8;2;13;2;2;4;7;16;5;3;3;38
***300;Diebstahl insgesamt von Fahrrädern einschl. unbefugte Ingebrauchnahme;11000000;Berlin;X;1125;0;1;8;13;42;64;117;117;234;120;418;61;78;139;152;235;118;44;19;707
***300;Diebstahl insgesamt von Fahrrädern einschl. unbefugte Ingebrauchnahme;5711000;Bielefeld;M;56;0;0;0;0;3;3;2;14;16;8;27;3;4;7;8;4;6;4;0;29
***300;Diebstahl insgesamt von Fahrrädern einschl. unbefugte Ingebrauchnahme;5711000;Bielefeld;W;3;0;0;0;0;0;0;0;0;0;0;0;1;1;2;1;0;0;0;0;3
***300;Diebstahl insgesamt von Fahrrädern einschl. unbefugte Ingebrauchnahme;5711000;Bielefeld;X;59;0;0;0;0;3;3;2;14;16;8;27;4;5;9;9;4;6;4;0;32
***300;Diebstahl insgesamt von Fahrrädern einschl. unbefugte Ingebrauchnahme;5911000;Bochum;M;76;0;0;0;4;3;7;1;13;14;5;26;7;3;10;13;19;6;2;0;50
***300;Diebstahl insgesamt von Fahrrädern einschl. unbefugte Ingebrauchnahme;5911000;Bochum;W;2;0;0;0;0;0;0;0;0;0;0;0;0;0;0;0;0;0;1;1;2
***300;Diebstahl insgesamt von Fahrrädern einschl. unbefugte Ingebrauchnahme;5911000;Bochum;X;78;0;0;0;4;3;7;1;13;14;5;26;7;3;10;13;19;6;3;1;52
***300;Diebstahl insgesamt von Fahrrädern einschl. unbefugte Ingebrauchnahme;5314000;Bonn;M;117;0;1;1;3;6;11;16;13;29;19;59;3;5;8;6;25;13;4;2;58
***300;Diebstahl insgesamt von Fahrrädern einschl. unbefugte Ingebrauchnahme;5314000;Bonn;W;8;0;0;0;0;0;0;1;0;1;1;2;0;0;0;1;1;0;4;0;6
***300;Diebstahl insgesamt von Fahrrädern einschl. unbefugte Ingebrauchnahme;5314000;Bonn;X;125;0;1;1;3;6;11;17;13;30;20;61;3;5;8;7;26;13;8;2;64
***300;Diebstahl insgesamt von Fahrrädern einschl. unbefugte Ingebrauchnahme;5512000;Bottrop;M;25;0;0;0;0;0;0;0;0;0;6;6;3;1;4;4;6;4;1;0;19
***300;Diebstahl insgesamt von Fahrrädern einschl. unbefugte Ingebrauchnahme;5512000;Bottrop;W;2;0;0;0;0;0;0;0;0;0;0;0;0;1;1;0;0;1;0;0;2
***300;Diebstahl insgesamt von Fahrrädern einschl. unbefugte Ingebrauchnahme;5512000;Bottrop;X;27;0;0;0;0;0;0;0;0;0;6;6;3;2;5;4;6;5;1;0;21
***300;Diebstahl insgesamt von Fahrrädern einschl. unbefugte Ingebrauchnahme;3101000;Braunschweig;M;152;0;0;0;0;2;2;3;8;11;18;31;15;9;24;30;34;19;8;6;121
***300;Diebstahl insgesamt von Fahrrädern einschl. unbefugte Ingebrauchnahme;3101000;Braunschweig;W;8;0;0;0;0;0;0;0;1;1;1;2;0;0;0;0;4;1;1;0;6
***300;Diebstahl insgesamt von Fahrrädern einschl. unbefugte Ingebrauchnahme;3101000;Braunschweig;X;160;0;0;0;0;2;2;3;9;12;19;33;15;9;24;30;38;20;9;6;127
***300;Diebstahl insgesamt von Fahrrädern einschl. unbefugte Ingebrauchnahme;4011000;Bremen;M;261;0;0;0;2;5;7;14;28;42;41;90;13;15;28;41;56;24;15;7;171
***300;Diebstahl insgesamt von Fahrrädern einschl. unbefugte Ingebrauchnahme;4011000;Bremen;W;29;0;0;0;0;0;0;6;5;11;3;14;1;0;1;4;5;4;1;0;15
***300;Diebstahl insgesamt von Fahrrädern einschl. unbefugte Ingebrauchnahme;4011000;Bremen;X;290;0;0;0;2;5;7;20;33;53;44;104;14;15;29;45;61;28;16;7;186
***300;Diebstahl insgesamt von Fahrrädern einschl. unbefugte Ingebrauchnahme;4012000;Bremerhaven;M;81;0;0;0;1;1;2;2;7;9;13;24;5;5;10;13;24;9;1;0;57
***300;Diebstahl insgesamt von Fahrrädern einschl. unbefugte Ingebrauchnahme;4012000;Bremerhaven;W;9;0;0;0;0;0;0;0;0;0;2;2;2;0;2;0;3;1;1;0;7
***300;Diebstahl insgesamt von Fahrrädern einschl. unbefugte Ingebrauchnahme;4012000;Bremerhaven;X;90;0;0;0;1;1;2;2;7;9;15;26;7;5;12;13;27;10;2;0;64
***300;Diebstahl insgesamt von Fahrrädern einschl. unbefugte Ingebrauchnahme;14511000;Chemnitz;M;131;0;1;0;1;1;3;2;3;5;12;20;9;5;14;36;49;9;3;0;111
***300;Diebstahl insgesamt von Fahrrädern einschl. unbefugte Ingebrauchnahme;14511000;Chemnitz;W;14;0;0;0;0;0;0;0;1;1;2;3;0;2;2;2;6;0;0;1;11
***300;Diebstahl insgesamt von Fahrrädern einschl. unbefugte Ingebrauchnahme;14511000;Chemnitz;X;145;0;1;0;1;1;3;2;4;6;14;23;9;7;16;38;55;9;3;1;122
***300;Diebstahl insgesamt von Fahrrädern einschl. unbefugte Ingebrauchnahme;6411000;Darmstadt;M;77;0;0;0;0;0;0;9;15;24;15;39;4;7;11;4;14;7;1;1;38
***300;Diebstahl insgesamt von Fahrrädern einschl. unbefugte Ingebrauchnahme;6411000;Darmstadt;W;5;0;0;0;0;0;0;0;0;0;2;2;0;0;0;1;0;1;0;1;3
***300;Diebstahl insgesamt von Fahrrädern einschl. unbefugte Ingebrauchnahme;6411000;Darmstadt;X;82;0;0;0;0;0;0;9;15;24;17;41;4;7;11;5;14;8;1;2;41
***300;Diebstahl insgesamt von Fahrrädern einschl. unbefugte Ingebrauchnahme;5913000;Dortmund;M;216;0;0;1;1;5;7;8;20;28;21;56;10;13;23;34;56;27;15;5;160
***300;Diebstahl insgesamt von Fahrrädern einschl. unbefugte Ingebrauchnahme;5913000;Dortmund;W;11;0;0;0;0;1;1;0;1;1;0;2;1;0;1;3;5;0;0;0;9
***300;Diebstahl insgesamt von Fahrrädern einschl. unbefugte Ingebrauchnahme;5913000;Dortmund;X;227;0;0;1;1;6;8;8;21;29;21;58;11;13;24;37;61;27;15;5;169
***300;Diebstahl insgesamt von Fahrrädern einschl. unbefugte Ingebrauchnahme;14612000;Dresden;M;383;0;0;0;1;2;3;9;10;19;24;46;24;36;60;122;127;22;6;0;337
***300;Diebstahl insgesamt von Fahrrädern einschl. unbefugte Ingebrauchnahme;14612000;Dresden;W;66;0;0;0;0;1;1;4;6;10;7;18;4;8;12;18;13;2;0;3;48
***300;Diebstahl insgesamt von Fahrrädern einschl. unbefugte Ingebrauchnahme;14612000;Dresden;X;449;0;0;0;1;3;4;13;16;29;31;64;28;44;72;140;140;24;6;3;385
***300;Diebstahl insgesamt von Fahrrädern einschl. unbefugte Ingebrauchnahme;5112000;Duisburg;M;115;0;0;0;2;0;2;15;16;31;7;40;6;5;11;14;29;13;8;0;75
***300;Diebstahl insgesamt von Fahrrädern einschl. unbefugte Ingebrauchnahme;5112000;Duisburg;W;9;0;1;1;0;0;2;1;0;1;1;4;0;0;0;0;2;3;0;0;5
***300;Diebstahl insgesamt von Fahrrädern einschl. unbefugte Ingebrauchnahme;5112000;Duisburg;X;124;0;1;1;2;0;4;16;16;32;8;44;6;5;11;14;31;16;8;0;80
***300;Diebstahl insgesamt von Fahrrädern einschl. unbefugte Ingebrauchnahme;5111000;Düsseldorf;M;245;0;1;0;1;5;7;15;28;43;33;83;31;24;55;25;35;36;6;5;162
***300;Diebstahl insgesamt von Fahrrädern einschl. unbefugte Ingebrauchnahme;5111000;Düsseldorf;W;8;0;0;1;0;0;1;1;1;2;2;5;0;0;0;0;1;0;1;1;3
***300;Diebstahl insgesamt von Fahrrädern einschl. unbefugte Ingebrauchnahme;5111000;Düsseldorf;X;253;0;1;1;1;5;8;16;29;45;35;88;31;24;55;25;36;36;7;6;165
***300;Diebstahl insgesamt von Fahrrädern einschl. unbefugte Ingebrauchnahme;16051000;Erfurt;M;81;0;0;0;0;1;1;8;5;13;7;21;5;3;8;26;22;3;0;1;60
***300;Diebstahl insgesamt von Fahrrädern einschl. unbefugte Ingebrauchnahme;16051000;Erfurt;W;10;0;0;0;0;1;1;1;1;2;0;3;1;1;2;2;3;0;0;0;7
***300;Diebstahl insgesamt von Fahrrädern einschl. unbefugte Ingebrauchnahme;16051000;Erfurt;X;91;0;0;0;0;2;2;9;6;15;7;24;6;4;10;28;25;3;0;1;67
***300;Diebstahl insgesamt von Fahrrädern einschl. unbefugte Ingebrauchnahme;9562000;Erlangen;M;132;0;1;0;0;3;4;7;21;28;26;58;14;13;27;12;15;12;6;2;74
***300;Diebstahl insgesamt von Fahrrädern einschl. unbefugte Ingebrauchnahme;9562000;Erlangen;W;5;0;0;0;0;0;0;0;1;1;0;1;1;0;1;1;1;0;1;0;4
***300;Diebstahl insgesamt von Fahrrädern einschl. unbefugte Ingebrauchnahme;9562000;Erlangen;X;137;0;1;0;0;3;4;7;22;29;26;59;15;13;28;13;16;12;7;2;78
***300;Diebstahl insgesamt von Fahrrädern einschl. unbefugte Ingebrauchnahme;5113000;Essen;M;109;0;0;0;0;1;1;8;11;19;12;32;17;14;31;7;25;9;5;0;77
***300;Diebstahl insgesamt von Fahrrädern einschl. unbefugte Ingebrauchnahme;5113000;Essen;W;7;0;0;0;0;0;0;0;0;0;0;0;0;1;1;1;2;1;0;2;7
***300;Diebstahl insgesamt von Fahrrädern einschl. unbefugte Ingebrauchnahme;5113000;Essen;X;116;0;0;0;0;1;1;8;11;19;12;32;17;15;32;8;27;10;5;2;84
***300;Diebstahl insgesamt von Fahrrädern einschl. unbefugte Ingebrauchnahme;6412000;Frankfurt am Main;M;259;0;0;1;0;3;4;20;31;51;44;99;13;12;25;30;54;35;11;5;160
***300;Diebstahl insgesamt von Fahrrädern einschl. unbefugte Ingebrauchnahme;6412000;Frankfurt am Main;W;12;0;0;0;0;0;0;1;0;1;2;3;0;1;1;3;2;3;0;0;9
***300;Diebstahl insgesamt von Fahrrädern einschl. unbefugte Ingebrauchnahme;6412000;Frankfurt am Main;X;271;0;0;1;0;3;4;21;31;52;46;102;13;13;26;33;56;38;11;5;169
***300;Diebstahl insgesamt von Fahrrädern einschl. unbefugte Ingebrauchnahme;8311000;Freiburg im Breisgau;M;168;0;0;1;5;6;12;7;31;38;31;81;12;13;25;19;19;18;5;1;87
***300;Diebstahl insgesamt von Fahrrädern einschl. unbefugte Ingebrauchnahme;8311000;Freiburg im Breisgau;W;9;0;0;0;0;0;0;0;0;0;1;1;2;0;2;1;3;1;1;0;8
***300;Diebstahl insgesamt von Fahrrädern einschl. unbefugte Ingebrauchnahme;8311000;Freiburg im Breisgau;X;177;0;0;1;5;6;12;7;31;38;32;82;14;13;27;20;22;19;6;1;95
***300;Diebstahl insgesamt von Fahrrädern einschl. unbefugte Ingebrauchnahme;9563000;Fürth;M;75;0;0;0;3;3;6;3;2;5;11;22;8;6;14;16;13;10;0;0;53
***300;Diebstahl insgesamt von Fahrrädern einschl. unbefugte Ingebrauchnahme;9563000;Fürth;W;8;0;0;0;0;0;0;0;0;0;1;1;0;1;1;3;3;0;0;0;7
***300;Diebstahl insgesamt von Fahrrädern einschl. unbefugte Ingebrauchnahme;9563000;Fürth;X;83;0;0;0;3;3;6;3;2;5;12;23;8;7;15;19;16;10;0;0;60
***300;Diebstahl insgesamt von Fahrrädern einschl. unbefugte Ingebrauchnahme;5513000;Gelsenkirchen;M;96;0;0;1;4;2;7;6;9;15;8;30;6;4;10;13;24;11;6;2;66
***300;Diebstahl insgesamt von Fahrrädern einschl. unbefugte Ingebrauchnahme;5513000;Gelsenkirchen;W;14;0;2;2;0;0;4;0;1;1;1;6;1;0;1;1;2;3;0;1;8
***300;Diebstahl insgesamt von Fahrrädern einschl. unbefugte Ingebrauchnahme;5513000;Gelsenkirchen;X;110;0;2;3;4;2;11;6;10;16;9;36;7;4;11;14;26;14;6;3;74
***300;Diebstahl insgesamt von Fahrrädern einschl. unbefugte Ingebrauchnahme;3152012;Göttingen;M;78;0;0;2;0;1;3;3;9;12;5;20;5;2;7;4;32;10;4;1;58
***300;Diebstahl insgesamt von Fahrrädern einschl. unbefugte Ingebrauchnahme;3152012;Göttingen;W;9;0;0;0;0;0;0;0;0;0;0;0;0;0;0;3;4;2;0;0;9
***300;Diebstahl insgesamt von Fahrrädern einschl. unbefugte Ingebrauchnahme;3152012;Göttingen;X;87;0;0;2;0;1;3;3;9;12;5;20;5;2;7;7;36;12;4;1;67
***300;Diebstahl insgesamt von Fahrrädern einschl. unbefugte Ingebrauchnahme;5914000;Hagen;M;31;0;0;0;1;5;6;4;3;7;3;16;2;0;2;3;7;3;0;0;15
***300;Diebstahl insgesamt von Fahrrädern einschl. unbefugte Ingebrauchnahme;5914000;Hagen;W;4;0;0;0;0;0;0;0;0;0;2;2;0;1;1;1;0;0;0;0;2
***300;Diebstahl insgesamt von Fahrrädern einschl. unbefugte Ingebrauchnahme;5914000;Hagen;X;35;0;0;0;1;5;6;4;3;7;5;18;2;1;3;4;7;3;0;0;17
***300;Diebstahl insgesamt von Fahrrädern einschl. unbefugte Ingebrauchnahme;15002000;Halle (Saale);M;135;1;1;2;2;5;11;9;10;19;15;45;6;10;16;29;36;6;2;1;90
***300;Diebstahl insgesamt von Fahrrädern einschl. unbefugte Ingebrauchnahme;15002000;Halle (Saale);W;7;0;1;1;0;0;2;1;0;1;0;3;0;0;0;3;1;0;0;0;4
***300;Diebstahl insgesamt von Fahrrädern einschl. unbefugte Ingebrauchnahme;15002000;Halle (Saale);X;142;1;2;3;2;5;13;10;10;20;15;48;6;10;16;32;37;6;2;1;94
***300;Diebstahl insgesamt von Fahrrädern einschl. unbefugte Ingebrauchnahme;2000000;Hamburg;M;663;0;0;2;4;19;25;69;88;157;114;296;28;42;70;66;114;85;25;7;367
***300;Diebstahl insgesamt von Fahrrädern einschl. unbefugte Ingebrauchnahme;2000000;Hamburg;W;41;0;0;0;0;5;5;11;3;14;5;24;1;1;2;2;6;6;0;1;17
***300;Diebstahl insgesamt von Fahrrädern einschl. unbefugte Ingebrauchnahme;2000000;Hamburg;X;704;0;0;2;4;24;30;80;91;171;119;320;29;43;72;68;120;91;25;8;384
***300;Diebstahl insgesamt von Fahrrädern einschl. unbefugte Ingebrauchnahme;5915000;Hamm;M;66;0;0;0;1;1;2;5;8;13;9;24;4;2;6;12;14;9;1;0;42
***300;Diebstahl insgesamt von Fahrrädern einschl. unbefugte Ingebrauchnahme;5915000;Hamm;W;2;0;0;0;0;0;0;0;1;1;0;1;0;0;0;0;0;1;0;0;1
***300;Diebstahl insgesamt von Fahrrädern einschl. unbefugte Ingebrauchnahme;5915000;Hamm;X;68;0;0;0;1;1;2;5;9;14;9;25;4;2;6;12;14;10;1;0;43
***300;Diebstahl insgesamt von Fahrrädern einschl. unbefugte Ingebrauchnahme;3241001;Hannover;M;388;0;0;3;1;9;13;20;26;46;37;96;28;24;52;57;87;65;21;10;292
***300;Diebstahl insgesamt von Fahrrädern einschl. unbefugte Ingebrauchnahme;3241001;Hannover;W;33;0;0;0;0;1;1;2;3;5;0;6;0;2;2;6;8;9;1;1;27
***300;Diebstahl insgesamt von Fahrrädern einschl. unbefugte Ingebrauchnahme;3241001;Hannover;X;421;0;0;3;1;10;14;22;29;51;37;102;28;26;54;63;95;74;22;11;319
***300;Diebstahl insgesamt von Fahrrädern einschl. unbefugte Ingebrauchnahme;8221000;Heidelberg;M;45;0;0;0;0;2;2;2;3;5;3;10;5;5;10;8;9;4;2;2;35
***300;Diebstahl insgesamt von Fahrrädern einschl. unbefugte Ingebrauchnahme;8221000;Heidelberg;W;5;0;0;0;0;0;0;0;0;0;0;0;0;0;0;1;1;2;1;0;5
***300;Diebstahl insgesamt von Fahrrädern einschl. unbefugte Ingebrauchnahme;8221000;Heidelberg;X;50;0;0;0;0;2;2;2;3;5;3;10;5;5;10;9;10;6;3;2;40
***300;Diebstahl insgesamt von Fahrrädern einschl. unbefugte Ingebrauchnahme;8121000;Heilbronn;M;19;0;0;0;0;1;1;2;1;3;2;6;1;1;2;3;4;0;1;3;13
***300;Diebstahl insgesamt von Fahrrädern einschl. unbefugte Ingebrauchnahme;8121000;Heilbronn;W;0;0;0;0;0;0;0;0;0;0;0;0;0;0;0;0;0;0;0;0;0
***300;Diebstahl insgesamt von Fahrrädern einschl. unbefugte Ingebrauchnahme;8121000;Heilbronn;X;19;0;0;0;0;1;1;2;1;3;2;6;1;1;2;3;4;0;1;3;13
***300;Diebstahl insgesamt von Fahrrädern einschl. unbefugte Ingebrauchnahme;5916000;Herne;M;71;0;0;0;1;1;2;9;20;29;8;39;4;0;4;10;10;6;0;2;32
***300;Diebstahl insgesamt von Fahrrädern einschl. unbefugte Ingebrauchnahme;5916000;Herne;W;2;0;0;0;0;0;0;0;1;1;0;1;0;0;0;0;1;0;0;0;1
***300;Diebstahl insgesamt von Fahrrädern einschl. unbefugte Ingebrauchnahme;5916000;Herne;X;73;0;0;0;1;1;2;9;21;30;8;40;4;0;4;10;11;6;0;2;33
***300;Diebstahl insgesamt von Fahrrädern einschl. unbefugte Ingebrauchnahme;9161000;Ingolstadt;M;52;0;0;0;1;3;4;4;5;9;4;17;5;5;10;8;9;6;2;0;35
***300;Diebstahl insgesamt von Fahrrädern einschl. unbefugte Ingebrauchnahme;9161000;Ingolstadt;W;1;0;0;0;0;0;0;0;0;0;0;0;0;0;0;0;0;1;0;0;1
***300;Diebstahl insgesamt von Fahrrädern einschl. unbefugte Ingebrauchnahme;9161000;Ingolstadt;X;53;0;0;0;1;3;4;4;5;9;4;17;5;5;10;8;9;7;2;0;36
***300;Diebstahl insgesamt von Fahrrädern einschl. unbefugte Ingebrauchnahme;16053000;Jena;M;42;0;1;0;0;0;1;0;1;1;3;5;5;4;9;7;16;3;2;0;37
***300;Diebstahl insgesamt von Fahrrädern einschl. unbefugte Ingebrauchnahme;16053000;Jena;W;3;0;0;0;0;0;0;0;1;1;0;1;0;0;0;1;1;0;0;0;2
***300;Diebstahl insgesamt von Fahrrädern einschl. unbefugte Ingebrauchnahme;16053000;Jena;X;45;0;1;0;0;0;1;0;2;2;3;6;5;4;9;8;17;3;2;0;39
***300;Diebstahl insgesamt von Fahrrädern einschl. unbefugte Ingebrauchnahme;8212000;Karlsruhe;M;83;0;0;0;0;4;4;9;11;20;14;38;7;5;12;12;15;4;1;1;45
***300;Diebstahl insgesamt von Fahrrädern einschl. unbefugte Ingebrauchnahme;8212000;Karlsruhe;W;4;0;0;0;0;0;0;0;0;0;0;0;1;0;1;0;3;0;0;0;4
***300;Diebstahl insgesamt von Fahrrädern einschl. unbefugte Ingebrauchnahme;8212000;Karlsruhe;X;87;0;0;0;0;4;4;9;11;20;14;38;8;5;13;12;18;4;1;1;49
***300;Diebstahl insgesamt von Fahrrädern einschl. unbefugte Ingebrauchnahme;6611000;Kassel;M;50;0;0;0;0;2;2;5;6;11;5;18;6;6;12;7;3;7;1;2;32
***300;Diebstahl insgesamt von Fahrrädern einschl. unbefugte Ingebrauchnahme;6611000;Kassel;W;2;0;0;0;0;0;0;0;0;0;0;0;0;0;0;0;1;0;1;0;2
***300;Diebstahl insgesamt von Fahrrädern einschl. unbefugte Ingebrauchnahme;6611000;Kassel;X;52;0;0;0;0;2;2;5;6;11;5;18;6;6;12;7;4;7;2;2;34
***300;Diebstahl insgesamt von Fahrrädern einschl. unbefugte Ingebrauchnahme;1002000;Kiel;M;94;0;2;0;0;2;4;4;8;12;8;24;10;7;17;8;19;19;4;3;70
***300;Diebstahl insgesamt von Fahrrädern einschl. unbefugte Ingebrauchnahme;1002000;Kiel;W;6;0;0;0;0;0;0;0;1;1;0;1;0;0;0;0;4;0;1;0;5
***300;Diebstahl insgesamt von Fahrrädern einschl. unbefugte Ingebrauchnahme;1002000;Kiel;X;100;0;2;0;0;2;4;4;9;13;8;25;10;7;17;8;23;19;5;3;75
***300;Diebstahl insgesamt von Fahrrädern einschl. unbefugte Ingebrauchnahme;7111000;Koblenz;M;61;0;0;0;0;4;4;8;8;16;5;25;3;3;6;3;12;10;3;2;36
***300;Diebstahl insgesamt von Fahrrädern einschl. unbefugte Ingebrauchnahme;7111000;Koblenz;W;1;0;0;0;0;0;0;0;0;0;0;0;0;0;0;0;1;0;0;0;1
***300;Diebstahl insgesamt von Fahrrädern einschl. unbefugte Ingebrauchnahme;7111000;Koblenz;X;62;0;0;0;0;4;4;8;8;16;5;25;3;3;6;3;13;10;3;2;37
***300;Diebstahl insgesamt von Fahrrädern einschl. unbefugte Ingebrauchnahme;5315000;Köln;M;468;0;0;1;2;21;24;43;58;101;65;190;31;36;67;41;76;68;18;8;278
***300;Diebstahl insgesamt von Fahrrädern einschl. unbefugte Ingebrauchnahme;5315000;Köln;W;33;0;0;0;0;2;2;1;3;4;3;9;2;2;4;0;9;6;2;3;24
***300;Diebstahl insgesamt von Fahrrädern einschl. unbefugte Ingebrauchnahme;5315000;Köln;X;501;0;0;1;2;23;26;44;61;105;68;199;33;38;71;41;85;74;20;11;302
***300;Diebstahl insgesamt von Fahrrädern einschl. unbefugte Ingebrauchnahme;5114000;Krefeld;M;87;0;1;1;0;7;9;10;9;19;9;37;1;4;5;12;19;10;2;2;50
***300;Diebstahl insgesamt von Fahrrädern einschl. unbefugte Ingebrauchnahme;5114000;Krefeld;W;12;0;0;0;1;0;1;0;0;0;1;2;0;1;1;2;3;1;3;0;10
***300;Diebstahl insgesamt von Fahrrädern einschl. unbefugte Ingebrauchnahme;5114000;Krefeld;X;99;0;1;1;1;7;10;10;9;19;10;39;1;5;6;14;22;11;5;2;60
***300;Diebstahl insgesamt von Fahrrädern einschl. unbefugte Ingebrauchnahme;14713000;Leipzig;M;590;0;0;0;1;7;8;18;24;42;45;95;42;57;99;145;204;33;10;4;495
***300;Diebstahl insgesamt von Fahrrädern einschl. unbefugte Ingebrauchnahme;14713000;Leipzig;W;66;0;0;1;1;0;2;1;2;3;8;13;2;7;9;23;15;3;1;2;53
***300;Diebstahl insgesamt von Fahrrädern einschl. unbefugte Ingebrauchnahme;14713000;Leipzig;X;656;0;0;1;2;7;10;19;26;45;53;108;44;64;108;168;219;36;11;6;548
***300;Diebstahl insgesamt von Fahrrädern einschl. unbefugte Ingebrauchnahme;5316000;Leverkusen;M;41;0;0;0;0;3;3;5;2;7;5;15;5;2;7;7;7;3;2;0;26
***300;Diebstahl insgesamt von Fahrrädern einschl. unbefugte Ingebrauchnahme;5316000;Leverkusen;W;7;0;0;0;0;0;0;0;0;0;1;1;2;0;2;0;3;0;0;1;6
***300;Diebstahl insgesamt von Fahrrädern einschl. unbefugte Ingebrauchnahme;5316000;Leverkusen;X;48;0;0;0;0;3;3;5;2;7;6;16;7;2;9;7;10;3;2;1;32
***300;Diebstahl insgesamt von Fahrrädern einschl. unbefugte Ingebrauchnahme;1003000;Lübeck;M;122;0;0;0;2;3;5;14;14;28;14;47;10;4;14;16;18;17;6;4;75
***300;Diebstahl insgesamt von Fahrrädern einschl. unbefugte Ingebrauchnahme;1003000;Lübeck;W;10;0;0;0;0;0;0;2;1;3;0;3;0;1;1;2;0;3;0;1;7
***300;Diebstahl insgesamt von Fahrrädern einschl. unbefugte Ingebrauchnahme;1003000;Lübeck;X;132;0;0;0;2;3;5;16;15;31;14;50;10;5;15;18;18;20;6;5;82
***300;Diebstahl insgesamt von Fahrrädern einschl. unbefugte Ingebrauchnahme;7314000;Ludwigshafen am Rhein;M;62;1;1;0;0;6;8;6;7;13;10;31;2;2;4;10;8;5;1;3;31
***300;Diebstahl insgesamt von Fahrrädern einschl. unbefugte Ingebrauchnahme;7314000;Ludwigshafen am Rhein;W;6;0;0;0;0;2;2;0;0;0;1;3;1;0;1;0;0;0;1;1;3
***300;Diebstahl insgesamt von Fahrrädern einschl. unbefugte Ingebrauchnahme;7314000;Ludwigshafen am Rhein;X;68;1;1;0;0;8;10;6;7;13;11;34;3;2;5;10;8;5;2;4;34
***300;Diebstahl insgesamt von Fahrrädern einschl. unbefugte Ingebrauchnahme;15003000;Magdeburg;M;156;0;0;2;4;3;9;8;15;23;24;56;16;16;32;29;27;9;3;0;100
***300;Diebstahl insgesamt von Fahrrädern einschl. unbefugte Ingebrauchnahme;15003000;Magdeburg;W;15;0;0;0;0;0;0;3;0;3;1;4;1;3;4;2;2;1;1;1;11
***300;Diebstahl insgesamt von Fahrrädern einschl. unbefugte Ingebrauchnahme;15003000;Magdeburg;X;171;0;0;2;4;3;9;11;15;26;25;60;17;19;36;31;29;10;4;1;111
***300;Diebstahl insgesamt von Fahrrädern einschl. unbefugte Ingebrauchnahme;7315000;Mainz;M;71;0;0;0;0;2;2;2;13;15;10;27;6;2;8;5;12;10;8;1;44
***300;Diebstahl insgesamt von Fahrrädern einschl. unbefugte Ingebrauchnahme;7315000;Mainz;W;6;0;0;0;1;0;1;0;1;1;1;3;0;0;0;0;0;3;0;0;3
***300;Diebstahl insgesamt von Fahrrädern einschl. unbefugte Ingebrauchnahme;7315000;Mainz;X;77;0;0;0;1;2;3;2;14;16;11;30;6;2;8;5;12;13;8;1;47
***300;Diebstahl insgesamt von Fahrrädern einschl. unbefugte Ingebrauchnahme;8222000;Mannheim;M;59;0;0;0;3;5;8;3;6;9;2;19;8;7;15;9;11;3;1;1;40
***300;Diebstahl insgesamt von Fahrrädern einschl. unbefugte Ingebrauchnahme;8222000;Mannheim;W;6;0;0;0;0;0;0;2;0;2;0;2;0;1;1;0;1;2;0;0;4
***300;Diebstahl insgesamt von Fahrrädern einschl. unbefugte Ingebrauchnahme;8222000;Mannheim;X;65;0;0;0;3;5;8;5;6;11;2;21;8;8;16;9;12;5;1;1;44
***300;Diebstahl insgesamt von Fahrrädern einschl. unbefugte Ingebrauchnahme;5170024;Moers;M;36;0;0;0;1;2;3;3;3;6;4;13;0;3;3;5;5;8;2;0;23
***300;Diebstahl insgesamt von Fahrrädern einschl. unbefugte Ingebrauchnahme;5170024;Moers;W;5;0;0;0;0;0;0;0;1;1;0;1;0;0;0;2;0;1;1;0;4
***300;Diebstahl insgesamt von Fahrrädern einschl. unbefugte Ingebrauchnahme;5170024;Moers;X;41;0;0;0;1;2;3;3;4;7;4;14;0;3;3;7;5;9;3;0;27
***300;Diebstahl insgesamt von Fahrrädern einschl. unbefugte Ingebrauchnahme;5116000;Mönchengladbach;M;64;0;0;1;1;1;3;5;1;6;11;20;6;6;12;3;16;8;4;1;44
***300;Diebstahl insgesamt von Fahrrädern einschl. unbefugte Ingebrauchnahme;5116000;Mönchengladbach;W;6;0;0;0;0;0;0;0;0;0;1;1;1;0;1;2;2;0;0;0;5
***300;Diebstahl insgesamt von Fahrrädern einschl. unbefugte Ingebrauchnahme;5116000;Mönchengladbach;X;70;0;0;1;1;1;3;5;1;6;12;21;7;6;13;5;18;8;4;1;49
***300;Diebstahl insgesamt von Fahrrädern einschl. unbefugte Ingebrauchnahme;5117000;Mülheim an der Ruhr;M;21;0;0;0;0;1;1;2;1;3;3;7;2;1;3;4;5;2;0;0;14
***300;Diebstahl insgesamt von Fahrrädern einschl. unbefugte Ingebrauchnahme;5117000;Mülheim an der Ruhr;W;2;0;0;0;0;0;0;0;0;0;1;1;0;0;0;0;1;0;0;0;1
***300;Diebstahl insgesamt von Fahrrädern einschl. unbefugte Ingebrauchnahme;5117000;Mülheim an der Ruhr;X;23;0;0;0;0;1;1;2;1;3;4;8;2;1;3;4;6;2;0;0;15
***300;Diebstahl insgesamt von Fahrrädern einschl. unbefugte Ingebrauchnahme;9162000;München;M;754;0;0;0;5;17;22;80;99;179;136;337;65;52;117;91;109;46;30;24;417
***300;Diebstahl insgesamt von Fahrrädern einschl. unbefugte Ingebrauchnahme;9162000;München;W;42;0;0;0;0;0;0;3;6;9;7;16;0;4;4;6;8;4;1;3;26
***300;Diebstahl insgesamt von Fahrrädern einschl. unbefugte Ingebrauchnahme;9162000;München;X;796;0;0;0;5;17;22;83;105;188;143;353;65;56;121;97;117;50;31;27;443
***300;Diebstahl insgesamt von Fahrrädern einschl. unbefugte Ingebrauchnahme;5515000;Münster;M;186;0;0;0;4;6;10;10;14;24;22;56;25;11;36;24;32;22;8;8;130
***300;Diebstahl insgesamt von Fahrrädern einschl. unbefugte Ingebrauchnahme;5515000;Münster;W;22;0;0;0;0;0;0;0;4;4;6;10;0;1;1;1;6;2;1;1;12
***300;Diebstahl insgesamt von Fahrrädern einschl. unbefugte Ingebrauchnahme;5515000;Münster;X;208;0;0;0;4;6;10;10;18;28;28;66;25;12;37;25;38;24;9;9;142
***300;Diebstahl insgesamt von Fahrrädern einschl. unbefugte Ingebrauchnahme;5162024;Neuss;M;83;0;0;0;0;2;2;5;7;12;16;30;2;6;8;13;18;11;3;0;53
***300;Diebstahl insgesamt von Fahrrädern einschl. unbefugte Ingebrauchnahme;5162024;Neuss;W;8;0;0;0;0;0;0;1;0;1;0;1;0;1;1;0;3;3;0;0;7
***300;Diebstahl insgesamt von Fahrrädern einschl. unbefugte Ingebrauchnahme;5162024;Neuss;X;91;0;0;0;0;2;2;6;7;13;16;31;2;7;9;13;21;14;3;0;60
***300;Diebstahl insgesamt von Fahrrädern einschl. unbefugte Ingebrauchnahme;9564000;Nürnberg;M;226;0;0;0;0;7;7;18;19;37;40;84;11;17;28;26;57;17;9;5;142
***300;Diebstahl insgesamt von Fahrrädern einschl. unbefugte Ingebrauchnahme;9564000;Nürnberg;W;21;0;0;0;0;0;0;2;1;3;0;3;2;3;5;2;4;5;0;2;18
***300;Diebstahl insgesamt von Fahrrädern einschl. unbefugte Ingebrauchnahme;9564000;Nürnberg;X;247;0;0;0;0;7;7;20;20;40;40;87;13;20;33;28;61;22;9;7;160
***300;Diebstahl insgesamt von Fahrrädern einschl. unbefugte Ingebrauchnahme;5119000;Oberhausen;M;26;0;0;0;1;0;1;2;4;6;4;11;1;1;2;5;1;6;1;0;15
***300;Diebstahl insgesamt von Fahrrädern einschl. unbefugte Ingebrauchnahme;5119000;Oberhausen;W;3;0;0;0;0;0;0;0;0;0;1;1;0;0;0;1;0;1;0;0;2
***300;Diebstahl insgesamt von Fahrrädern einschl. unbefugte Ingebrauchnahme;5119000;Oberhausen;X;29;0;0;0;1;0;1;2;4;6;5;12;1;1;2;6;1;7;1;0;17
***300;Diebstahl insgesamt von Fahrrädern einschl. unbefugte Ingebrauchnahme;6413000;Offenbach am Main;M;55;0;0;0;0;0;0;10;9;19;10;29;0;3;3;2;6;13;1;1;26
***300;Diebstahl insgesamt von Fahrrädern einschl. unbefugte Ingebrauchnahme;6413000;Offenbach am Main;W;4;0;0;0;0;0;0;1;0;1;0;1;1;0;1;0;1;0;0;1;3
***300;Diebstahl insgesamt von Fahrrädern einschl. unbefugte Ingebrauchnahme;6413000;Offenbach am Main;X;59;0;0;0;0;0;0;11;9;20;10;30;1;3;4;2;7;13;1;2;29
***300;Diebstahl insgesamt von Fahrrädern einschl. unbefugte Ingebrauchnahme;3403000;Oldenburg (Oldenburg);M;165;0;0;0;0;2;2;7;20;27;32;61;20;13;33;20;25;13;8;5;104
***300;Diebstahl insgesamt von Fahrrädern einschl. unbefugte Ingebrauchnahme;3403000;Oldenburg (Oldenburg);W;18;0;0;0;0;2;2;1;2;3;4;9;2;1;3;1;4;1;0;0;9
***300;Diebstahl insgesamt von Fahrrädern einschl. unbefugte Ingebrauchnahme;3403000;Oldenburg (Oldenburg);X;183;0;0;0;0;4;4;8;22;30;36;70;22;14;36;21;29;14;8;5;113
***300;Diebstahl insgesamt von Fahrrädern einschl. unbefugte Ingebrauchnahme;3404000;Osnabrück;M;109;0;0;0;1;3;4;5;3;8;11;23;6;9;15;24;30;9;6;2;86
***300;Diebstahl insgesamt von Fahrrädern einschl. unbefugte Ingebrauchnahme;3404000;Osnabrück;W;5;0;0;0;0;0;0;0;0;0;0;0;0;0;0;0;3;2;0;0;5
***300;Diebstahl insgesamt von Fahrrädern einschl. unbefugte Ingebrauchnahme;3404000;Osnabrück;X;114;0;0;0;1;3;4;5;3;8;11;23;6;9;15;24;33;11;6;2;91
***300;Diebstahl insgesamt von Fahrrädern einschl. unbefugte Ingebrauchnahme;5774032;Paderborn;M;101;0;0;0;1;3;4;8;18;26;16;46;2;6;8;16;17;11;2;1;55
***300;Diebstahl insgesamt von Fahrrädern einschl. unbefugte Ingebrauchnahme;5774032;Paderborn;W;9;0;0;0;0;0;0;0;0;0;2;2;0;1;1;4;2;0;0;0;7
***300;Diebstahl insgesamt von Fahrrädern einschl. unbefugte Ingebrauchnahme;5774032;Paderborn;X;110;0;0;0;1;3;4;8;18;26;18;48;2;7;9;20;19;11;2;1;62
***300;Diebstahl insgesamt von Fahrrädern einschl. unbefugte Ingebrauchnahme;8231000;Pforzheim;M;8;0;0;1;2;0;3;0;0;0;2;5;0;0;0;0;1;2;0;0;3
***300;Diebstahl insgesamt von Fahrrädern einschl. unbefugte Ingebrauchnahme;8231000;Pforzheim;W;1;0;0;0;0;0;0;0;0;0;0;0;0;0;0;0;1;0;0;0;1
***300;Diebstahl insgesamt von Fahrrädern einschl. unbefugte Ingebrauchnahme;8231000;Pforzheim;X;9;0;0;1;2;0;3;0;0;0;2;5;0;0;0;0;2;2;0;0;4
***300;Diebstahl insgesamt von Fahrrädern einschl. unbefugte Ingebrauchnahme;12054000;Potsdam;M;82;0;0;0;0;3;3;11;8;19;13;35;9;7;16;11;14;4;2;0;47
***300;Diebstahl insgesamt von Fahrrädern einschl. unbefugte Ingebrauchnahme;12054000;Potsdam;W;3;0;0;0;0;0;0;1;0;1;0;1;0;0;0;1;0;1;0;0;2
***300;Diebstahl insgesamt von Fahrrädern einschl. unbefugte Ingebrauchnahme;12054000;Potsdam;X;85;0;0;0;0;3;3;12;8;20;13;36;9;7;16;12;14;5;2;0;49
***300;Diebstahl insgesamt von Fahrrädern einschl. unbefugte Ingebrauchnahme;5562032;Recklinghausen;M;56;0;0;0;2;3;5;1;2;3;8;16;4;8;12;8;14;5;1;0;40
***300;Diebstahl insgesamt von Fahrrädern einschl. unbefugte Ingebrauchnahme;5562032;Recklinghausen;W;3;0;0;0;1;0;1;0;1;1;1;3;0;0;0;0;0;0;0;0;0
***300;Diebstahl insgesamt von Fahrrädern einschl. unbefugte Ingebrauchnahme;5562032;Recklinghausen;X;59;0;0;0;3;3;6;1;3;4;9;19;4;8;12;8;14;5;1;0;40
***300;Diebstahl insgesamt von Fahrrädern einschl. unbefugte Ingebrauchnahme;9362000;Regensburg;M;62;0;0;0;0;0;0;1;7;8;8;16;2;5;7;17;16;4;1;1;46
***300;Diebstahl insgesamt von Fahrrädern einschl. unbefugte Ingebrauchnahme;9362000;Regensburg;W;6;0;0;0;0;0;0;0;0;0;1;1;0;0;0;1;3;1;0;0;5
***300;Diebstahl insgesamt von Fahrrädern einschl. unbefugte Ingebrauchnahme;9362000;Regensburg;X;68;0;0;0;0;0;0;1;7;8;9;17;2;5;7;18;19;5;1;1;51
***300;Diebstahl insgesamt von Fahrrädern einschl. unbefugte Ingebrauchnahme;5120000;Remscheid;M;8;0;0;0;1;0;1;0;0;0;0;1;0;0;0;3;3;0;1;0;7
***300;Diebstahl insgesamt von Fahrrädern einschl. unbefugte Ingebrauchnahme;5120000;Remscheid;W;1;0;0;0;0;0;0;0;0;0;0;0;0;0;0;1;0;0;0;0;1
***300;Diebstahl insgesamt von Fahrrädern einschl. unbefugte Ingebrauchnahme;5120000;Remscheid;X;9;0;0;0;1;0;1;0;0;0;0;1;0;0;0;4;3;0;1;0;8
***300;Diebstahl insgesamt von Fahrrädern einschl. unbefugte Ingebrauchnahme;8415061;Reutlingen;M;20;0;0;0;0;2;2;3;6;9;0;11;0;2;2;2;4;1;0;0;9
***300;Diebstahl insgesamt von Fahrrädern einschl. unbefugte Ingebrauchnahme;8415061;Reutlingen;W;6;0;0;0;0;0;0;3;2;5;0;5;1;0;1;0;0;0;0;0;1
***300;Diebstahl insgesamt von Fahrrädern einschl. unbefugte Ingebrauchnahme;8415061;Reutlingen;X;26;0;0;0;0;2;2;6;8;14;0;16;1;2;3;2;4;1;0;0;10
***300;Diebstahl insgesamt von Fahrrädern einschl. unbefugte Ingebrauchnahme;13003000;Rostock;M;119;0;0;0;2;9;11;15;16;31;12;54;9;6;15;17;20;8;4;1;65
***300;Diebstahl insgesamt von Fahrrädern einschl. unbefugte Ingebrauchnahme;13003000;Rostock;W;19;0;0;0;2;2;4;1;2;3;1;8;0;2;2;3;2;2;0;2;11
***300;Diebstahl insgesamt von Fahrrädern einschl. unbefugte Ingebrauchnahme;13003000;Rostock;X;138;0;0;0;4;11;15;16;18;34;13;62;9;8;17;20;22;10;4;3;76
***300;Diebstahl insgesamt von Fahrrädern einschl. unbefugte Ingebrauchnahme;10041100;Saarbrücken;M;27;0;1;1;0;1;3;4;0;4;3;10;1;1;2;9;4;0;2;0;17
***300;Diebstahl insgesamt von Fahrrädern einschl. unbefugte Ingebrauchnahme;10041100;Saarbrücken;W;4;0;0;0;0;0;0;0;0;0;0;0;0;0;0;3;0;1;0;0;4
***300;Diebstahl insgesamt von Fahrrädern einschl. unbefugte Ingebrauchnahme;10041100;Saarbrücken;X;31;0;1;1;0;1;3;4;0;4;3;10;1;1;2;12;4;1;2;0;21
***300;Diebstahl insgesamt von Fahrrädern einschl. unbefugte Ingebrauchnahme;5122000;Solingen;M;21;0;0;0;0;3;3;5;1;6;1;10;1;1;2;0;4;4;1;0;11
***300;Diebstahl insgesamt von Fahrrädern einschl. unbefugte Ingebrauchnahme;5122000;Solingen;W;2;0;0;0;0;0;0;0;0;0;0;0;0;0;0;0;0;1;1;0;2
***300;Diebstahl insgesamt von Fahrrädern einschl. unbefugte Ingebrauchnahme;5122000;Solingen;X;23;0;0;0;0;3;3;5;1;6;1;10;1;1;2;0;4;5;2;0;13
***300;Diebstahl insgesamt von Fahrrädern einschl. unbefugte Ingebrauchnahme;8111000;Stuttgart;M;103;0;2;1;1;4;8;7;20;27;21;56;6;5;11;7;12;8;7;2;47
***300;Diebstahl insgesamt von Fahrrädern einschl. unbefugte Ingebrauchnahme;8111000;Stuttgart;W;7;0;0;1;0;0;1;2;2;4;0;5;0;0;0;1;0;1;0;0;2
***300;Diebstahl insgesamt von Fahrrädern einschl. unbefugte Ingebrauchnahme;8111000;Stuttgart;X;110;0;2;2;1;4;9;9;22;31;21;61;6;5;11;8;12;9;7;2;49
***300;Diebstahl insgesamt von Fahrrädern einschl. unbefugte Ingebrauchnahme;7211000;Trier;M;43;0;0;0;0;1;1;1;11;12;5;18;5;8;13;5;3;1;1;2;25
***300;Diebstahl insgesamt von Fahrrädern einschl. unbefugte Ingebrauchnahme;7211000;Trier;W;4;0;0;0;0;1;1;0;1;1;0;2;0;2;2;0;0;0;0;0;2
***300;Diebstahl insgesamt von Fahrrädern einschl. unbefugte Ingebrauchnahme;7211000;Trier;X;47;0;0;0;0;2;2;1;12;13;5;20;5;10;15;5;3;1;1;2;27
***300;Diebstahl insgesamt von Fahrrädern einschl. unbefugte Ingebrauchnahme;8421000;Ulm;M;31;0;0;0;0;0;0;0;3;3;0;3;0;2;2;6;12;5;2;1;28
***300;Diebstahl insgesamt von Fahrrädern einschl. unbefugte Ingebrauchnahme;8421000;Ulm;W;5;0;0;0;0;0;0;0;1;1;0;1;1;0;1;1;2;0;0;0;4
***300;Diebstahl insgesamt von Fahrrädern einschl. unbefugte Ingebrauchnahme;8421000;Ulm;X;36;0;0;0;0;0;0;0;4;4;0;4;1;2;3;7;14;5;2;1;32
***300;Diebstahl insgesamt von Fahrrädern einschl. unbefugte Ingebrauchnahme;6414000;Wiesbaden;M;58;0;0;0;2;3;5;6;10;16;9;30;0;1;1;7;15;3;2;0;28
***300;Diebstahl insgesamt von Fahrrädern einschl. unbefugte Ingebrauchnahme;6414000;Wiesbaden;W;6;0;0;1;0;1;2;1;0;1;0;3;0;0;0;0;3;0;0;0;3
***300;Diebstahl insgesamt von Fahrrädern einschl. unbefugte Ingebrauchnahme;6414000;Wiesbaden;X;64;0;0;1;2;4;7;7;10;17;9;33;0;1;1;7;18;3;2;0;31
***300;Diebstahl insgesamt von Fahrrädern einschl. unbefugte Ingebrauchnahme;3103000;Wolfsburg;M;44;0;0;0;0;6;6;7;6;13;7;26;1;4;5;5;5;2;1;0;18
***300;Diebstahl insgesamt von Fahrrädern einschl. unbefugte Ingebrauchnahme;3103000;Wolfsburg;W;5;0;0;0;0;0;0;2;1;3;0;3;0;0;0;1;0;1;0;0;2
***300;Diebstahl insgesamt von Fahrrädern einschl. unbefugte Ingebrauchnahme;3103000;Wolfsburg;X;49;0;0;0;0;6;6;9;7;16;7;29;1;4;5;6;5;3;1;0;20
***300;Diebstahl insgesamt von Fahrrädern einschl. unbefugte Ingebrauchnahme;5124000;Wuppertal;M;25;0;0;1;2;1;4;1;2;3;2;9;2;1;3;5;4;4;0;0;16
***300;Diebstahl insgesamt von Fahrrädern einschl. unbefugte Ingebrauchnahme;5124000;Wuppertal;W;2;0;0;0;0;0;0;0;0;0;0;0;0;0;0;0;0;1;1;0;2
***300;Diebstahl insgesamt von Fahrrädern einschl. unbefugte Ingebrauchnahme;5124000;Wuppertal;X;27;0;0;1;2;1;4;1;2;3;2;9;2;1;3;5;4;5;1;0;18
***300;Diebstahl insgesamt von Fahrrädern einschl. unbefugte Ingebrauchnahme;9663000;Würzburg;M;45;0;0;0;0;0;0;3;6;9;8;17;4;5;9;5;10;1;1;2;28
***300;Diebstahl insgesamt von Fahrrädern einschl. unbefugte Ingebrauchnahme;9663000;Würzburg;W;1;0;0;0;0;0;0;0;1;1;0;1;0;0;0;0;0;0;0;0;0
***300;Diebstahl insgesamt von Fahrrädern einschl. unbefugte Ingebrauchnahme;9663000;Würzburg;X;46;0;0;0;0;0;0;3;7;10;8;18;4;5;9;5;10;1;1;2;28
*50*00;Diebstahl insgesamt an/aus Kraftfahrzeugen;5334002;Aachen;M;76;0;0;0;0;0;0;8;4;12;8;20;3;6;9;13;17;12;5;0;56
*50*00;Diebstahl insgesamt an/aus Kraftfahrzeugen;5334002;Aachen;W;1;0;0;0;0;0;0;0;0;0;0;0;0;0;0;0;1;0;0;0;1
*50*00;Diebstahl insgesamt an/aus Kraftfahrzeugen;5334002;Aachen;X;77;0;0;0;0;0;0;8;4;12;8;20;3;6;9;13;18;12;5;0;57
*50*00;Diebstahl insgesamt an/aus Kraftfahrzeugen;9761000;Augsburg;M;41;0;0;0;0;1;1;1;4;5;5;11;3;1;4;12;4;6;1;3;30
*50*00;Diebstahl insgesamt an/aus Kraftfahrzeugen;9761000;Augsburg;W;2;0;0;0;0;0;0;0;0;0;0;0;0;0;0;0;1;0;1;0;2
*50*00;Diebstahl insgesamt an/aus Kraftfahrzeugen;9761000;Augsburg;X;43;0;0;0;0;1;1;1;4;5;5;11;3;1;4;12;5;6;2;3;32
*50*00;Diebstahl insgesamt an/aus Kraftfahrzeugen;5378004;Bergisch Gladbach;M;31;0;0;0;0;0;0;0;4;4;8;12;0;3;3;7;7;1;0;1;19
*50*00;Diebstahl insgesamt an/aus Kraftfahrzeugen;5378004;Bergisch Gladbach;W;1;0;0;0;0;0;0;0;0;0;0;0;0;0;0;0;1;0;0;0;1
*50*00;Diebstahl insgesamt an/aus Kraftfahrzeugen;5378004;Bergisch Gladbach;X;32;0;0;0;0;0;0;0;4;4;8;12;0;3;3;7;8;1;0;1;20
*50*00;Diebstahl insgesamt an/aus Kraftfahrzeugen;11000000;Berlin;M;935;0;0;0;5;17;22;26;69;95;135;252;98;81;179;154;230;86;26;8;683
*50*00;Diebstahl insgesamt an/aus Kraftfahrzeugen;11000000;Berlin;W;44;0;0;0;1;0;1;3;3;6;4;11;2;2;4;7;16;6;0;0;33
*50*00;Diebstahl insgesamt an/aus Kraftfahrzeugen;11000000;Berlin;X;979;0;0;0;6;17;23;29;72;101;139;263;100;83;183;161;246;92;26;8;716
*50*00;Diebstahl insgesamt an/aus Kraftfahrzeugen;5711000;Bielefeld;M;88;0;0;0;0;0;0;3;6;9;16;25;12;7;19;14;22;5;2;1;63
*50*00;Diebstahl insgesamt an/aus Kraftfahrzeugen;5711000;Bielefeld;W;5;0;0;0;0;0;0;0;0;0;1;1;0;1;1;1;2;0;0;0;4
*50*00;Diebstahl insgesamt an/aus Kraftfahrzeugen;5711000;Bielefeld;X;93;0;0;0;0;0;0;3;6;9;17;26;12;8;20;15;24;5;2;1;67
*50*00;Diebstahl insgesamt an/aus Kraftfahrzeugen;5911000;Bochum;M;89;0;0;1;1;1;3;8;13;21;15;39;7;4;11;12;19;3;5;0;50
*50*00;Diebstahl insgesamt an/aus Kraftfahrzeugen;5911000;Bochum;W;4;0;0;0;0;0;0;0;3;3;0;3;0;0;0;1;0;0;0;0;1
*50*00;Diebstahl insgesamt an/aus Kraftfahrzeugen;5911000;Bochum;X;93;0;0;1;1;1;3;8;16;24;15;42;7;4;11;13;19;3;5;0;51
*50*00;Diebstahl insgesamt an/aus Kraftfahrzeugen;5314000;Bonn;M;101;0;0;0;0;1;1;6;2;8;11;20;7;1;8;22;31;15;5;0;81
*50*00;Diebstahl insgesamt an/aus Kraftfahrzeugen;5314000;Bonn;W;6;0;0;0;0;0;0;0;0;0;2;2;0;0;0;0;2;2;0;0;4
*50*00;Diebstahl insgesamt an/aus Kraftfahrzeugen;5314000;Bonn;X;107;0;0;0;0;1;1;6;2;8;13;22;7;1;8;22;33;17;5;0;85
*50*00;Diebstahl insgesamt an/aus Kraftfahrzeugen;5512000;Bottrop;M;19;0;0;0;0;0;0;0;0;0;4;4;1;1;2;3;7;2;1;0;15
*50*00;Diebstahl insgesamt an/aus Kraftfahrzeugen;5512000;Bottrop;W;0;0;0;0;0;0;0;0;0;0;0;0;0;0;0;0;0;0;0;0;0
*50*00;Diebstahl insgesamt an/aus Kraftfahrzeugen;5512000;Bottrop;X;19;0;0;0;0;0;0;0;0;0;4;4;1;1;2;3;7;2;1;0;15
*50*00;Diebstahl insgesamt an/aus Kraftfahrzeugen;3101000;Braunschweig;M;59;0;0;0;0;0;0;0;2;2;6;8;4;5;9;12;15;6;5;4;51
*50*00;Diebstahl insgesamt an/aus Kraftfahrzeugen;3101000;Braunschweig;W;3;0;0;0;0;0;0;0;0;0;1;1;0;0;0;0;1;0;0;1;2
*50*00;Diebstahl insgesamt an/aus Kraftfahrzeugen;3101000;Braunschweig;X;62;0;0;0;0;0;0;0;2;2;7;9;4;5;9;12;16;6;5;5;53
*50*00;Diebstahl insgesamt an/aus Kraftfahrzeugen;4011000;Bremen;M;160;0;0;0;0;0;0;4;10;14;15;29;14;15;29;38;44;11;6;3;131
*50*00;Diebstahl insgesamt an/aus Kraftfahrzeugen;4011000;Bremen;W;5;0;0;0;0;0;0;0;2;2;0;2;0;0;0;1;2;0;0;0;3
*50*00;Diebstahl insgesamt an/aus Kraftfahrzeugen;4011000;Bremen;X;165;0;0;0;0;0;0;4;12;16;15;31;14;15;29;39;46;11;6;3;134
*50*00;Diebstahl insgesamt an/aus Kraftfahrzeugen;4012000;Bremerhaven;M;40;0;0;0;0;1;1;2;4;6;7;14;4;3;7;5;9;5;0;0;26
*50*00;Diebstahl insgesamt an/aus Kraftfahrzeugen;4012000;Bremerhaven;W;2;0;0;0;0;0;0;0;0;0;0;0;0;0;0;0;1;0;0;1;2
*50*00;Diebstahl insgesamt an/aus Kraftfahrzeugen;4012000;Bremerhaven;X;42;0;0;0;0;1;1;2;4;6;7;14;4;3;7;5;10;5;0;1;28
*50*00;Diebstahl insgesamt an/aus Kraftfahrzeugen;14511000;Chemnitz;M;110;0;0;0;0;0;0;4;4;8;15;23;5;11;16;24;30;13;2;2;87
*50*00;Diebstahl insgesamt an/aus Kraftfahrzeugen;14511000;Chemnitz;W;5;0;0;0;0;0;0;0;0;0;0;0;0;1;1;2;1;0;0;1;5
*50*00;Diebstahl insgesamt an/aus Kraftfahrzeugen;14511000;Chemnitz;X;115;0;0;0;0;0;0;4;4;8;15;23;5;12;17;26;31;13;2;3;92
*50*00;Diebstahl insgesamt an/aus Kraftfahrzeugen;6411000;Darmstadt;M;54;0;0;1;1;0;2;7;10;17;7;26;2;1;3;2;15;5;3;0;28
*50*00;Diebstahl insgesamt an/aus Kraftfahrzeugen;6411000;Darmstadt;W;2;0;0;0;0;0;0;0;0;0;0;0;0;0;0;0;2;0;0;0;2
*50*00;Diebstahl insgesamt an/aus Kraftfahrzeugen;6411000;Darmstadt;X;56;0;0;1;1;0;2;7;10;17;7;26;2;1;3;2;17;5;3;0;30
*50*00;Diebstahl insgesamt an/aus Kraftfahrzeugen;5913000;Dortmund;M;250;0;0;0;1;3;4;10;28;38;43;85;20;17;37;39;62;22;4;1;165
*50*00;Diebstahl insgesamt an/aus Kraftfahrzeugen;5913000;Dortmund;W;10;0;0;0;0;0;0;1;0;1;1;2;2;1;3;1;2;2;0;0;8
*50*00;Diebstahl insgesamt an/aus Kraftfahrzeugen;5913000;Dortmund;X;260;0;0;0;1;3;4;11;28;39;44;87;22;18;40;40;64;24;4;1;173
*50*00;Diebstahl insgesamt an/aus Kraftfahrzeugen;14612000;Dresden;M;175;0;0;0;0;0;0;4;5;9;11;20;20;18;38;38;57;18;3;1;155
*50*00;Diebstahl insgesamt an/aus Kraftfahrzeugen;14612000;Dresden;W;10;0;0;0;0;0;0;1;0;1;0;1;0;2;2;6;1;0;0;0;9
*50*00;Diebstahl insgesamt an/aus Kraftfahrzeugen;14612000;Dresden;X;185;0;0;0;0;0;0;5;5;10;11;21;20;20;40;44;58;18;3;1;164
*50*00;Diebstahl insgesamt an/aus Kraftfahrzeugen;5112000;Duisburg;M;111;0;0;0;0;5;5;9;6;15;11;31;5;8;13;10;40;12;5;0;80
*50*00;Diebstahl insgesamt an/aus Kraftfahrzeugen;5112000;Duisburg;W;9;0;0;0;0;0;0;0;0;0;1;1;2;2;4;1;1;0;2;0;8
*50*00;Diebstahl insgesamt an/aus Kraftfahrzeugen;5112000;Duisburg;X;120;0;0;0;0;5;5;9;6;15;12;32;7;10;17;11;41;12;7;0;88
*50*00;Diebstahl insgesamt an/aus Kraftfahrzeugen;5111000;Düsseldorf;M;250;0;2;0;0;2;4;13;14;27;32;63;16;27;43;43;69;25;4;3;187
*50*00;Diebstahl insgesamt an/aus Kraftfahrzeugen;5111000;Düsseldorf;W;18;0;0;0;0;0;0;1;0;1;2;3;1;3;4;2;6;2;1;0;15
*50*00;Diebstahl insgesamt an/aus Kraftfahrzeugen;5111000;Düsseldorf;X;268;0;2;0;0;2;4;14;14;28;34;66;17;30;47;45;75;27;5;3;202
*50*00;Diebstahl insgesamt an/aus Kraftfahrzeugen;16051000;Erfurt;M;30;0;0;0;0;1;1;1;1;2;1;4;1;3;4;7;9;3;2;1;26
*50*00;Diebstahl insgesamt an/aus Kraftfahrzeugen;16051000;Erfurt;W;3;0;0;0;0;0;0;0;0;0;0;0;1;2;3;0;0;0;0;0;3
*50*00;Diebstahl insgesamt an/aus Kraftfahrzeugen;16051000;Erfurt;X;33;0;0;0;0;1;1;1;1;2;1;4;2;5;7;7;9;3;2;1;29
*50*00;Diebstahl insgesamt an/aus Kraftfahrzeugen;9562000;Erlangen;M;17;0;0;0;0;0;0;4;0;4;4;8;0;1;1;3;3;2;0;0;9
*50*00;Diebstahl insgesamt an/aus Kraftfahrzeugen;9562000;Erlangen;W;0;0;0;0;0;0;0;0;0;0;0;0;0;0;0;0;0;0;0;0;0
*50*00;Diebstahl insgesamt an/aus Kraftfahrzeugen;9562000;Erlangen;X;17;0;0;0;0;0;0;4;0;4;4;8;0;1;1;3;3;2;0;0;9
*50*00;Diebstahl insgesamt an/aus Kraftfahrzeugen;5113000;Essen;M;151;0;0;0;0;0;0;3;14;17;20;37;12;14;26;23;36;22;5;2;114
*50*00;Diebstahl insgesamt an/aus Kraftfahrzeugen;5113000;Essen;W;4;0;0;0;0;0;0;0;1;1;1;2;0;0;0;0;2;0;0;0;2
*50*00;Diebstahl insgesamt an/aus Kraftfahrzeugen;5113000;Essen;X;155;0;0;0;0;0;0;3;15;18;21;39;12;14;26;23;38;22;5;2;116
*50*00;Diebstahl insgesamt an/aus Kraftfahrzeugen;6412000;Frankfurt am Main;M;275;0;0;0;0;0;0;4;17;21;51;72;21;15;36;47;73;32;11;4;203
*50*00;Diebstahl insgesamt an/aus Kraftfahrzeugen;6412000;Frankfurt am Main;W;14;0;0;0;0;0;0;1;3;4;0;4;2;0;2;1;5;1;1;0;10
*50*00;Diebstahl insgesamt an/aus Kraftfahrzeugen;6412000;Frankfurt am Main;X;289;0;0;0;0;0;0;5;20;25;51;76;23;15;38;48;78;33;12;4;213
*50*00;Diebstahl insgesamt an/aus Kraftfahrzeugen;8311000;Freiburg im Breisgau;M;54;0;0;0;0;0;0;2;6;8;11;19;5;4;9;11;7;5;2;1;35
*50*00;Diebstahl insgesamt an/aus Kraftfahrzeugen;8311000;Freiburg im Breisgau;W;1;0;0;0;0;0;0;0;0;0;0;0;0;0;0;0;0;1;0;0;1
*50*00;Diebstahl insgesamt an/aus Kraftfahrzeugen;8311000;Freiburg im Breisgau;X;55;0;0;0;0;0;0;2;6;8;11;19;5;4;9;11;7;6;2;1;36
*50*00;Diebstahl insgesamt an/aus Kraftfahrzeugen;9563000;Fürth;M;21;0;0;0;0;0;0;0;1;1;4;5;2;2;4;3;5;2;2;0;16
*50*00;Diebstahl insgesamt an/aus Kraftfahrzeugen;9563000;Fürth;W;3;0;0;0;0;0;0;0;0;0;0;0;0;1;1;0;0;1;1;0;3
*50*00;Diebstahl insgesamt an/aus Kraftfahrzeugen;9563000;Fürth;X;24;0;0;0;0;0;0;0;1;1;4;5;2;3;5;3;5;3;3;0;19
*50*00;Diebstahl insgesamt an/aus Kraftfahrzeugen;5513000;Gelsenkirchen;M;68;0;0;0;0;0;0;0;3;3;8;11;5;6;11;12;17;11;6;0;57
*50*00;Diebstahl insgesamt an/aus Kraftfahrzeugen;5513000;Gelsenkirchen;W;4;0;0;0;0;0;0;0;0;0;0;0;0;0;0;1;1;2;0;0;4
*50*00;Diebstahl insgesamt an/aus Kraftfahrzeugen;5513000;Gelsenkirchen;X;72;0;0;0;0;0;0;0;3;3;8;11;5;6;11;13;18;13;6;0;61
*50*00;Diebstahl insgesamt an/aus Kraftfahrzeugen;3152012;Göttingen;M;42;0;0;0;0;0;0;0;0;0;4;4;4;5;9;5;17;7;0;0;38
*50*00;Diebstahl insgesamt an/aus Kraftfahrzeugen;3152012;Göttingen;W;0;0;0;0;0;0;0;0;0;0;0;0;0;0;0;0;0;0;0;0;0
*50*00;Diebstahl insgesamt an/aus Kraftfahrzeugen;3152012;Göttingen;X;42;0;0;0;0;0;0;0;0;0;4;4;4;5;9;5;17;7;0;0;38
*50*00;Diebstahl insgesamt an/aus Kraftfahrzeugen;5914000;Hagen;M;50;0;0;0;0;0;0;3;1;4;3;7;1;8;9;6;16;9;2;1;43
*50*00;Diebstahl insgesamt an/aus Kraftfahrzeugen;5914000;Hagen;W;5;0;0;0;0;0;0;0;0;0;0;0;0;0;0;1;1;2;1;0;5
*50*00;Diebstahl insgesamt an/aus Kraftfahrzeugen;5914000;Hagen;X;55;0;0;0;0;0;0;3;1;4;3;7;1;8;9;7;17;11;3;1;48
*50*00;Diebstahl insgesamt an/aus Kraftfahrzeugen;15002000;Halle (Saale);M;64;0;0;0;0;0;0;1;10;11;7;18;2;1;3;15;23;3;2;0;46
*50*00;Diebstahl insgesamt an/aus Kraftfahrzeugen;15002000;Halle (Saale);W;3;0;0;0;0;0;0;0;0;0;1;1;0;0;0;1;1;0;0;0;2
*50*00;Diebstahl insgesamt an/aus Kraftfahrzeugen;15002000;Halle (Saale);X;67;0;0;0;0;0;0;1;10;11;8;19;2;1;3;16;24;3;2;0;48
*50*00;Diebstahl insgesamt an/aus Kraftfahrzeugen;2000000;Hamburg;M;441;0;0;0;2;5;7;18;35;53;71;131;31;22;53;73;107;57;15;5;310
*50*00;Diebstahl insgesamt an/aus Kraftfahrzeugen;2000000;Hamburg;W;26;0;0;0;0;4;4;1;4;5;2;11;2;3;5;4;5;1;0;0;15
*50*00;Diebstahl insgesamt an/aus Kraftfahrzeugen;2000000;Hamburg;X;467;0;0;0;2;9;11;19;39;58;73;142;33;25;58;77;112;58;15;5;325
*50*00;Diebstahl insgesamt an/aus Kraftfahrzeugen;5915000;Hamm;M;47;0;0;0;0;0;0;3;3;6;9;15;4;3;7;6;13;6;0;0;32
*50*00;Diebstahl insgesamt an/aus Kraftfahrzeugen;5915000;Hamm;W;2;0;0;0;0;0;0;0;0;0;1;1;0;0;0;0;0;1;0;0;1
*50*00;Diebstahl insgesamt an/aus Kraftfahrzeugen;5915000;Hamm;X;49;0;0;0;0;0;0;3;3;6;10;16;4;3;7;6;13;7;0;0;33
*50*00;Diebstahl insgesamt an/aus Kraftfahrzeugen;3241001;Hannover;M;164;0;0;0;0;0;0;1;10;11;19;30;21;9;30;27;45;19;10;3;134
*50*00;Diebstahl insgesamt an/aus Kraftfahrzeugen;3241001;Hannover;W;24;0;0;0;0;1;1;2;1;3;6;10;1;2;3;5;4;0;2;0;14
*50*00;Diebstahl insgesamt an/aus Kraftfahrzeugen;3241001;Hannover;X;188;0;0;0;0;1;1;3;11;14;25;40;22;11;33;32;49;19;12;3;148
*50*00;Diebstahl insgesamt an/aus Kraftfahrzeugen;8221000;Heidelberg;M;22;0;0;0;0;1;1;2;1;3;5;9;3;1;4;5;4;0;0;0;13
*50*00;Diebstahl insgesamt an/aus Kraftfahrzeugen;8221000;Heidelberg;W;4;0;0;0;0;0;0;0;0;0;0;0;1;1;2;0;1;1;0;0;4
*50*00;Diebstahl insgesamt an/aus Kraftfahrzeugen;8221000;Heidelberg;X;26;0;0;0;0;1;1;2;1;3;5;9;4;2;6;5;5;1;0;0;17
*50*00;Diebstahl insgesamt an/aus Kraftfahrzeugen;8121000;Heilbronn;M;18;0;0;0;0;0;0;0;1;1;1;2;3;4;7;4;3;0;1;1;16
*50*00;Diebstahl insgesamt an/aus Kraftfahrzeugen;8121000;Heilbronn;W;1;0;0;0;0;0;0;0;0;0;0;0;0;1;1;0;0;0;0;0;1
*50*00;Diebstahl insgesamt an/aus Kraftfahrzeugen;8121000;Heilbronn;X;19;0;0;0;0;0;0;0;1;1;1;2;3;5;8;4;3;0;1;1;17
*50*00;Diebstahl insgesamt an/aus Kraftfahrzeugen;5916000;Herne;M;43;0;0;0;0;0;0;2;9;11;7;18;4;4;8;5;8;3;1;0;25
*50*00;Diebstahl insgesamt an/aus Kraftfahrzeugen;5916000;Herne;W;4;0;0;0;0;0;0;0;0;0;0;0;2;0;2;1;0;0;1;0;4
*50*00;Diebstahl insgesamt an/aus Kraftfahrzeugen;5916000;Herne;X;47;0;0;0;0;0;0;2;9;11;7;18;6;4;10;6;8;3;2;0;29
*50*00;Diebstahl insgesamt an/aus Kraftfahrzeugen;9161000;Ingolstadt;M;19;0;0;0;0;0;0;0;1;1;1;2;1;3;4;2;8;3;0;0;17
*50*00;Diebstahl insgesamt an/aus Kraftfahrzeugen;9161000;Ingolstadt;W;0;0;0;0;0;0;0;0;0;0;0;0;0;0;0;0;0;0;0;0;0
*50*00;Diebstahl insgesamt an/aus Kraftfahrzeugen;9161000;Ingolstadt;X;19;0;0;0;0;0;0;0;1;1;1;2;1;3;4;2;8;3;0;0;17
*50*00;Diebstahl insgesamt an/aus Kraftfahrzeugen;16053000;Jena;M;14;0;0;0;0;2;2;0;0;0;1;3;1;0;1;1;7;1;1;0;11
*50*00;Diebstahl insgesamt an/aus Kraftfahrzeugen;16053000;Jena;W;2;0;0;0;0;0;0;0;0;0;0;0;0;1;1;1;0;0;0;0;2
*50*00;Diebstahl insgesamt an/aus Kraftfahrzeugen;16053000;Jena;X;16;0;0;0;0;2;2;0;0;0;1;3;1;1;2;2;7;1;1;0;13
*50*00;Diebstahl insgesamt an/aus Kraftfahrzeugen;8212000;Karlsruhe;M;107;0;0;0;0;1;1;8;11;19;10;30;6;10;16;22;22;14;2;1;77
*50*00;Diebstahl insgesamt an/aus Kraftfahrzeugen;8212000;Karlsruhe;W;3;0;0;0;0;0;0;0;0;0;0;0;0;1;1;0;1;1;0;0;3
*50*00;Diebstahl insgesamt an/aus Kraftfahrzeugen;8212000;Karlsruhe;X;110;0;0;0;0;1;1;8;11;19;10;30;6;11;17;22;23;15;2;1;80
*50*00;Diebstahl insgesamt an/aus Kraftfahrzeugen;6611000;Kassel;M;75;0;0;0;0;0;0;1;0;1;4;5;15;8;23;12;22;9;4;0;70
*50*00;Diebstahl insgesamt an/aus Kraftfahrzeugen;6611000;Kassel;W;13;0;0;0;0;0;0;0;2;2;5;7;1;1;2;1;2;0;1;0;6
*50*00;Diebstahl insgesamt an/aus Kraftfahrzeugen;6611000;Kassel;X;88;0;0;0;0;0;0;1;2;3;9;12;16;9;25;13;24;9;5;0;76
*50*00;Diebstahl insgesamt an/aus Kraftfahrzeugen;1002000;Kiel;M;71;0;0;0;0;0;0;1;5;6;5;11;8;12;20;7;18;11;4;0;60
*50*00;Diebstahl insgesamt an/aus Kraftfahrzeugen;1002000;Kiel;W;2;0;0;0;0;0;0;1;0;1;0;1;0;0;0;1;0;0;0;0;1
*50*00;Diebstahl insgesamt an/aus Kraftfahrzeugen;1002000;Kiel;X;73;0;0;0;0;0;0;2;5;7;5;12;8;12;20;8;18;11;4;0;61
*50*00;Diebstahl insgesamt an/aus Kraftfahrzeugen;7111000;Koblenz;M;28;0;0;0;0;0;0;0;7;7;4;11;1;2;3;4;7;3;0;0;17
*50*00;Diebstahl insgesamt an/aus Kraftfahrzeugen;7111000;Koblenz;W;0;0;0;0;0;0;0;0;0;0;0;0;0;0;0;0;0;0;0;0;0
*50*00;Diebstahl insgesamt an/aus Kraftfahrzeugen;7111000;Koblenz;X;28;0;0;0;0;0;0;0;7;7;4;11;1;2;3;4;7;3;0;0;17
*50*00;Diebstahl insgesamt an/aus Kraftfahrzeugen;5315000;Köln;M;448;0;0;0;3;8;11;10;50;60;59;130;44;39;83;61;106;58;9;1;318
*50*00;Diebstahl insgesamt an/aus Kraftfahrzeugen;5315000;Köln;W;18;0;0;0;0;0;0;0;0;0;4;4;1;2;3;1;7;3;0;0;14
*50*00;Diebstahl insgesamt an/aus Kraftfahrzeugen;5315000;Köln;X;466;0;0;0;3;8;11;10;50;60;63;134;45;41;86;62;113;61;9;1;332
*50*00;Diebstahl insgesamt an/aus Kraftfahrzeugen;5114000;Krefeld;M;69;0;0;0;0;0;0;1;2;3;8;11;4;5;9;12;21;12;3;1;58
*50*00;Diebstahl insgesamt an/aus Kraftfahrzeugen;5114000;Krefeld;W;3;0;0;0;0;0;0;0;0;0;0;0;0;1;1;0;0;1;1;0;3
*50*00;Diebstahl insgesamt an/aus Kraftfahrzeugen;5114000;Krefeld;X;72;0;0;0;0;0;0;1;2;3;8;11;4;6;10;12;21;13;4;1;61
*50*00;Diebstahl insgesamt an/aus Kraftfahrzeugen;14713000;Leipzig;M;278;0;0;0;0;1;1;1;9;10;23;34;19;24;43;67;108;24;2;0;244
*50*00;Diebstahl insgesamt an/aus Kraftfahrzeugen;14713000;Leipzig;W;48;0;0;0;0;0;0;0;2;2;3;5;4;4;8;16;10;7;2;0;43
*50*00;Diebstahl insgesamt an/aus Kraftfahrzeugen;14713000;Leipzig;X;326;0;0;0;0;1;1;1;11;12;26;39;23;28;51;83;118;31;4;0;287
*50*00;Diebstahl insgesamt an/aus Kraftfahrzeugen;5316000;Leverkusen;M;38;0;0;0;0;2;2;2;2;4;6;12;5;2;7;5;10;3;0;1;26
*50*00;Diebstahl insgesamt an/aus Kraftfahrzeugen;5316000;Leverkusen;W;0;0;0;0;0;0;0;0;0;0;0;0;0;0;0;0;0;0;0;0;0
*50*00;Diebstahl insgesamt an/aus Kraftfahrzeugen;5316000;Leverkusen;X;38;0;0;0;0;2;2;2;2;4;6;12;5;2;7;5;10;3;0;1;26
*50*00;Diebstahl insgesamt an/aus Kraftfahrzeugen;1003000;Lübeck;M;49;0;0;0;0;0;0;5;2;7;6;13;1;3;4;10;15;6;1;0;36
*50*00;Diebstahl insgesamt an/aus Kraftfahrzeugen;1003000;Lübeck;W;3;0;0;0;0;0;0;0;0;0;0;0;0;1;1;1;1;0;0;0;3
*50*00;Diebstahl insgesamt an/aus Kraftfahrzeugen;1003000;Lübeck;X;52;0;0;0;0;0;0;5;2;7;6;13;1;4;5;11;16;6;1;0;39
*50*00;Diebstahl insgesamt an/aus Kraftfahrzeugen;7314000;Ludwigshafen am Rhein;M;52;1;3;0;1;1;6;3;1;4;1;11;5;5;10;7;16;5;2;1;41
*50*00;Diebstahl insgesamt an/aus Kraftfahrzeugen;7314000;Ludwigshafen am Rhein;W;6;0;0;0;0;0;0;0;0;0;0;0;1;0;1;0;0;2;2;1;6
*50*00;Diebstahl insgesamt an/aus Kraftfahrzeugen;7314000;Ludwigshafen am Rhein;X;58;1;3;0;1;1;6;3;1;4;1;11;6;5;11;7;16;7;4;2;47
*50*00;Diebstahl insgesamt an/aus Kraftfahrzeugen;15003000;Magdeburg;M;114;0;0;0;0;0;0;3;2;5;12;17;13;11;24;26;26;14;7;0;97
*50*00;Diebstahl insgesamt an/aus Kraftfahrzeugen;15003000;Magdeburg;W;16;0;0;0;0;0;0;2;1;3;3;6;3;1;4;1;2;3;0;0;10
*50*00;Diebstahl insgesamt an/aus Kraftfahrzeugen;15003000;Magdeburg;X;130;0;0;0;0;0;0;5;3;8;15;23;16;12;28;27;28;17;7;0;107
*50*00;Diebstahl insgesamt an/aus Kraftfahrzeugen;7315000;Mainz;M;45;0;0;0;0;0;0;5;7;12;10;22;5;3;8;5;4;4;2;0;23
*50*00;Diebstahl insgesamt an/aus Kraftfahrzeugen;7315000;Mainz;W;4;0;0;0;0;0;0;0;0;0;1;1;1;1;2;0;1;0;0;0;3
*50*00;Diebstahl insgesamt an/aus Kraftfahrzeugen;7315000;Mainz;X;49;0;0;0;0;0;0;5;7;12;11;23;6;4;10;5;5;4;2;0;26
*50*00;Diebstahl insgesamt an/aus Kraftfahrzeugen;8222000;Mannheim;M;74;0;0;0;0;1;1;7;8;15;6;22;5;1;6;15;17;9;5;0;52
*50*00;Diebstahl insgesamt an/aus Kraftfahrzeugen;8222000;Mannheim;W;8;0;0;0;0;0;0;1;0;1;0;1;2;0;2;0;0;4;1;0;7
*50*00;Diebstahl insgesamt an/aus Kraftfahrzeugen;8222000;Mannheim;X;82;0;0;0;0;1;1;8;8;16;6;23;7;1;8;15;17;13;6;0;59
*50*00;Diebstahl insgesamt an/aus Kraftfahrzeugen;5170024;Moers;M;25;0;0;0;1;0;1;2;0;2;3;6;3;1;4;3;7;4;1;0;19
*50*00;Diebstahl insgesamt an/aus Kraftfahrzeugen;5170024;Moers;W;1;0;0;0;0;0;0;0;0;0;0;0;0;0;0;0;1;0;0;0;1
*50*00;Diebstahl insgesamt an/aus Kraftfahrzeugen;5170024;Moers;X;26;0;0;0;1;0;1;2;0;2;3;6;3;1;4;3;8;4;1;0;20
*50*00;Diebstahl insgesamt an/aus Kraftfahrzeugen;5116000;Mönchengladbach;M;71;0;0;0;0;2;2;0;6;6;8;16;9;5;14;13;17;9;2;0;55
*50*00;Diebstahl insgesamt an/aus Kraftfahrzeugen;5116000;Mönchengladbach;W;5;0;0;0;0;0;0;0;0;0;0;0;0;0;0;3;1;1;0;0;5
*50*00;Diebstahl insgesamt an/aus Kraftfahrzeugen;5116000;Mönchengladbach;X;76;0;0;0;0;2;2;0;6;6;8;16;9;5;14;16;18;10;2;0;60
*50*00;Diebstahl insgesamt an/aus Kraftfahrzeugen;5117000;Mülheim an der Ruhr;M;26;0;0;0;0;1;1;0;0;0;3;4;1;0;1;4;10;5;2;0;22
*50*00;Diebstahl insgesamt an/aus Kraftfahrzeugen;5117000;Mülheim an der Ruhr;W;1;0;0;0;0;0;0;0;0;0;0;0;1;0;1;0;0;0;0;0;1
*50*00;Diebstahl insgesamt an/aus Kraftfahrzeugen;5117000;Mülheim an der Ruhr;X;27;0;0;0;0;1;1;0;0;0;3;4;2;0;2;4;10;5;2;0;23
*50*00;Diebstahl insgesamt an/aus Kraftfahrzeugen;9162000;München;M;193;0;0;2;3;6;11;8;14;22;27;60;12;10;22;28;43;18;15;7;133
*50*00;Diebstahl insgesamt an/aus Kraftfahrzeugen;9162000;München;W;17;0;0;0;0;2;2;0;1;1;3;6;3;0;3;1;4;1;1;1;11
*50*00;Diebstahl insgesamt an/aus Kraftfahrzeugen;9162000;München;X;210;0;0;2;3;8;13;8;15;23;30;66;15;10;25;29;47;19;16;8;144
*50*00;Diebstahl insgesamt an/aus Kraftfahrzeugen;5515000;Münster;M;112;0;0;0;1;0;1;4;16;20;34;55;6;11;17;11;21;4;4;0;57
*50*00;Diebstahl insgesamt an/aus Kraftfahrzeugen;5515000;Münster;W;9;0;0;0;0;0;0;0;0;0;1;1;1;1;2;0;4;1;1;0;8
*50*00;Diebstahl insgesamt an/aus Kraftfahrzeugen;5515000;Münster;X;121;0;0;0;1;0;1;4;16;20;35;56;7;12;19;11;25;5;5;0;65
*50*00;Diebstahl insgesamt an/aus Kraftfahrzeugen;5162024;Neuss;M;81;0;0;0;1;2;3;8;7;15;14;32;3;10;13;12;18;4;2;0;49
*50*00;Diebstahl insgesamt an/aus Kraftfahrzeugen;5162024;Neuss;W;7;0;0;0;0;3;3;1;0;1;0;4;0;0;0;0;2;1;0;0;3
*50*00;Diebstahl insgesamt an/aus Kraftfahrzeugen;5162024;Neuss;X;88;0;0;0;1;5;6;9;7;16;14;36;3;10;13;12;20;5;2;0;52
*50*00;Diebstahl insgesamt an/aus Kraftfahrzeugen;9564000;Nürnberg;M;113;0;0;0;1;2;3;6;6;12;12;27;10;5;15;19;28;17;6;1;86
*50*00;Diebstahl insgesamt an/aus Kraftfahrzeugen;9564000;Nürnberg;W;11;0;0;0;0;1;1;0;0;0;2;3;0;0;0;3;3;0;2;0;8
*50*00;Diebstahl insgesamt an/aus Kraftfahrzeugen;9564000;Nürnberg;X;124;0;0;0;1;3;4;6;6;12;14;30;10;5;15;22;31;17;8;1;94
*50*00;Diebstahl insgesamt an/aus Kraftfahrzeugen;5119000;Oberhausen;M;62;0;0;0;0;0;0;2;5;7;8;15;8;4;12;14;15;4;2;0;47
*50*00;Diebstahl insgesamt an/aus Kraftfahrzeugen;5119000;Oberhausen;W;4;0;0;0;0;0;0;0;0;0;2;2;0;0;0;0;1;0;1;0;2
*50*00;Diebstahl insgesamt an/aus Kraftfahrzeugen;5119000;Oberhausen;X;66;0;0;0;0;0;0;2;5;7;10;17;8;4;12;14;16;4;3;0;49
*50*00;Diebstahl insgesamt an/aus Kraftfahrzeugen;6413000;Offenbach am Main;M;50;0;0;0;0;0;0;3;3;6;9;15;6;3;9;6;12;7;0;1;35
*50*00;Diebstahl insgesamt an/aus Kraftfahrzeugen;6413000;Offenbach am Main;W;1;0;0;0;0;0;0;1;0;1;0;1;0;0;0;0;0;0;0;0;0
*50*00;Diebstahl insgesamt an/aus Kraftfahrzeugen;6413000;Offenbach am Main;X;51;0;0;0;0;0;0;4;3;7;9;16;6;3;9;6;12;7;0;1;35
*50*00;Diebstahl insgesamt an/aus Kraftfahrzeugen;3403000;Oldenburg (Oldenburg);M;51;0;0;0;0;1;1;5;4;9;14;24;8;3;11;11;3;1;1;0;27
*50*00;Diebstahl insgesamt an/aus Kraftfahrzeugen;3403000;Oldenburg (Oldenburg);W;5;0;0;0;0;0;0;0;0;0;2;2;0;1;1;1;0;0;1;0;3
*50*00;Diebstahl insgesamt an/aus Kraftfahrzeugen;3403000;Oldenburg (Oldenburg);X;56;0;0;0;0;1;1;5;4;9;16;26;8;4;12;12;3;1;2;0;30
*50*00;Diebstahl insgesamt an/aus Kraftfahrzeugen;3404000;Osnabrück;M;93;0;0;0;0;0;0;3;4;7;9;16;9;13;22;21;22;8;4;0;77
*50*00;Diebstahl insgesamt an/aus Kraftfahrzeugen;3404000;Osnabrück;W;4;0;0;0;0;0;0;0;0;0;1;1;0;0;0;0;1;2;0;0;3
*50*00;Diebstahl insgesamt an/aus Kraftfahrzeugen;3404000;Osnabrück;X;97;0;0;0;0;0;0;3;4;7;10;17;9;13;22;21;23;10;4;0;80
*50*00;Diebstahl insgesamt an/aus Kraftfahrzeugen;5774032;Paderborn;M;36;0;0;0;0;0;0;0;0;0;4;4;5;4;9;9;10;2;2;0;32
*50*00;Diebstahl insgesamt an/aus Kraftfahrzeugen;5774032;Paderborn;W;3;0;0;0;0;0;0;0;0;0;0;0;0;0;0;1;0;1;1;0;3
*50*00;Diebstahl insgesamt an/aus Kraftfahrzeugen;5774032;Paderborn;X;39;0;0;0;0;0;0;0;0;0;4;4;5;4;9;10;10;3;3;0;35
*50*00;Diebstahl insgesamt an/aus Kraftfahrzeugen;8231000;Pforzheim;M;23;0;0;0;0;0;0;0;2;2;4;6;0;2;2;2;8;3;0;2;17
*50*00;Diebstahl insgesamt an/aus Kraftfahrzeugen;8231000;Pforzheim;W;4;0;0;0;0;0;0;0;1;1;1;2;0;0;0;0;0;1;0;1;2
*50*00;Diebstahl insgesamt an/aus Kraftfahrzeugen;8231000;Pforzheim;X;27;0;0;0;0;0;0;0;3;3;5;8;0;2;2;2;8;4;0;3;19
*50*00;Diebstahl insgesamt an/aus Kraftfahrzeugen;12054000;Potsdam;M;40;0;0;0;0;0;0;0;2;2;4;6;4;2;6;6;17;4;1;0;34
*50*00;Diebstahl insgesamt an/aus Kraftfahrzeugen;12054000;Potsdam;W;6;0;0;0;0;0;0;0;3;3;1;4;0;0;0;1;1;0;0;0;2
*50*00;Diebstahl insgesamt an/aus Kraftfahrzeugen;12054000;Potsdam;X;46;0;0;0;0;0;0;0;5;5;5;10;4;2;6;7;18;4;1;0;36
*50*00;Diebstahl insgesamt an/aus Kraftfahrzeugen;5562032;Recklinghausen;M;23;0;0;0;0;0;0;0;2;2;3;5;2;2;4;2;9;2;1;0;18
*50*00;Diebstahl insgesamt an/aus Kraftfahrzeugen;5562032;Recklinghausen;W;4;0;0;0;0;0;0;0;1;1;0;1;0;1;1;1;1;0;0;0;3
*50*00;Diebstahl insgesamt an/aus Kraftfahrzeugen;5562032;Recklinghausen;X;27;0;0;0;0;0;0;0;3;3;3;6;2;3;5;3;10;2;1;0;21
*50*00;Diebstahl insgesamt an/aus Kraftfahrzeugen;9362000;Regensburg;M;30;0;0;0;0;0;0;1;0;1;5;6;4;2;6;3;9;3;3;0;24
*50*00;Diebstahl insgesamt an/aus Kraftfahrzeugen;9362000;Regensburg;W;4;0;0;0;0;2;2;0;0;0;0;2;1;0;1;0;1;0;0;0;2
*50*00;Diebstahl insgesamt an/aus Kraftfahrzeugen;9362000;Regensburg;X;34;0;0;0;0;2;2;1;0;1;5;8;5;2;7;3;10;3;3;0;26
*50*00;Diebstahl insgesamt an/aus Kraftfahrzeugen;5120000;Remscheid;M;10;0;0;0;0;0;0;0;0;0;2;2;1;0;1;2;2;3;0;0;8
*50*00;Diebstahl insgesamt an/aus Kraftfahrzeugen;5120000;Remscheid;W;0;0;0;0;0;0;0;0;0;0;0;0;0;0;0;0;0;0;0;0;0
*50*00;Diebstahl insgesamt an/aus Kraftfahrzeugen;5120000;Remscheid;X;10;0;0;0;0;0;0;0;0;0;2;2;1;0;1;2;2;3;0;0;8
*50*00;Diebstahl insgesamt an/aus Kraftfahrzeugen;8415061;Reutlingen;M;15;0;0;0;0;0;0;0;3;3;4;7;1;1;2;1;3;0;2;0;8
*50*00;Diebstahl insgesamt an/aus Kraftfahrzeugen;8415061;Reutlingen;W;2;0;0;0;0;0;0;0;0;0;0;0;0;0;0;0;0;0;2;0;2
*50*00;Diebstahl insgesamt an/aus Kraftfahrzeugen;8415061;Reutlingen;X;17;0;0;0;0;0;0;0;3;3;4;7;1;1;2;1;3;0;4;0;10
*50*00;Diebstahl insgesamt an/aus Kraftfahrzeugen;13003000;Rostock;M;55;0;0;0;0;0;0;4;4;8;5;13;6;5;11;9;12;6;3;1;42
*50*00;Diebstahl insgesamt an/aus Kraftfahrzeugen;13003000;Rostock;W;5;0;0;0;0;2;2;0;0;0;0;2;0;0;0;0;2;0;1;0;3
*50*00;Diebstahl insgesamt an/aus Kraftfahrzeugen;13003000;Rostock;X;60;0;0;0;0;2;2;4;4;8;5;15;6;5;11;9;14;6;4;1;45
*50*00;Diebstahl insgesamt an/aus Kraftfahrzeugen;10041100;Saarbrücken;M;75;0;1;0;0;0;1;7;2;9;5;15;7;5;12;12;23;10;2;1;60
*50*00;Diebstahl insgesamt an/aus Kraftfahrzeugen;10041100;Saarbrücken;W;4;0;0;0;0;0;0;0;0;0;1;1;0;1;1;0;1;0;1;0;3
*50*00;Diebstahl insgesamt an/aus Kraftfahrzeugen;10041100;Saarbrücken;X;79;0;1;0;0;0;1;7;2;9;6;16;7;6;13;12;24;10;3;1;63
*50*00;Diebstahl insgesamt an/aus Kraftfahrzeugen;5122000;Solingen;M;16;0;0;0;0;0;0;0;3;3;0;3;2;0;2;5;3;2;1;0;13
*50*00;Diebstahl insgesamt an/aus Kraftfahrzeugen;5122000;Solingen;W;3;0;0;0;0;0;0;0;0;0;0;0;0;0;0;1;1;1;0;0;3
*50*00;Diebstahl insgesamt an/aus Kraftfahrzeugen;5122000;Solingen;X;19;0;0;0;0;0;0;0;3;3;0;3;2;0;2;6;4;3;1;0;16
*50*00;Diebstahl insgesamt an/aus Kraftfahrzeugen;8111000;Stuttgart;M;96;0;0;1;1;1;3;3;9;12;13;28;11;5;16;13;19;12;6;2;68
*50*00;Diebstahl insgesamt an/aus Kraftfahrzeugen;8111000;Stuttgart;W;17;0;0;0;0;0;0;0;0;0;1;1;1;2;3;6;5;0;2;0;16
*50*00;Diebstahl insgesamt an/aus Kraftfahrzeugen;8111000;Stuttgart;X;113;0;0;1;1;1;3;3;9;12;14;29;12;7;19;19;24;12;8;2;84
*50*00;Diebstahl insgesamt an/aus Kraftfahrzeugen;7211000;Trier;M;31;0;0;0;0;0;0;4;5;9;2;11;1;4;5;6;6;1;2;0;20
*50*00;Diebstahl insgesamt an/aus Kraftfahrzeugen;7211000;Trier;W;4;0;0;0;0;0;0;2;0;2;0;2;0;0;0;0;1;0;1;0;2
*50*00;Diebstahl insgesamt an/aus Kraftfahrzeugen;7211000;Trier;X;35;0;0;0;0;0;0;6;5;11;2;13;1;4;5;6;7;1;3;0;22
*50*00;Diebstahl insgesamt an/aus Kraftfahrzeugen;8421000;Ulm;M;22;0;0;0;0;4;4;1;1;2;2;8;3;0;3;4;5;1;1;0;14
*50*00;Diebstahl insgesamt an/aus Kraftfahrzeugen;8421000;Ulm;W;1;0;0;0;0;0;0;0;0;0;0;0;0;1;1;0;0;0;0;0;1
*50*00;Diebstahl insgesamt an/aus Kraftfahrzeugen;8421000;Ulm;X;23;0;0;0;0;4;4;1;1;2;2;8;3;1;4;4;5;1;1;0;15
*50*00;Diebstahl insgesamt an/aus Kraftfahrzeugen;6414000;Wiesbaden;M;97;0;0;0;0;2;2;5;10;15;17;34;15;8;23;12;18;5;4;1;63
*50*00;Diebstahl insgesamt an/aus Kraftfahrzeugen;6414000;Wiesbaden;W;7;0;0;0;0;0;0;1;0;1;0;1;3;1;4;0;2;0;0;0;6
*50*00;Diebstahl insgesamt an/aus Kraftfahrzeugen;6414000;Wiesbaden;X;104;0;0;0;0;2;2;6;10;16;17;35;18;9;27;12;20;5;4;1;69
*50*00;Diebstahl insgesamt an/aus Kraftfahrzeugen;3103000;Wolfsburg;M;39;0;0;0;0;0;0;0;0;0;6;6;2;5;7;13;6;2;4;1;33
*50*00;Diebstahl insgesamt an/aus Kraftfahrzeugen;3103000;Wolfsburg;W;3;0;0;0;0;0;0;0;0;0;0;0;1;0;1;1;0;0;1;0;3
*50*00;Diebstahl insgesamt an/aus Kraftfahrzeugen;3103000;Wolfsburg;X;42;0;0;0;0;0;0;0;0;0;6;6;3;5;8;14;6;2;5;1;36
*50*00;Diebstahl insgesamt an/aus Kraftfahrzeugen;5124000;Wuppertal;M;76;0;0;0;2;1;3;9;7;16;7;26;7;3;10;13;18;7;1;1;50
*50*00;Diebstahl insgesamt an/aus Kraftfahrzeugen;5124000;Wuppertal;W;4;0;0;0;0;1;1;0;0;0;0;1;0;1;1;1;0;1;0;0;3
*50*00;Diebstahl insgesamt an/aus Kraftfahrzeugen;5124000;Wuppertal;X;80;0;0;0;2;2;4;9;7;16;7;27;7;4;11;14;18;8;1;1;53
*50*00;Diebstahl insgesamt an/aus Kraftfahrzeugen;9663000;Würzburg;M;29;0;0;0;0;0;0;0;0;0;2;2;6;6;12;4;7;4;0;0;27
*50*00;Diebstahl insgesamt an/aus Kraftfahrzeugen;9663000;Würzburg;W;2;0;0;0;0;0;0;0;0;0;0;0;0;0;0;2;0;0;0;0;2
*50*00;Diebstahl insgesamt an/aus Kraftfahrzeugen;9663000;Würzburg;X;31;0;0;0;0;0;0;0;0;0;2;2;6;6;12;6;7;4;0;0;29
*90*00;Taschendiebstahl insgesamt;5334002;Aachen;M;16;0;0;0;0;0;0;1;4;5;2;7;0;1;1;3;1;2;1;1;9
*90*00;Taschendiebstahl insgesamt;5334002;Aachen;W;8;0;0;0;0;0;0;0;1;1;0;1;1;1;2;1;3;1;0;0;7
*90*00;Taschendiebstahl insgesamt;5334002;Aachen;X;24;0;0;0;0;0;0;1;5;6;2;8;1;2;3;4;4;3;1;1;16
*90*00;Taschendiebstahl insgesamt;9761000;Augsburg;M;10;0;0;0;0;0;0;0;5;5;0;5;1;0;1;1;2;0;1;0;5
*90*00;Taschendiebstahl insgesamt;9761000;Augsburg;W;2;0;0;0;0;0;0;1;0;1;0;1;0;1;1;0;0;0;0;0;1
*90*00;Taschendiebstahl insgesamt;9761000;Augsburg;X;12;0;0;0;0;0;0;1;5;6;0;6;1;1;2;1;2;0;1;0;6
*90*00;Taschendiebstahl insgesamt;5378004;Bergisch Gladbach;M;2;0;0;0;0;0;0;0;0;0;2;2;0;0;0;0;0;0;0;0;0
*90*00;Taschendiebstahl insgesamt;5378004;Bergisch Gladbach;W;3;0;0;0;0;0;0;1;2;3;0;3;0;0;0;0;0;0;0;0;0
*90*00;Taschendiebstahl insgesamt;5378004;Bergisch Gladbach;X;5;0;0;0;0;0;0;1;2;3;2;5;0;0;0;0;0;0;0;0;0
*90*00;Taschendiebstahl insgesamt;11000000;Berlin;M;806;0;0;0;3;16;19;44;74;118;134;271;67;63;130;139;163;73;27;3;535
*90*00;Taschendiebstahl insgesamt;11000000;Berlin;W;237;0;0;0;3;14;17;26;22;48;29;94;16;17;33;33;48;16;12;1;143
*90*00;Taschendiebstahl insgesamt;11000000;Berlin;X;1043;0;0;0;6;30;36;70;96;166;163;365;83;80;163;172;211;89;39;4;678
*90*00;Taschendiebstahl insgesamt;5711000;Bielefeld;M;37;0;0;0;0;0;0;1;3;4;9;13;6;3;9;6;7;2;0;0;24
*90*00;Taschendiebstahl insgesamt;5711000;Bielefeld;W;10;0;0;0;0;0;0;0;0;0;4;4;2;0;2;0;1;2;1;0;6
*90*00;Taschendiebstahl insgesamt;5711000;Bielefeld;X;47;0;0;0;0;0;0;1;3;4;13;17;8;3;11;6;8;4;1;0;30
*90*00;Taschendiebstahl insgesamt;5911000;Bochum;M;36;0;0;0;1;1;2;2;4;6;8;16;8;0;8;7;3;2;0;0;20
*90*00;Taschendiebstahl insgesamt;5911000;Bochum;W;15;0;0;0;0;0;0;2;1;3;2;5;0;2;2;3;4;1;0;0;10
*90*00;Taschendiebstahl insgesamt;5911000;Bochum;X;51;0;0;0;1;1;2;4;5;9;10;21;8;2;10;10;7;3;0;0;30
*90*00;Taschendiebstahl insgesamt;5314000;Bonn;M;49;0;0;0;0;2;2;1;3;4;8;14;3;2;5;8;18;4;0;0;35
*90*00;Taschendiebstahl insgesamt;5314000;Bonn;W;47;0;0;0;0;6;6;3;7;10;8;24;5;4;9;7;4;3;0;0;23
*90*00;Taschendiebstahl insgesamt;5314000;Bonn;X;96;0;0;0;0;8;8;4;10;14;16;38;8;6;14;15;22;7;0;0;58
*90*00;Taschendiebstahl insgesamt;5512000;Bottrop;M;5;0;0;0;0;0;0;0;0;0;2;2;0;1;1;0;1;1;0;0;3
*90*00;Taschendiebstahl insgesamt;5512000;Bottrop;W;4;0;0;0;0;0;0;1;0;1;1;2;0;0;0;0;1;0;1;0;2
*90*00;Taschendiebstahl insgesamt;5512000;Bottrop;X;9;0;0;0;0;0;0;1;0;1;3;4;0;1;1;0;2;1;1;0;5
*90*00;Taschendiebstahl insgesamt;3101000;Braunschweig;M;117;0;0;0;0;0;0;5;3;8;33;41;14;17;31;14;22;8;1;0;76
*90*00;Taschendiebstahl insgesamt;3101000;Braunschweig;W;15;0;0;0;0;1;1;1;0;1;4;6;2;0;2;2;3;2;0;0;9
*90*00;Taschendiebstahl insgesamt;3101000;Braunschweig;X;132;0;0;0;0;1;1;6;3;9;37;47;16;17;33;16;25;10;1;0;85
*90*00;Taschendiebstahl insgesamt;4011000;Bremen;M;191;0;1;0;0;1;2;21;46;67;25;94;11;12;23;24;36;10;4;0;97
*90*00;Taschendiebstahl insgesamt;4011000;Bremen;W;29;0;0;0;0;0;0;0;0;0;4;4;1;3;4;5;6;8;2;0;25
*90*00;Taschendiebstahl insgesamt;4011000;Bremen;X;220;0;1;0;0;1;2;21;46;67;29;98;12;15;27;29;42;18;6;0;122
*90*00;Taschendiebstahl insgesamt;4012000;Bremerhaven;M;14;0;0;0;0;0;0;0;0;0;1;1;3;1;4;3;3;3;0;0;13
*90*00;Taschendiebstahl insgesamt;4012000;Bremerhaven;W;1;0;0;0;0;0;0;0;0;0;0;0;0;0;0;1;0;0;0;0;1
*90*00;Taschendiebstahl insgesamt;4012000;Bremerhaven;X;15;0;0;0;0;0;0;0;0;0;1;1;3;1;4;4;3;3;0;0;14
*90*00;Taschendiebstahl insgesamt;14511000;Chemnitz;M;28;0;0;0;0;1;1;0;1;1;4;6;2;2;4;10;7;1;0;0;22
*90*00;Taschendiebstahl insgesamt;14511000;Chemnitz;W;1;0;0;0;1;0;1;0;0;0;0;1;0;0;0;0;0;0;0;0;0
*90*00;Taschendiebstahl insgesamt;14511000;Chemnitz;X;29;0;0;0;1;1;2;0;1;1;4;7;2;2;4;10;7;1;0;0;22
*90*00;Taschendiebstahl insgesamt;6411000;Darmstadt;M;6;0;0;0;0;0;0;0;1;1;0;1;2;0;2;0;2;1;0;0;5
*90*00;Taschendiebstahl insgesamt;6411000;Darmstadt;W;4;0;0;0;0;0;0;0;1;1;1;2;0;1;1;0;1;0;0;0;2
*90*00;Taschendiebstahl insgesamt;6411000;Darmstadt;X;10;0;0;0;0;0;0;0;2;2;1;3;2;1;3;0;3;1;0;0;7
*90*00;Taschendiebstahl insgesamt;5913000;Dortmund;M;270;0;0;0;3;4;7;18;38;56;78;141;22;20;42;38;30;15;3;1;129
*90*00;Taschendiebstahl insgesamt;5913000;Dortmund;W;102;0;0;0;1;5;6;3;6;9;19;34;8;10;18;19;19;9;3;0;68
*90*00;Taschendiebstahl insgesamt;5913000;Dortmund;X;372;0;0;0;4;9;13;21;44;65;97;175;30;30;60;57;49;24;6;1;197
*90*00;Taschendiebstahl insgesamt;14612000;Dresden;M;78;0;0;0;0;1;1;0;2;2;5;8;6;6;12;19;26;8;4;1;70
*90*00;Taschendiebstahl insgesamt;14612000;Dresden;W;6;0;0;0;1;0;1;0;0;0;0;1;0;0;0;0;3;1;1;0;5
*90*00;Taschendiebstahl insgesamt;14612000;Dresden;X;84;0;0;0;1;1;2;0;2;2;5;9;6;6;12;19;29;9;5;1;75
*90*00;Taschendiebstahl insgesamt;5112000;Duisburg;M;16;0;0;0;1;1;2;2;1;3;1;6;0;0;0;2;4;3;0;1;10
*90*00;Taschendiebstahl insgesamt;5112000;Duisburg;W;31;1;0;0;1;0;2;5;5;10;4;16;5;1;6;2;3;4;0;0;15
*90*00;Taschendiebstahl insgesamt;5112000;Duisburg;X;47;1;0;0;2;1;4;7;6;13;5;22;5;1;6;4;7;7;0;1;25
*90*00;Taschendiebstahl insgesamt;5111000;Düsseldorf;M;354;0;0;0;1;2;3;6;37;43;74;120;32;34;66;72;64;24;6;2;234
*90*00;Taschendiebstahl insgesamt;5111000;Düsseldorf;W;119;0;0;0;0;3;3;8;15;23;25;51;9;8;17;14;25;9;3;0;68
*90*00;Taschendiebstahl insgesamt;5111000;Düsseldorf;X;473;0;0;0;1;5;6;14;52;66;99;171;41;42;83;86;89;33;9;2;302
*90*00;Taschendiebstahl insgesamt;16051000;Erfurt;M;6;0;0;0;0;0;0;0;0;0;0;0;0;0;0;1;3;1;0;1;6
*90*00;Taschendiebstahl insgesamt;16051000;Erfurt;W;0;0;0;0;0;0;0;0;0;0;0;0;0;0;0;0;0;0;0;0;0
*90*00;Taschendiebstahl insgesamt;16051000;Erfurt;X;6;0;0;0;0;0;0;0;0;0;0;0;0;0;0;1;3;1;0;1;6
*90*00;Taschendiebstahl insgesamt;9562000;Erlangen;M;8;0;0;0;0;0;0;0;1;1;1;2;0;0;0;2;2;2;0;0;6
*90*00;Taschendiebstahl insgesamt;9562000;Erlangen;W;4;0;0;0;0;0;0;1;1;2;0;2;0;0;0;0;0;1;1;0;2
*90*00;Taschendiebstahl insgesamt;9562000;Erlangen;X;12;0;0;0;0;0;0;1;2;3;1;4;0;0;0;2;2;3;1;0;8
*90*00;Taschendiebstahl insgesamt;5113000;Essen;M;45;0;0;0;0;1;1;0;6;6;4;11;3;4;7;10;10;4;3;0;34
*90*00;Taschendiebstahl insgesamt;5113000;Essen;W;41;0;0;0;0;3;3;3;2;5;8;16;3;2;5;7;6;6;1;0;25
*90*00;Taschendiebstahl insgesamt;5113000;Essen;X;86;0;0;0;0;4;4;3;8;11;12;27;6;6;12;17;16;10;4;0;59
*90*00;Taschendiebstahl insgesamt;6412000;Frankfurt am Main;M;172;0;0;0;0;1;1;8;21;29;28;58;7;12;19;29;40;20;5;1;114
*90*00;Taschendiebstahl insgesamt;6412000;Frankfurt am Main;W;34;0;0;0;0;1;1;0;1;1;8;10;1;5;6;4;9;5;0;0;24
*90*00;Taschendiebstahl insgesamt;6412000;Frankfurt am Main;X;206;0;0;0;0;2;2;8;22;30;36;68;8;17;25;33;49;25;5;1;138
*90*00;Taschendiebstahl insgesamt;8311000;Freiburg im Breisgau;M;44;0;0;0;0;1;1;4;9;13;7;21;4;3;7;6;6;4;0;0;23
*90*00;Taschendiebstahl insgesamt;8311000;Freiburg im Breisgau;W;9;0;0;0;0;0;0;1;1;2;2;4;2;1;3;1;1;0;0;0;5
*90*00;Taschendiebstahl insgesamt;8311000;Freiburg im Breisgau;X;53;0;0;0;0;1;1;5;10;15;9;25;6;4;10;7;7;4;0;0;28
*90*00;Taschendiebstahl insgesamt;9563000;Fürth;M;7;0;0;0;0;0;0;0;1;1;2;3;0;0;0;2;2;0;0;0;4
*90*00;Taschendiebstahl insgesamt;9563000;Fürth;W;2;0;0;0;0;0;0;0;0;0;1;1;0;0;0;0;0;1;0;0;1
*90*00;Taschendiebstahl insgesamt;9563000;Fürth;X;9;0;0;0;0;0;0;0;1;1;3;4;0;0;0;2;2;1;0;0;5
*90*00;Taschendiebstahl insgesamt;5513000;Gelsenkirchen;M;19;0;0;0;0;0;0;0;0;0;2;2;2;2;4;5;5;3;0;0;17
*90*00;Taschendiebstahl insgesamt;5513000;Gelsenkirchen;W;23;0;0;0;0;0;0;0;2;2;7;9;2;0;2;2;5;3;2;0;14
*90*00;Taschendiebstahl insgesamt;5513000;Gelsenkirchen;X;42;0;0;0;0;0;0;0;2;2;9;11;4;2;6;7;10;6;2;0;31
*90*00;Taschendiebstahl insgesamt;3152012;Göttingen;M;34;0;0;0;0;0;0;0;1;1;4;5;3;2;5;9;11;3;0;1;29
*90*00;Taschendiebstahl insgesamt;3152012;Göttingen;W;6;0;0;0;0;0;0;0;0;0;0;0;0;0;0;3;2;1;0;0;6
*90*00;Taschendiebstahl insgesamt;3152012;Göttingen;X;40;0;0;0;0;0;0;0;1;1;4;5;3;2;5;12;13;4;0;1;35
*90*00;Taschendiebstahl insgesamt;5914000;Hagen;M;20;0;0;0;0;0;0;0;3;3;2;5;1;0;1;4;4;3;3;0;15
*90*00;Taschendiebstahl insgesamt;5914000;Hagen;W;13;0;0;0;0;0;0;2;1;3;3;6;5;0;5;0;1;1;0;0;7
*90*00;Taschendiebstahl insgesamt;5914000;Hagen;X;33;0;0;0;0;0;0;2;4;6;5;11;6;0;6;4;5;4;3;0;22
*90*00;Taschendiebstahl insgesamt;15002000;Halle (Saale);M;4;0;0;0;0;0;0;0;0;0;0;0;0;1;1;0;1;1;1;0;4
*90*00;Taschendiebstahl insgesamt;15002000;Halle (Saale);W;4;0;0;0;0;0;0;0;0;0;1;1;0;0;0;2;0;1;0;0;3
*90*00;Taschendiebstahl insgesamt;15002000;Halle (Saale);X;8;0;0;0;0;0;0;0;0;0;1;1;0;1;1;2;1;2;1;0;7
*90*00;Taschendiebstahl insgesamt;2000000;Hamburg;M;637;0;0;1;1;7;9;47;126;173;106;288;28;44;72;89;119;53;12;4;349
*90*00;Taschendiebstahl insgesamt;2000000;Hamburg;W;133;0;0;1;0;1;2;4;6;10;12;24;11;15;26;22;35;20;4;2;109
*90*00;Taschendiebstahl insgesamt;2000000;Hamburg;X;770;0;0;2;1;8;11;51;132;183;118;312;39;59;98;111;154;73;16;6;458
*90*00;Taschendiebstahl insgesamt;5915000;Hamm;M;15;0;0;0;0;0;0;0;2;2;1;3;1;1;2;5;3;2;0;0;12
*90*00;Taschendiebstahl insgesamt;5915000;Hamm;W;9;0;0;0;0;0;0;0;2;2;1;3;1;0;1;2;2;1;0;0;6
*90*00;Taschendiebstahl insgesamt;5915000;Hamm;X;24;0;0;0;0;0;0;0;4;4;2;6;2;1;3;7;5;3;0;0;18
*90*00;Taschendiebstahl insgesamt;3241001;Hannover;M;147;0;0;0;0;1;1;2;9;11;41;53;18;19;37;19;24;11;3;0;94
*90*00;Taschendiebstahl insgesamt;3241001;Hannover;W;29;0;0;0;0;0;0;1;0;1;4;5;3;2;5;9;7;2;1;0;24
*90*00;Taschendiebstahl insgesamt;3241001;Hannover;X;176;0;0;0;0;1;1;3;9;12;45;58;21;21;42;28;31;13;4;0;118
*90*00;Taschendiebstahl insgesamt;8221000;Heidelberg;M;13;0;0;0;0;1;1;0;3;3;2;6;1;0;1;0;5;1;0;0;7
*90*00;Taschendiebstahl insgesamt;8221000;Heidelberg;W;21;0;0;0;0;1;1;3;1;4;7;12;1;1;2;1;5;1;0;0;9
*90*00;Taschendiebstahl insgesamt;8221000;Heidelberg;X;34;0;0;0;0;2;2;3;4;7;9;18;2;1;3;1;10;2;0;0;16
*90*00;Taschendiebstahl insgesamt;8121000;Heilbronn;M;7;0;0;0;0;0;0;0;0;0;1;1;1;0;1;0;3;2;0;0;6
*90*00;Taschendiebstahl insgesamt;8121000;Heilbronn;W;4;0;0;0;0;0;0;0;1;1;1;2;0;0;0;1;0;0;1;0;2
*90*00;Taschendiebstahl insgesamt;8121000;Heilbronn;X;11;0;0;0;0;0;0;0;1;1;2;3;1;0;1;1;3;2;1;0;8
*90*00;Taschendiebstahl insgesamt;5916000;Herne;M;6;0;0;0;0;0;0;0;3;3;2;5;0;0;0;0;0;0;1;0;1
*90*00;Taschendiebstahl insgesamt;5916000;Herne;W;7;0;0;0;0;0;0;0;0;0;1;1;1;1;2;1;2;1;0;0;6
*90*00;Taschendiebstahl insgesamt;5916000;Herne;X;13;0;0;0;0;0;0;0;3;3;3;6;1;1;2;1;2;1;1;0;7
*90*00;Taschendiebstahl insgesamt;9161000;Ingolstadt;M;3;0;0;0;0;0;0;0;0;0;1;1;0;1;1;0;1;0;0;0;2
*90*00;Taschendiebstahl insgesamt;9161000;Ingolstadt;W;3;0;0;0;0;0;0;0;0;0;1;1;0;0;0;0;1;1;0;0;2
*90*00;Taschendiebstahl insgesamt;9161000;Ingolstadt;X;6;0;0;0;0;0;0;0;0;0;2;2;0;1;1;0;2;1;0;0;4
*90*00;Taschendiebstahl insgesamt;16053000;Jena;M;0;0;0;0;0;0;0;0;0;0;0;0;0;0;0;0;0;0;0;0;0
*90*00;Taschendiebstahl insgesamt;16053000;Jena;W;0;0;0;0;0;0;0;0;0;0;0;0;0;0;0;0;0;0;0;0;0
*90*00;Taschendiebstahl insgesamt;16053000;Jena;X;0;0;0;0;0;0;0;0;0;0;0;0;0;0;0;0;0;0;0;0;0
*90*00;Taschendiebstahl insgesamt;8212000;Karlsruhe;M;76;0;0;0;0;0;0;3;10;13;10;23;7;10;17;17;12;6;1;0;53
*90*00;Taschendiebstahl insgesamt;8212000;Karlsruhe;W;8;0;0;0;0;1;1;0;2;2;1;4;0;1;1;1;2;0;0;0;4
*90*00;Taschendiebstahl insgesamt;8212000;Karlsruhe;X;84;0;0;0;0;1;1;3;12;15;11;27;7;11;18;18;14;6;1;0;57
*90*00;Taschendiebstahl insgesamt;6611000;Kassel;M;25;0;0;0;0;0;0;0;4;4;2;6;0;1;1;5;8;3;1;1;19
*90*00;Taschendiebstahl insgesamt;6611000;Kassel;W;6;0;0;0;0;0;0;0;1;1;1;2;1;0;1;1;1;1;0;0;4
*90*00;Taschendiebstahl insgesamt;6611000;Kassel;X;31;0;0;0;0;0;0;0;5;5;3;8;1;1;2;6;9;4;1;1;23
*90*00;Taschendiebstahl insgesamt;1002000;Kiel;M;11;0;0;0;0;0;0;1;2;3;1;4;1;1;2;1;2;2;0;0;7
*90*00;Taschendiebstahl insgesamt;1002000;Kiel;W;0;0;0;0;0;0;0;0;0;0;0;0;0;0;0;0;0;0;0;0;0
*90*00;Taschendiebstahl insgesamt;1002000;Kiel;X;11;0;0;0;0;0;0;1;2;3;1;4;1;1;2;1;2;2;0;0;7
*90*00;Taschendiebstahl insgesamt;7111000;Koblenz;M;6;0;0;0;1;0;1;1;0;1;0;2;2;0;2;1;0;1;0;0;4
*90*00;Taschendiebstahl insgesamt;7111000;Koblenz;W;5;0;0;0;0;1;1;0;0;0;0;1;1;0;1;1;1;0;1;0;4
*90*00;Taschendiebstahl insgesamt;7111000;Koblenz;X;11;0;0;0;1;1;2;1;0;1;0;3;3;0;3;2;1;1;1;0;8
*90*00;Taschendiebstahl insgesamt;5315000;Köln;M;595;0;1;0;4;10;15;23;74;97;132;244;43;50;93;97;116;33;11;1;351
*90*00;Taschendiebstahl insgesamt;5315000;Köln;W;235;0;0;0;3;14;17;21;22;43;43;103;15;28;43;27;37;17;7;1;132
*90*00;Taschendiebstahl insgesamt;5315000;Köln;X;830;0;1;0;7;24;32;44;96;140;175;347;58;78;136;124;153;50;18;2;483
*90*00;Taschendiebstahl insgesamt;5114000;Krefeld;M;21;0;0;0;0;0;0;0;2;2;9;11;1;2;3;4;2;1;0;0;10
*90*00;Taschendiebstahl insgesamt;5114000;Krefeld;W;15;0;0;0;0;0;0;2;1;3;1;4;2;2;4;3;2;2;0;0;11
*90*00;Taschendiebstahl insgesamt;5114000;Krefeld;X;36;0;0;0;0;0;0;2;3;5;10;15;3;4;7;7;4;3;0;0;21
*90*00;Taschendiebstahl insgesamt;14713000;Leipzig;M;70;0;0;0;0;0;0;2;3;5;6;11;7;8;15;22;17;5;0;0;59
*90*00;Taschendiebstahl insgesamt;14713000;Leipzig;W;9;0;0;0;0;2;2;0;0;0;0;2;0;1;1;2;2;1;0;1;7
*90*00;Taschendiebstahl insgesamt;14713000;Leipzig;X;79;0;0;0;0;2;2;2;3;5;6;13;7;9;16;24;19;6;0;1;66
*90*00;Taschendiebstahl insgesamt;5316000;Leverkusen;M;13;0;1;0;1;1;3;0;0;0;2;5;2;1;3;2;3;0;0;0;8
*90*00;Taschendiebstahl insgesamt;5316000;Leverkusen;W;14;0;0;0;0;0;0;3;1;4;2;6;1;2;3;2;1;2;0;0;8
*90*00;Taschendiebstahl insgesamt;5316000;Leverkusen;X;27;0;1;0;1;1;3;3;1;4;4;11;3;3;6;4;4;2;0;0;16
*90*00;Taschendiebstahl insgesamt;1003000;Lübeck;M;14;0;0;0;0;2;2;2;1;3;2;7;1;0;1;3;3;0;0;0;7
*90*00;Taschendiebstahl insgesamt;1003000;Lübeck;W;8;0;0;0;0;0;0;1;1;2;2;4;2;0;2;1;0;1;0;0;4
*90*00;Taschendiebstahl insgesamt;1003000;Lübeck;X;22;0;0;0;0;2;2;3;2;5;4;11;3;0;3;4;3;1;0;0;11
*90*00;Taschendiebstahl insgesamt;7314000;Ludwigshafen am Rhein;M;7;0;0;0;0;0;0;1;2;3;1;4;0;0;0;0;1;1;1;0;3
*90*00;Taschendiebstahl insgesamt;7314000;Ludwigshafen am Rhein;W;10;0;0;1;0;0;1;0;1;1;1;3;3;1;4;1;2;0;0;0;7
*90*00;Taschendiebstahl insgesamt;7314000;Ludwigshafen am Rhein;X;17;0;0;1;0;0;1;1;3;4;2;7;3;1;4;1;3;1;1;0;10
*90*00;Taschendiebstahl insgesamt;15003000;Magdeburg;M;3;0;0;0;0;0;0;0;1;1;0;1;0;0;0;0;1;0;1;0;2
*90*00;Taschendiebstahl insgesamt;15003000;Magdeburg;W;2;0;0;0;0;0;0;0;0;0;0;0;0;0;0;1;1;0;0;0;2
*90*00;Taschendiebstahl insgesamt;15003000;Magdeburg;X;5;0;0;0;0;0;0;0;1;1;0;1;0;0;0;1;2;0;1;0;4
*90*00;Taschendiebstahl insgesamt;7315000;Mainz;M;32;0;0;0;0;1;1;4;4;8;4;13;4;2;6;5;4;2;2;0;19
*90*00;Taschendiebstahl insgesamt;7315000;Mainz;W;9;0;0;0;0;0;0;2;1;3;2;5;1;1;2;0;1;1;0;0;4
*90*00;Taschendiebstahl insgesamt;7315000;Mainz;X;41;0;0;0;0;1;1;6;5;11;6;18;5;3;8;5;5;3;2;0;23
*90*00;Taschendiebstahl insgesamt;8222000;Mannheim;M;21;0;0;1;0;0;1;0;2;2;0;3;3;3;6;1;7;4;0;0;18
*90*00;Taschendiebstahl insgesamt;8222000;Mannheim;W;17;0;0;0;0;1;1;0;1;1;6;8;2;2;4;1;3;1;0;0;9
*90*00;Taschendiebstahl insgesamt;8222000;Mannheim;X;38;0;0;1;0;1;2;0;3;3;6;11;5;5;10;2;10;5;0;0;27
*90*00;Taschendiebstahl insgesamt;5170024;Moers;M;6;0;0;0;0;0;0;0;0;0;0;0;1;0;1;1;3;1;0;0;6
*90*00;Taschendiebstahl insgesamt;5170024;Moers;W;5;0;0;0;0;1;1;0;0;0;0;1;0;1;1;2;1;0;0;0;4
*90*00;Taschendiebstahl insgesamt;5170024;Moers;X;11;0;0;0;0;1;1;0;0;0;0;1;1;1;2;3;4;1;0;0;10
*90*00;Taschendiebstahl insgesamt;5116000;Mönchengladbach;M;37;0;0;0;0;0;0;1;2;3;8;11;5;5;10;7;7;1;1;0;26
*90*00;Taschendiebstahl insgesamt;5116000;Mönchengladbach;W;11;0;0;0;0;1;1;2;0;2;0;3;1;0;1;1;2;4;0;0;8
*90*00;Taschendiebstahl insgesamt;5116000;Mönchengladbach;X;48;0;0;0;0;1;1;3;2;5;8;14;6;5;11;8;9;5;1;0;34
*90*00;Taschendiebstahl insgesamt;5117000;Mülheim an der Ruhr;M;4;0;0;0;0;0;0;0;0;0;0;0;0;0;0;1;2;1;0;0;4
*90*00;Taschendiebstahl insgesamt;5117000;Mülheim an der Ruhr;W;6;0;0;0;1;0;1;0;0;0;0;1;0;3;3;0;1;1;0;0;5
*90*00;Taschendiebstahl insgesamt;5117000;Mülheim an der Ruhr;X;10;0;0;0;1;0;1;0;0;0;0;1;0;3;3;1;3;2;0;0;9
*90*00;Taschendiebstahl insgesamt;9162000;München;M;251;0;0;1;0;1;2;8;24;32;32;66;25;12;37;50;67;23;7;1;185
*90*00;Taschendiebstahl insgesamt;9162000;München;W;47;0;0;0;0;3;3;1;5;6;12;21;1;1;2;6;12;3;2;1;26
*90*00;Taschendiebstahl insgesamt;9162000;München;X;298;0;0;1;0;4;5;9;29;38;44;87;26;13;39;56;79;26;9;2;211
*90*00;Taschendiebstahl insgesamt;5515000;Münster;M;166;0;0;0;0;5;5;17;22;39;44;88;19;13;32;15;25;5;1;0;78
*90*00;Taschendiebstahl insgesamt;5515000;Münster;W;38;0;0;0;0;1;1;1;2;3;6;10;5;2;7;5;14;1;0;1;28
*90*00;Taschendiebstahl insgesamt;5515000;Münster;X;204;0;0;0;0;6;6;18;24;42;50;98;24;15;39;20;39;6;1;1;106
*90*00;Taschendiebstahl insgesamt;5162024;Neuss;M;15;0;0;0;0;1;1;0;1;1;6;8;0;3;3;2;1;0;1;0;7
*90*00;Taschendiebstahl insgesamt;5162024;Neuss;W;14;0;0;0;0;1;1;0;1;1;2;4;1;0;1;4;3;1;1;0;10
*90*00;Taschendiebstahl insgesamt;5162024;Neuss;X;29;0;0;0;0;2;2;0;2;2;8;12;1;3;4;6;4;1;2;0;17
*90*00;Taschendiebstahl insgesamt;9564000;Nürnberg;M;55;0;0;0;0;0;0;1;0;1;5;6;3;7;10;8;15;15;0;1;49
*90*00;Taschendiebstahl insgesamt;9564000;Nürnberg;W;13;0;0;0;0;0;0;0;1;1;4;5;0;0;0;1;4;2;1;0;8
*90*00;Taschendiebstahl insgesamt;9564000;Nürnberg;X;68;0;0;0;0;0;0;1;1;2;9;11;3;7;10;9;19;17;1;1;57
*90*00;Taschendiebstahl insgesamt;5119000;Oberhausen;M;34;0;0;0;0;0;0;3;5;8;4;12;2;5;7;3;7;5;0;0;22
*90*00;Taschendiebstahl insgesamt;5119000;Oberhausen;W;28;0;0;0;0;0;0;2;2;4;2;6;3;2;5;6;8;2;1;0;22
*90*00;Taschendiebstahl insgesamt;5119000;Oberhausen;X;62;0;0;0;0;0;0;5;7;12;6;18;5;7;12;9;15;7;1;0;44
*90*00;Taschendiebstahl insgesamt;6413000;Offenbach am Main;M;5;0;0;0;0;0;0;0;0;0;1;1;2;0;2;0;1;1;0;0;4
*90*00;Taschendiebstahl insgesamt;6413000;Offenbach am Main;W;3;0;0;0;0;0;0;0;0;0;0;0;1;0;1;1;1;0;0;0;3
*90*00;Taschendiebstahl insgesamt;6413000;Offenbach am Main;X;8;0;0;0;0;0;0;0;0;0;1;1;3;0;3;1;2;1;0;0;7
*90*00;Taschendiebstahl insgesamt;3403000;Oldenburg (Oldenburg);M;30;0;0;0;0;0;0;0;6;6;3;9;3;5;8;7;4;2;0;0;21
*90*00;Taschendiebstahl insgesamt;3403000;Oldenburg (Oldenburg);W;6;0;0;0;0;0;0;0;1;1;2;3;0;0;0;0;2;1;0;0;3
*90*00;Taschendiebstahl insgesamt;3403000;Oldenburg (Oldenburg);X;36;0;0;0;0;0;0;0;7;7;5;12;3;5;8;7;6;3;0;0;24
*90*00;Taschendiebstahl insgesamt;3404000;Osnabrück;M;60;0;0;0;0;0;0;2;1;3;17;20;5;7;12;16;9;1;2;0;40
*90*00;Taschendiebstahl insgesamt;3404000;Osnabrück;W;14;0;0;1;0;0;1;0;0;0;4;5;2;1;3;2;2;1;1;0;9
*90*00;Taschendiebstahl insgesamt;3404000;Osnabrück;X;74;0;0;1;0;0;1;2;1;3;21;25;7;8;15;18;11;2;3;0;49
*90*00;Taschendiebstahl insgesamt;5774032;Paderborn;M;28;0;0;0;0;0;0;0;1;1;6;7;6;2;8;6;5;1;1;0;21
*90*00;Taschendiebstahl insgesamt;5774032;Paderborn;W;6;0;0;0;0;0;0;1;1;2;1;3;0;1;1;2;0;0;0;0;3
*90*00;Taschendiebstahl insgesamt;5774032;Paderborn;X;34;0;0;0;0;0;0;1;2;3;7;10;6;3;9;8;5;1;1;0;24
*90*00;Taschendiebstahl insgesamt;8231000;Pforzheim;M;7;0;0;0;0;0;0;1;0;1;0;1;0;0;0;1;1;4;0;0;6
*90*00;Taschendiebstahl insgesamt;8231000;Pforzheim;W;1;0;0;0;0;0;0;0;0;0;0;0;0;0;0;0;1;0;0;0;1
*90*00;Taschendiebstahl insgesamt;8231000;Pforzheim;X;8;0;0;0;0;0;0;1;0;1;0;1;0;0;0;1;2;4;0;0;7
*90*00;Taschendiebstahl insgesamt;12054000;Potsdam;M;5;0;0;0;0;0;0;0;0;0;0;0;0;2;2;2;0;0;1;0;5
*90*00;Taschendiebstahl insgesamt;12054000;Potsdam;W;5;0;0;0;0;1;1;1;2;3;0;4;0;0;0;1;0;0;0;0;1
*90*00;Taschendiebstahl insgesamt;12054000;Potsdam;X;10;0;0;0;0;1;1;1;2;3;0;4;0;2;2;3;0;0;1;0;6
*90*00;Taschendiebstahl insgesamt;5562032;Recklinghausen;M;3;0;0;0;0;0;0;0;0;0;2;2;0;0;0;1;0;0;0;0;1
*90*00;Taschendiebstahl insgesamt;5562032;Recklinghausen;W;0;0;0;0;0;0;0;0;0;0;0;0;0;0;0;0;0;0;0;0;0
*90*00;Taschendiebstahl insgesamt;5562032;Recklinghausen;X;3;0;0;0;0;0;0;0;0;0;2;2;0;0;0;1;0;0;0;0;1
*90*00;Taschendiebstahl insgesamt;9362000;Regensburg;M;7;0;0;0;0;0;0;2;0;2;0;2;0;3;3;2;0;0;0;0;5
*90*00;Taschendiebstahl insgesamt;9362000;Regensburg;W;2;0;0;0;0;0;0;0;0;0;0;0;0;0;0;1;0;1;0;0;2
*90*00;Taschendiebstahl insgesamt;9362000;Regensburg;X;9;0;0;0;0;0;0;2;0;2;0;2;0;3;3;3;0;1;0;0;7
*90*00;Taschendiebstahl insgesamt;5120000;Remscheid;M;4;0;0;0;0;0;0;0;0;0;1;1;1;0;1;1;1;0;0;0;3
*90*00;Taschendiebstahl insgesamt;5120000;Remscheid;W;9;0;0;0;0;0;0;0;0;0;1;1;1;1;2;2;2;1;1;0;8
*90*00;Taschendiebstahl insgesamt;5120000;Remscheid;X;13;0;0;0;0;0;0;0;0;0;2;2;2;1;3;3;3;1;1;0;11
*90*00;Taschendiebstahl insgesamt;8415061;Reutlingen;M;1;0;0;0;0;0;0;0;0;0;0;0;1;0;1;0;0;0;0;0;1
*90*00;Taschendiebstahl insgesamt;8415061;Reutlingen;W;2;0;0;0;0;0;0;0;0;0;1;1;0;0;0;0;1;0;0;0;1
*90*00;Taschendiebstahl insgesamt;8415061;Reutlingen;X;3;0;0;0;0;0;0;0;0;0;1;1;1;0;1;0;1;0;0;0;2
*90*00;Taschendiebstahl insgesamt;13003000;Rostock;M;18;0;0;2;0;0;2;1;3;4;2;8;0;1;1;5;2;1;1;0;10
*90*00;Taschendiebstahl insgesamt;13003000;Rostock;W;5;0;0;0;0;1;1;0;1;1;0;2;0;1;1;0;1;1;0;0;3
*90*00;Taschendiebstahl insgesamt;13003000;Rostock;X;23;0;0;2;0;1;3;1;4;5;2;10;0;2;2;5;3;2;1;0;13
*90*00;Taschendiebstahl insgesamt;10041100;Saarbrücken;M;19;0;0;0;0;1;1;3;0;3;3;7;1;0;1;1;5;4;0;1;12
*90*00;Taschendiebstahl insgesamt;10041100;Saarbrücken;W;41;0;0;0;0;1;1;1;5;6;8;15;2;1;3;5;11;7;0;0;26
*90*00;Taschendiebstahl insgesamt;10041100;Saarbrücken;X;60;0;0;0;0;2;2;4;5;9;11;22;3;1;4;6;16;11;0;1;38
*90*00;Taschendiebstahl insgesamt;5122000;Solingen;M;4;0;0;0;0;0;0;0;2;2;1;3;0;0;0;0;1;0;0;0;1
*90*00;Taschendiebstahl insgesamt;5122000;Solingen;W;13;0;0;0;0;0;0;1;3;4;0;4;2;0;2;5;2;0;0;0;9
*90*00;Taschendiebstahl insgesamt;5122000;Solingen;X;17;0;0;0;0;0;0;1;5;6;1;7;2;0;2;5;3;0;0;0;10
*90*00;Taschendiebstahl insgesamt;8111000;Stuttgart;M;123;0;0;0;0;1;1;4;13;17;13;31;9;18;27;23;27;11;2;2;92
*90*00;Taschendiebstahl insgesamt;8111000;Stuttgart;W;22;0;0;0;0;0;0;0;1;1;6;7;4;1;5;6;3;1;0;0;15
*90*00;Taschendiebstahl insgesamt;8111000;Stuttgart;X;145;0;0;0;0;1;1;4;14;18;19;38;13;19;32;29;30;12;2;2;107
*90*00;Taschendiebstahl insgesamt;7211000;Trier;M;5;0;0;0;0;0;0;3;1;4;1;5;0;0;0;0;0;0;0;0;0
*90*00;Taschendiebstahl insgesamt;7211000;Trier;W;6;0;0;0;0;0;0;0;1;1;2;3;0;0;0;1;1;0;1;0;3
*90*00;Taschendiebstahl insgesamt;7211000;Trier;X;11;0;0;0;0;0;0;3;2;5;3;8;0;0;0;1;1;0;1;0;3
*90*00;Taschendiebstahl insgesamt;8421000;Ulm;M;5;0;0;0;0;0;0;0;3;3;0;3;0;0;0;1;1;0;0;0;2
*90*00;Taschendiebstahl insgesamt;8421000;Ulm;W;5;0;0;0;0;0;0;0;1;1;1;2;1;0;1;1;1;0;0;0;3
*90*00;Taschendiebstahl insgesamt;8421000;Ulm;X;10;0;0;0;0;0;0;0;4;4;1;5;1;0;1;2;2;0;0;0;5
*90*00;Taschendiebstahl insgesamt;6414000;Wiesbaden;M;18;0;0;0;0;0;0;0;1;1;4;5;3;1;4;1;5;3;0;0;13
*90*00;Taschendiebstahl insgesamt;6414000;Wiesbaden;W;15;0;0;0;0;0;0;1;2;3;3;6;1;1;2;3;2;1;1;0;9
*90*00;Taschendiebstahl insgesamt;6414000;Wiesbaden;X;33;0;0;0;0;0;0;1;3;4;7;11;4;2;6;4;7;4;1;0;22
*90*00;Taschendiebstahl insgesamt;3103000;Wolfsburg;M;3;0;0;0;0;0;0;0;0;0;0;0;0;1;1;1;1;0;0;0;3
*90*00;Taschendiebstahl insgesamt;3103000;Wolfsburg;W;1;0;0;0;0;0;0;0;0;0;0;0;0;0;0;0;0;0;1;0;1
*90*00;Taschendiebstahl insgesamt;3103000;Wolfsburg;X;4;0;0;0;0;0;0;0;0;0;0;0;0;1;1;1;1;0;1;0;4
*90*00;Taschendiebstahl insgesamt;5124000;Wuppertal;M;26;0;0;1;1;1;3;1;2;3;6;12;0;2;2;2;5;5;0;0;14
*90*00;Taschendiebstahl insgesamt;5124000;Wuppertal;W;34;0;0;0;0;1;1;2;2;4;6;11;6;0;6;7;8;2;0;0;23
*90*00;Taschendiebstahl insgesamt;5124000;Wuppertal;X;60;0;0;1;1;2;4;3;4;7;12;23;6;2;8;9;13;7;0;0;37
*90*00;Taschendiebstahl insgesamt;9663000;Würzburg;M;26;0;0;1;0;0;1;1;2;3;6;10;3;3;6;4;4;1;1;0;16
*90*00;Taschendiebstahl insgesamt;9663000;Würzburg;W;9;0;0;0;0;1;1;1;1;2;1;4;0;1;1;0;4;0;0;0;5
*90*00;Taschendiebstahl insgesamt;9663000;Würzburg;X;35;0;0;1;0;1;2;2;3;5;7;14;3;4;7;4;8;1;1;0;21
510000;Betrug §§ 263, 263a, 264, 264a, 265, 265a, 265b StGB;5334002;Aachen;M;1262;0;0;0;1;0;1;38;100;138;213;352;92;93;185;180;255;158;80;52;910
510000;Betrug §§ 263, 263a, 264, 264a, 265, 265a, 265b StGB;5334002;Aachen;W;583;0;0;0;0;5;5;28;60;88;96;189;43;37;80;75;99;82;39;19;394
510000;Betrug §§ 263, 263a, 264, 264a, 265, 265a, 265b StGB;5334002;Aachen;X;1845;0;0;0;1;5;6;66;160;226;309;541;135;130;265;255;354;240;119;71;1304
510000;Betrug §§ 263, 263a, 264, 264a, 265, 265a, 265b StGB;9761000;Augsburg;M;1939;0;0;0;1;3;4;52;114;166;261;431;162;146;308;308;423;258;151;60;1508
510000;Betrug §§ 263, 263a, 264, 264a, 265, 265a, 265b StGB;9761000;Augsburg;W;807;0;0;0;0;3;3;40;55;95;106;204;63;73;136;104;167;102;61;33;603
510000;Betrug §§ 263, 263a, 264, 264a, 265, 265a, 265b StGB;9761000;Augsburg;X;2746;0;0;0;1;6;7;92;169;261;367;635;225;219;444;412;590;360;212;93;2111
510000;Betrug §§ 263, 263a, 264, 264a, 265, 265a, 265b StGB;5378004;Bergisch Gladbach;M;308;0;0;0;0;1;1;7;7;14;26;41;21;23;44;44;72;60;31;16;267
510000;Betrug §§ 263, 263a, 264, 264a, 265, 265a, 265b StGB;5378004;Bergisch Gladbach;W;152;0;0;0;0;1;1;2;11;13;14;28;8;9;17;28;31;24;15;9;124
510000;Betrug §§ 263, 263a, 264, 264a, 265, 265a, 265b StGB;5378004;Bergisch Gladbach;X;460;0;0;0;0;2;2;9;18;27;40;69;29;32;61;72;103;84;46;25;391
510000;Betrug §§ 263, 263a, 264, 264a, 265, 265a, 265b StGB;11000000;Berlin;M;31009;2;0;1;8;47;58;368;906;1274;2591;3923;2148;2492;4640;5790;8009;4872;2699;1076;27086
510000;Betrug §§ 263, 263a, 264, 264a, 265, 265a, 265b StGB;11000000;Berlin;W;14831;0;0;2;6;50;58;275;598;873;1674;2605;1239;1305;2544;2761;3227;2051;1137;506;12226
510000;Betrug §§ 263, 263a, 264, 264a, 265, 265a, 265b StGB;11000000;Berlin;X;45840;2;0;3;14;97;116;643;1504;2147;4265;6528;3387;3797;7184;8551;11236;6923;3836;1582;39312
510000;Betrug §§ 263, 263a, 264, 264a, 265, 265a, 265b StGB;5711000;Bielefeld;M;2576;0;0;0;2;5;7;47;86;133;258;398;218;219;437;457;643;388;163;90;2178
510000;Betrug §§ 263, 263a, 264, 264a, 265, 265a, 265b StGB;5711000;Bielefeld;W;1007;0;0;0;0;6;6;44;61;105;96;207;77;76;153;171;217;171;65;23;800
510000;Betrug §§ 263, 263a, 264, 264a, 265, 265a, 265b StGB;5711000;Bielefeld;X;3583;0;0;0;2;11;13;91;147;238;354;605;295;295;590;628;860;559;228;113;2978
510000;Betrug §§ 263, 263a, 264, 264a, 265, 265a, 265b StGB;5911000;Bochum;M;2086;0;1;0;1;7;9;10;73;83;230;322;186;170;356;371;499;327;159;52;1764
510000;Betrug §§ 263, 263a, 264, 264a, 265, 265a, 265b StGB;5911000;Bochum;W;819;0;0;1;2;10;13;19;32;51;123;187;88;65;153;141;138;109;67;24;632
510000;Betrug §§ 263, 263a, 264, 264a, 265, 265a, 265b StGB;5911000;Bochum;X;2905;0;1;1;3;17;22;29;105;134;353;509;274;235;509;512;637;436;226;76;2396
510000;Betrug §§ 263, 263a, 264, 264a, 265, 265a, 265b StGB;5314000;Bonn;M;2235;0;0;0;0;4;4;31;84;115;295;414;209;212;421;345;495;301;167;92;1821
510000;Betrug §§ 263, 263a, 264, 264a, 265, 265a, 265b StGB;5314000;Bonn;W;983;0;0;0;1;3;4;42;60;102;129;235;101;87;188;130;176;126;93;35;748
510000;Betrug §§ 263, 263a, 264, 264a, 265, 265a, 265b StGB;5314000;Bonn;X;3218;0;0;0;1;7;8;73;144;217;424;649;310;299;609;475;671;427;260;127;2569
510000;Betrug §§ 263, 263a, 264, 264a, 265, 265a, 265b StGB;5512000;Bottrop;M;594;0;0;0;0;2;2;4;11;15;55;72;52;63;115;111;136;100;38;22;522
510000;Betrug §§ 263, 263a, 264, 264a, 265, 265a, 265b StGB;5512000;Bottrop;W;296;0;0;0;0;2;2;3;13;16;38;56;26;29;55;42;75;44;13;11;240
510000;Betrug §§ 263, 263a, 264, 264a, 265, 265a, 265b StGB;5512000;Bottrop;X;890;0;0;0;0;4;4;7;24;31;93;128;78;92;170;153;211;144;51;33;762
510000;Betrug §§ 263, 263a, 264, 264a, 265, 265a, 265b StGB;3101000;Braunschweig;M;2170;0;0;0;0;2;2;31;72;103;295;400;213;200;413;397;484;267;133;76;1770
510000;Betrug §§ 263, 263a, 264, 264a, 265, 265a, 265b StGB;3101000;Braunschweig;W;897;0;0;1;0;6;7;31;58;89;109;205;88;70;158;136;176;117;68;37;692
510000;Betrug §§ 263, 263a, 264, 264a, 265, 265a, 265b StGB;3101000;Braunschweig;X;3067;0;0;1;0;8;9;62;130;192;404;605;301;270;571;533;660;384;201;113;2462
510000;Betrug §§ 263, 263a, 264, 264a, 265, 265a, 265b StGB;4011000;Bremen;M;3961;0;0;0;1;13;14;70;138;208;435;657;345;338;683;670;956;580;297;118;3304
510000;Betrug §§ 263, 263a, 264, 264a, 265, 265a, 265b StGB;4011000;Bremen;W;1480;0;0;0;1;5;6;42;81;123;188;317;144;124;268;234;309;198;107;47;1163
510000;Betrug §§ 263, 263a, 264, 264a, 265, 265a, 265b StGB;4011000;Bremen;X;5441;0;0;0;2;18;20;112;219;331;623;974;489;462;951;904;1265;778;404;165;4467
510000;Betrug §§ 263, 263a, 264, 264a, 265, 265a, 265b StGB;4012000;Bremerhaven;M;425;0;0;0;0;0;0;4;6;10;44;54;30;27;57;85;98;64;46;21;371
510000;Betrug §§ 263, 263a, 264, 264a, 265, 265a, 265b StGB;4012000;Bremerhaven;W;206;0;0;0;0;0;0;4;3;7;21;28;23;20;43;34;37;29;25;10;178
510000;Betrug §§ 263, 263a, 264, 264a, 265, 265a, 265b StGB;4012000;Bremerhaven;X;631;0;0;0;0;0;0;8;9;17;65;82;53;47;100;119;135;93;71;31;549
510000;Betrug §§ 263, 263a, 264, 264a, 265, 265a, 265b StGB;14511000;Chemnitz;M;1891;0;0;0;1;1;2;36;71;107;217;326;133;167;300;391;473;207;122;72;1565
510000;Betrug §§ 263, 263a, 264, 264a, 265, 265a, 265b StGB;14511000;Chemnitz;W;708;0;0;0;3;2;5;24;33;57;79;141;49;54;103;140;139;89;64;32;567
510000;Betrug §§ 263, 263a, 264, 264a, 265, 265a, 265b StGB;14511000;Chemnitz;X;2599;0;0;0;4;3;7;60;104;164;296;467;182;221;403;531;612;296;186;104;2132
510000;Betrug §§ 263, 263a, 264, 264a, 265, 265a, 265b StGB;6411000;Darmstadt;M;918;0;0;0;0;0;0;11;40;51;101;152;72;74;146;161;203;151;72;33;766
510000;Betrug §§ 263, 263a, 264, 264a, 265, 265a, 265b StGB;6411000;Darmstadt;W;405;0;0;0;0;2;2;10;23;33;52;87;31;22;53;62;97;63;30;13;318
510000;Betrug §§ 263, 263a, 264, 264a, 265, 265a, 265b StGB;6411000;Darmstadt;X;1323;0;0;0;0;2;2;21;63;84;153;239;103;96;199;223;300;214;102;46;1084
510000;Betrug §§ 263, 263a, 264, 264a, 265, 265a, 265b StGB;5913000;Dortmund;M;5959;0;0;0;4;19;23;111;274;385;733;1141;517;526;1043;1093;1327;824;378;153;4818
510000;Betrug §§ 263, 263a, 264, 264a, 265, 265a, 265b StGB;5913000;Dortmund;W;2082;0;1;0;2;26;29;82;101;183;276;488;212;172;384;356;438;263;107;46;1594
510000;Betrug §§ 263, 263a, 264, 264a, 265, 265a, 265b StGB;5913000;Dortmund;X;8041;0;1;0;6;45;52;193;375;568;1009;1629;729;698;1427;1449;1765;1087;485;199;6412
510000;Betrug §§ 263, 263a, 264, 264a, 265, 265a, 265b StGB;14612000;Dresden;M;4915;0;0;1;0;10;11;54;101;155;354;520;300;376;676;1024;1311;716;486;182;4395
510000;Betrug §§ 263, 263a, 264, 264a, 265, 265a, 265b StGB;14612000;Dresden;W;2769;0;0;0;0;2;2;50;81;131;180;313;169;232;401;561;680;407;277;130;2456
510000;Betrug §§ 263, 263a, 264, 264a, 265, 265a, 265b StGB;14612000;Dresden;X;7684;0;0;1;0;12;13;104;182;286;534;833;469;608;1077;1585;1991;1123;763;312;6851
510000;Betrug §§ 263, 263a, 264, 264a, 265, 265a, 265b StGB;5112000;Duisburg;M;4563;1;0;2;8;26;37;103;162;265;537;839;430;394;824;820;1072;631;271;106;3724
510000;Betrug §§ 263, 263a, 264, 264a, 265, 265a, 265b StGB;5112000;Duisburg;W;2011;0;0;0;6;20;26;59;116;175;300;501;216;184;400;326;396;239;103;46;1510
510000;Betrug §§ 263, 263a, 264, 264a, 265, 265a, 265b StGB;5112000;Duisburg;X;6574;1;0;2;14;46;63;162;278;440;837;1340;646;578;1224;1146;1468;870;374;152;5234
510000;Betrug §§ 263, 263a, 264, 264a, 265, 265a, 265b StGB;5111000;Düsseldorf;M;4845;0;0;0;0;7;7;41;135;176;471;654;385;398;783;849;1177;805;368;209;4191
510000;Betrug §§ 263, 263a, 264, 264a, 265, 265a, 265b StGB;5111000;Düsseldorf;W;2009;0;0;0;0;9;9;54;105;159;281;449;183;169;352;327;398;279;144;60;1560
510000;Betrug §§ 263, 263a, 264, 264a, 265, 265a, 265b StGB;5111000;Düsseldorf;X;6854;0;0;0;0;16;16;95;240;335;752;1103;568;567;1135;1176;1575;1084;512;269;5751
510000;Betrug §§ 263, 263a, 264, 264a, 265, 265a, 265b StGB;16051000;Erfurt;M;1707;0;0;1;0;1;2;43;68;111;161;274;134;158;292;353;381;211;125;71;1433
510000;Betrug §§ 263, 263a, 264, 264a, 265, 265a, 265b StGB;16051000;Erfurt;W;1055;0;0;1;0;0;1;51;47;98;127;226;94;103;197;193;215;114;68;42;829
510000;Betrug §§ 263, 263a, 264, 264a, 265, 265a, 265b StGB;16051000;Erfurt;X;2762;0;0;2;0;1;3;94;115;209;288;500;228;261;489;546;596;325;193;113;2262
510000;Betrug §§ 263, 263a, 264, 264a, 265, 265a, 265b StGB;9562000;Erlangen;M;319;0;0;0;0;0;0;5;9;14;30;44;24;28;52;54;72;48;32;17;275
510000;Betrug §§ 263, 263a, 264, 264a, 265, 265a, 265b StGB;9562000;Erlangen;W;150;0;0;0;0;0;0;0;6;6;28;34;20;10;30;24;25;20;13;4;116
510000;Betrug §§ 263, 263a, 264, 264a, 265, 265a, 265b StGB;9562000;Erlangen;X;469;0;0;0;0;0;0;5;15;20;58;78;44;38;82;78;97;68;45;21;391
510000;Betrug §§ 263, 263a, 264, 264a, 265, 265a, 265b StGB;5113000;Essen;M;5214;0;0;2;2;8;12;101;196;297;608;917;510;469;979;918;1209;716;342;133;4297
510000;Betrug §§ 263, 263a, 264, 264a, 265, 265a, 265b StGB;5113000;Essen;W;2326;0;1;0;2;9;12;74;104;178;323;513;215;186;401;432;493;292;129;66;1813
510000;Betrug §§ 263, 263a, 264, 264a, 265, 265a, 265b StGB;5113000;Essen;X;7540;0;1;2;4;17;24;175;300;475;931;1430;725;655;1380;1350;1702;1008;471;199;6110
510000;Betrug §§ 263, 263a, 264, 264a, 265, 265a, 265b StGB;6412000;Frankfurt am Main;M;8468;0;0;0;1;12;13;109;332;441;789;1243;627;696;1323;1483;2152;1388;635;244;7225
510000;Betrug §§ 263, 263a, 264, 264a, 265, 265a, 265b StGB;6412000;Frankfurt am Main;W;3069;1;0;2;0;6;9;94;196;290;417;716;257;258;515;469;710;427;171;61;2353
510000;Betrug §§ 263, 263a, 264, 264a, 265, 265a, 265b StGB;6412000;Frankfurt am Main;X;11537;1;0;2;1;18;22;203;528;731;1206;1959;884;954;1838;1952;2862;1815;806;305;9578
510000;Betrug §§ 263, 263a, 264, 264a, 265, 265a, 265b StGB;8311000;Freiburg im Breisgau;M;2211;0;1;0;0;8;9;69;161;230;302;541;203;190;393;367;438;245;145;82;1670
510000;Betrug §§ 263, 263a, 264, 264a, 265, 265a, 265b StGB;8311000;Freiburg im Breisgau;W;817;0;0;0;1;4;5;33;53;86;119;210;83;51;134;124;158;98;60;33;607
510000;Betrug §§ 263, 263a, 264, 264a, 265, 265a, 265b StGB;8311000;Freiburg im Breisgau;X;3028;0;1;0;1;12;14;102;214;316;421;751;286;241;527;491;596;343;205;115;2277
510000;Betrug §§ 263, 263a, 264, 264a, 265, 265a, 265b StGB;9563000;Fürth;M;516;0;0;0;0;1;1;10;28;38;54;93;33;36;69;81;141;78;36;18;423
510000;Betrug §§ 263, 263a, 264, 264a, 265, 265a, 265b StGB;9563000;Fürth;W;237;0;0;0;0;0;0;8;15;23;24;47;16;14;30;41;53;31;22;13;190
510000;Betrug §§ 263, 263a, 264, 264a, 265, 265a, 265b StGB;9563000;Fürth;X;753;0;0;0;0;1;1;18;43;61;78;140;49;50;99;122;194;109;58;31;613
510000;Betrug §§ 263, 263a, 264, 264a, 265, 265a, 265b StGB;5513000;Gelsenkirchen;M;1161;0;1;0;2;8;11;29;41;70;111;192;84;92;176;178;287;194;93;41;969
510000;Betrug §§ 263, 263a, 264, 264a, 265, 265a, 265b StGB;5513000;Gelsenkirchen;W;538;0;0;1;2;6;9;13;22;35;64;108;41;42;83;85;140;71;33;18;430
510000;Betrug §§ 263, 263a, 264, 264a, 265, 265a, 265b StGB;5513000;Gelsenkirchen;X;1699;0;1;1;4;14;20;42;63;105;175;300;125;134;259;263;427;265;126;59;1399
510000;Betrug §§ 263, 263a, 264, 264a, 265, 265a, 265b StGB;3152012;Göttingen;M;805;1;0;0;1;5;7;9;28;37;83;127;50;73;123;142;190;119;59;45;678
510000;Betrug §§ 263, 263a, 264, 264a, 265, 265a, 265b StGB;3152012;Göttingen;W;344;0;0;0;0;6;6;3;14;17;35;58;31;32;63;54;57;53;29;30;286
510000;Betrug §§ 263, 263a, 264, 264a, 265, 265a, 265b StGB;3152012;Göttingen;X;1149;1;0;0;1;11;13;12;42;54;118;185;81;105;186;196;247;172;88;75;964
510000;Betrug §§ 263, 263a, 264, 264a, 265, 265a, 265b StGB;5914000;Hagen;M;1260;0;0;1;1;5;7;13;46;59;151;217;119;116;235;237;277;181;89;24;1043
510000;Betrug §§ 263, 263a, 264, 264a, 265, 265a, 265b StGB;5914000;Hagen;W;428;0;0;0;1;7;8;9;28;37;55;100;43;34;77;70;83;56;29;13;328
510000;Betrug §§ 263, 263a, 264, 264a, 265, 265a, 265b StGB;5914000;Hagen;X;1688;0;0;1;2;12;15;22;74;96;206;317;162;150;312;307;360;237;118;37;1371
510000;Betrug §§ 263, 263a, 264, 264a, 265, 265a, 265b StGB;15002000;Halle (Saale);M;1501;0;0;1;2;7;10;24;38;62;120;192;101;111;212;299;406;234;102;56;1309
510000;Betrug §§ 263, 263a, 264, 264a, 265, 265a, 265b StGB;15002000;Halle (Saale);W;694;0;0;0;2;9;11;10;29;39;61;111;44;51;95;147;165;91;64;21;583
510000;Betrug §§ 263, 263a, 264, 264a, 265, 265a, 265b StGB;15002000;Halle (Saale);X;2195;0;0;1;4;16;21;34;67;101;181;303;145;162;307;446;571;325;166;77;1892
510000;Betrug §§ 263, 263a, 264, 264a, 265, 265a, 265b StGB;2000000;Hamburg;M;11839;0;0;0;6;54;60;271;558;829;1287;2176;814;883;1697;2054;2608;1849;974;481;9663
510000;Betrug §§ 263, 263a, 264, 264a, 265, 265a, 265b StGB;2000000;Hamburg;W;4317;0;0;0;2;42;44;171;222;393;495;932;385;348;733;685;909;602;326;130;3385
510000;Betrug §§ 263, 263a, 264, 264a, 265, 265a, 265b StGB;2000000;Hamburg;X;16156;0;0;0;8;96;104;442;780;1222;1782;3108;1199;1231;2430;2739;3517;2451;1300;611;13048
510000;Betrug §§ 263, 263a, 264, 264a, 265, 265a, 265b StGB;5915000;Hamm;M;1148;0;0;0;0;1;1;13;38;51;156;208;86;100;186;201;281;159;74;39;940
510000;Betrug §§ 263, 263a, 264, 264a, 265, 265a, 265b StGB;5915000;Hamm;W;365;0;0;0;0;7;7;8;16;24;49;80;19;23;42;70;82;55;25;11;285
510000;Betrug §§ 263, 263a, 264, 264a, 265, 265a, 265b StGB;5915000;Hamm;X;1513;0;0;0;0;8;8;21;54;75;205;288;105;123;228;271;363;214;99;50;1225
510000;Betrug §§ 263, 263a, 264, 264a, 265, 265a, 265b StGB;3241001;Hannover;M;6273;0;0;2;2;19;23;112;248;360;730;1113;540;535;1075;1077;1392;927;455;234;5160
510000;Betrug §§ 263, 263a, 264, 264a, 265, 265a, 265b StGB;3241001;Hannover;W;2725;0;0;0;2;13;15;89;162;251;333;599;252;226;478;396;552;357;215;128;2126
510000;Betrug §§ 263, 263a, 264, 264a, 265, 265a, 265b StGB;3241001;Hannover;X;8998;0;0;2;4;32;38;201;410;611;1063;1712;792;761;1553;1473;1944;1284;670;362;7286
510000;Betrug §§ 263, 263a, 264, 264a, 265, 265a, 265b StGB;8221000;Heidelberg;M;974;0;0;0;1;4;5;14;21;35;125;165;82;90;172;175;207;134;85;36;809
510000;Betrug §§ 263, 263a, 264, 264a, 265, 265a, 265b StGB;8221000;Heidelberg;W;525;0;0;0;0;0;0;16;22;38;73;111;66;45;111;80;94;72;37;20;414
510000;Betrug §§ 263, 263a, 264, 264a, 265, 265a, 265b StGB;8221000;Heidelberg;X;1499;0;0;0;1;4;5;30;43;73;198;276;148;135;283;255;301;206;122;56;1223
510000;Betrug §§ 263, 263a, 264, 264a, 265, 265a, 265b StGB;8121000;Heilbronn;M;583;0;0;0;0;4;4;19;24;43;66;113;44;47;91;104;138;70;44;23;470
510000;Betrug §§ 263, 263a, 264, 264a, 265, 265a, 265b StGB;8121000;Heilbronn;W;287;0;0;0;0;2;2;12;14;26;35;63;17;19;36;45;67;48;23;5;224
510000;Betrug §§ 263, 263a, 264, 264a, 265, 265a, 265b StGB;8121000;Heilbronn;X;870;0;0;0;0;6;6;31;38;69;101;176;61;66;127;149;205;118;67;28;694
510000;Betrug §§ 263, 263a, 264, 264a, 265, 265a, 265b StGB;5916000;Herne;M;717;0;0;0;0;4;4;5;23;28;81;113;64;62;126;119;187;108;42;22;604
510000;Betrug §§ 263, 263a, 264, 264a, 265, 265a, 265b StGB;5916000;Herne;W;295;0;0;0;0;2;2;4;8;12;25;39;24;14;38;47;78;58;20;15;256
510000;Betrug §§ 263, 263a, 264, 264a, 265, 265a, 265b StGB;5916000;Herne;X;1012;0;0;0;0;6;6;9;31;40;106;152;88;76;164;166;265;166;62;37;860
510000;Betrug §§ 263, 263a, 264, 264a, 265, 265a, 265b StGB;9161000;Ingolstadt;M;661;0;0;0;0;1;1;13;38;51;69;121;57;46;103;93;147;112;58;27;540
510000;Betrug §§ 263, 263a, 264, 264a, 265, 265a, 265b StGB;9161000;Ingolstadt;W;233;0;0;0;0;0;0;7;8;15;30;45;16;28;44;30;54;33;22;5;188
510000;Betrug §§ 263, 263a, 264, 264a, 265, 265a, 265b StGB;9161000;Ingolstadt;X;894;0;0;0;0;1;1;20;46;66;99;166;73;74;147;123;201;145;80;32;728
510000;Betrug §§ 263, 263a, 264, 264a, 265, 265a, 265b StGB;16053000;Jena;M;692;0;0;0;0;0;0;2;14;16;51;67;50;55;105;134;206;103;57;20;625
510000;Betrug §§ 263, 263a, 264, 264a, 265, 265a, 265b StGB;16053000;Jena;W;313;0;0;0;1;1;2;3;4;7;30;39;23;21;44;61;90;44;26;9;274
510000;Betrug §§ 263, 263a, 264, 264a, 265, 265a, 265b StGB;16053000;Jena;X;1005;0;0;0;1;1;2;5;18;23;81;106;73;76;149;195;296;147;83;29;899
510000;Betrug §§ 263, 263a, 264, 264a, 265, 265a, 265b StGB;8212000;Karlsruhe;M;3693;0;1;1;5;7;14;84;185;269;498;781;411;356;767;668;774;398;224;81;2912
510000;Betrug §§ 263, 263a, 264, 264a, 265, 265a, 265b StGB;8212000;Karlsruhe;W;1203;0;0;0;0;6;6;69;82;151;188;345;113;98;211;166;229;121;99;32;858
510000;Betrug §§ 263, 263a, 264, 264a, 265, 265a, 265b StGB;8212000;Karlsruhe;X;4896;0;1;1;5;13;20;153;267;420;686;1126;524;454;978;834;1003;519;323;113;3770
510000;Betrug §§ 263, 263a, 264, 264a, 265, 265a, 265b StGB;6611000;Kassel;M;1694;0;1;1;1;2;5;37;60;97;163;265;133;139;272;298;422;230;141;66;1429
510000;Betrug §§ 263, 263a, 264, 264a, 265, 265a, 265b StGB;6611000;Kassel;W;732;0;1;0;2;4;7;28;35;63;82;152;67;66;133;99;143;106;69;30;580
510000;Betrug §§ 263, 263a, 264, 264a, 265, 265a, 265b StGB;6611000;Kassel;X;2426;0;2;1;3;6;12;65;95;160;245;417;200;205;405;397;565;336;210;96;2009
510000;Betrug §§ 263, 263a, 264, 264a, 265, 265a, 265b StGB;1002000;Kiel;M;1048;0;0;0;0;0;0;16;33;49;121;170;77;80;157;151;233;190;92;55;878
510000;Betrug §§ 263, 263a, 264, 264a, 265, 265a, 265b StGB;1002000;Kiel;W;531;0;0;0;0;3;3;6;19;25;50;78;52;55;107;91;107;80;49;19;453
510000;Betrug §§ 263, 263a, 264, 264a, 265, 265a, 265b StGB;1002000;Kiel;X;1579;0;0;0;0;3;3;22;52;74;171;248;129;135;264;242;340;270;141;74;1331
510000;Betrug §§ 263, 263a, 264, 264a, 265, 265a, 265b StGB;7111000;Koblenz;M;841;0;0;0;0;0;0;15;36;51;98;149;68;77;145;150;192;110;65;30;692
510000;Betrug §§ 263, 263a, 264, 264a, 265, 265a, 265b StGB;7111000;Koblenz;W;318;0;0;0;0;2;2;12;22;34;39;75;24;26;50;47;63;58;18;7;243
510000;Betrug §§ 263, 263a, 264, 264a, 265, 265a, 265b StGB;7111000;Koblenz;X;1159;0;0;0;0;2;2;27;58;85;137;224;92;103;195;197;255;168;83;37;935
510000;Betrug §§ 263, 263a, 264, 264a, 265, 265a, 265b StGB;5315000;Köln;M;7754;0;0;0;0;11;11;109;402;511;856;1378;629;604;1233;1245;1749;1215;652;282;6376
510000;Betrug §§ 263, 263a, 264, 264a, 265, 265a, 265b StGB;5315000;Köln;W;3509;0;0;0;4;11;15;115;238;353;498;866;318;268;586;590;662;458;213;134;2643
510000;Betrug §§ 263, 263a, 264, 264a, 265, 265a, 265b StGB;5315000;Köln;X;11263;0;0;0;4;22;26;224;640;864;1354;2244;947;872;1819;1835;2411;1673;865;416;9019
510000;Betrug §§ 263, 263a, 264, 264a, 265, 265a, 265b StGB;5114000;Krefeld;M;1974;0;0;0;1;3;4;17;62;79;230;313;168;180;348;322;444;321;147;79;1661
510000;Betrug §§ 263, 263a, 264, 264a, 265, 265a, 265b StGB;5114000;Krefeld;W;820;0;0;1;1;2;4;20;55;75;134;213;65;59;124;125;158;131;46;23;607
510000;Betrug §§ 263, 263a, 264, 264a, 265, 265a, 265b StGB;5114000;Krefeld;X;2794;0;0;1;2;5;8;37;117;154;364;526;233;239;472;447;602;452;193;102;2268
510000;Betrug §§ 263, 263a, 264, 264a, 265, 265a, 265b StGB;14713000;Leipzig;M;4218;0;0;0;0;4;4;40;76;116;311;431;312;362;674;887;1101;604;336;185;3787
510000;Betrug §§ 263, 263a, 264, 264a, 265, 265a, 265b StGB;14713000;Leipzig;W;1975;0;0;1;1;6;8;39;50;89;178;275;155;188;343;409;472;244;151;81;1700
510000;Betrug §§ 263, 263a, 264, 264a, 265, 265a, 265b StGB;14713000;Leipzig;X;6193;0;0;1;1;10;12;79;126;205;489;706;467;550;1017;1296;1573;848;487;266;5487
510000;Betrug §§ 263, 263a, 264, 264a, 265, 265a, 265b StGB;5316000;Leverkusen;M;892;0;0;0;0;2;2;2;30;32;100;134;71;88;159;152;226;129;63;29;758
510000;Betrug §§ 263, 263a, 264, 264a, 265, 265a, 265b StGB;5316000;Leverkusen;W;381;0;0;0;0;1;1;2;21;23;69;93;35;28;63;57;82;56;19;11;288
510000;Betrug §§ 263, 263a, 264, 264a, 265, 265a, 265b StGB;5316000;Leverkusen;X;1273;0;0;0;0;3;3;4;51;55;169;227;106;116;222;209;308;185;82;40;1046
510000;Betrug §§ 263, 263a, 264, 264a, 265, 265a, 265b StGB;1003000;Lübeck;M;964;0;0;0;2;4;6;15;32;47;88;141;60;79;139;168;224;155;86;51;823
510000;Betrug §§ 263, 263a, 264, 264a, 265, 265a, 265b StGB;1003000;Lübeck;W;443;0;0;0;0;1;1;12;18;30;43;74;33;26;59;70;102;68;43;27;369
510000;Betrug §§ 263, 263a, 264, 264a, 265, 265a, 265b StGB;1003000;Lübeck;X;1407;0;0;0;2;5;7;27;50;77;131;215;93;105;198;238;326;223;129;78;1192
510000;Betrug §§ 263, 263a, 264, 264a, 265, 265a, 265b StGB;7314000;Ludwigshafen am Rhein;M;1488;0;0;0;0;1;1;21;58;79;171;251;140;145;285;278;323;210;98;43;1237
510000;Betrug §§ 263, 263a, 264, 264a, 265, 265a, 265b StGB;7314000;Ludwigshafen am Rhein;W;748;0;0;0;0;3;3;18;44;62;92;157;71;58;129;121;162;110;50;19;591
510000;Betrug §§ 263, 263a, 264, 264a, 265, 265a, 265b StGB;7314000;Ludwigshafen am Rhein;X;2236;0;0;0;0;4;4;39;102;141;263;408;211;203;414;399;485;320;148;62;1828
510000;Betrug §§ 263, 263a, 264, 264a, 265, 265a, 265b StGB;15003000;Magdeburg;M;1718;0;1;0;2;8;11;53;58;111;182;304;118;124;242;330;389;228;171;54;1414
510000;Betrug §§ 263, 263a, 264, 264a, 265, 265a, 265b StGB;15003000;Magdeburg;W;851;0;0;0;3;8;11;48;35;83;82;176;72;69;141;134;189;107;80;24;675
510000;Betrug §§ 263, 263a, 264, 264a, 265, 265a, 265b StGB;15003000;Magdeburg;X;2569;0;1;0;5;16;22;101;93;194;264;480;190;193;383;464;578;335;251;78;2089
510000;Betrug §§ 263, 263a, 264, 264a, 265, 265a, 265b StGB;7315000;Mainz;M;1806;0;0;0;0;12;12;34;119;153;245;410;152;161;313;311;345;216;129;82;1396
510000;Betrug §§ 263, 263a, 264, 264a, 265, 265a, 265b StGB;7315000;Mainz;W;723;0;0;0;0;9;9;31;52;83;108;200;74;46;120;87;146;90;54;26;523
510000;Betrug §§ 263, 263a, 264, 264a, 265, 265a, 265b StGB;7315000;Mainz;X;2529;0;0;0;0;21;21;65;171;236;353;610;226;207;433;398;491;306;183;108;1919
510000;Betrug §§ 263, 263a, 264, 264a, 265, 265a, 265b StGB;8222000;Mannheim;M;3304;0;0;0;0;10;10;27;129;156;386;552;324;336;660;600;719;442;226;105;2752
510000;Betrug §§ 263, 263a, 264, 264a, 265, 265a, 265b StGB;8222000;Mannheim;W;1513;0;0;0;0;8;8;39;64;103;223;334;158;130;288;250;304;193;103;41;1179
510000;Betrug §§ 263, 263a, 264, 264a, 265, 265a, 265b StGB;8222000;Mannheim;X;4817;0;0;0;0;18;18;66;193;259;609;886;482;466;948;850;1023;635;329;146;3931
510000;Betrug §§ 263, 263a, 264, 264a, 265, 265a, 265b StGB;5170024;Moers;M;419;0;0;0;1;1;2;1;13;14;49;65;24;31;55;59;112;74;32;22;354
510000;Betrug §§ 263, 263a, 264, 264a, 265, 265a, 265b StGB;5170024;Moers;W;188;0;0;0;0;1;1;1;13;14;23;38;11;13;24;23;50;28;20;5;150
510000;Betrug §§ 263, 263a, 264, 264a, 265, 265a, 265b StGB;5170024;Moers;X;607;0;0;0;1;2;3;2;26;28;72;103;35;44;79;82;162;102;52;27;504
510000;Betrug §§ 263, 263a, 264, 264a, 265, 265a, 265b StGB;5116000;Mönchengladbach;M;1548;0;0;0;0;1;1;23;55;78;197;276;141;162;303;285;367;192;88;37;1272
510000;Betrug §§ 263, 263a, 264, 264a, 265, 265a, 265b StGB;5116000;Mönchengladbach;W;674;0;0;0;0;3;3;23;43;66;115;184;63;65;128;98;134;74;39;17;490
510000;Betrug §§ 263, 263a, 264, 264a, 265, 265a, 265b StGB;5116000;Mönchengladbach;X;2222;0;0;0;0;4;4;46;98;144;312;460;204;227;431;383;501;266;127;54;1762
510000;Betrug §§ 263, 263a, 264, 264a, 265, 265a, 265b StGB;5117000;Mülheim an der Ruhr;M;1342;0;0;0;0;1;1;16;38;54;135;190;121;129;250;260;293;210;87;52;1152
510000;Betrug §§ 263, 263a, 264, 264a, 265, 265a, 265b StGB;5117000;Mülheim an der Ruhr;W;547;0;0;0;0;1;1;11;20;31;73;105;43;50;93;105;119;72;34;19;442
510000;Betrug §§ 263, 263a, 264, 264a, 265, 265a, 265b StGB;5117000;Mülheim an der Ruhr;X;1889;0;0;0;0;2;2;27;58;85;208;295;164;179;343;365;412;282;121;71;1594
510000;Betrug §§ 263, 263a, 264, 264a, 265, 265a, 265b StGB;9162000;München;M;6420;0;0;0;2;7;9;66;194;260;641;910;488;543;1031;1008;1514;1110;572;275;5510
510000;Betrug §§ 263, 263a, 264, 264a, 265, 265a, 265b StGB;9162000;München;W;2792;0;0;0;1;12;13;56;102;158;342;513;252;210;462;457;604;426;227;103;2279
510000;Betrug §§ 263, 263a, 264, 264a, 265, 265a, 265b StGB;9162000;München;X;9212;0;0;0;3;19;22;122;296;418;983;1423;740;753;1493;1465;2118;1536;799;378;7789
510000;Betrug §§ 263, 263a, 264, 264a, 265, 265a, 265b StGB;5515000;Münster;M;1522;0;0;0;0;6;6;41;69;110;178;294;133;111;244;243;339;209;121;72;1228
510000;Betrug §§ 263, 263a, 264, 264a, 265, 265a, 265b StGB;5515000;Münster;W;616;0;0;0;0;4;4;27;29;56;72;132;47;46;93;95;129;89;56;22;484
510000;Betrug §§ 263, 263a, 264, 264a, 265, 265a, 265b StGB;5515000;Münster;X;2138;0;0;0;0;10;10;68;98;166;250;426;180;157;337;338;468;298;177;94;1712
510000;Betrug §§ 263, 263a, 264, 264a, 265, 265a, 265b StGB;5162024;Neuss;M;1308;0;0;0;0;1;1;19;35;54;168;223;96;130;226;255;322;160;85;37;1085
510000;Betrug §§ 263, 263a, 264, 264a, 265, 265a, 265b StGB;5162024;Neuss;W;575;0;0;0;0;2;2;14;37;51;82;135;50;47;97;108;106;76;40;13;440
510000;Betrug §§ 263, 263a, 264, 264a, 265, 265a, 265b StGB;5162024;Neuss;X;1883;0;0;0;0;3;3;33;72;105;250;358;146;177;323;363;428;236;125;50;1525
510000;Betrug §§ 263, 263a, 264, 264a, 265, 265a, 265b StGB;9564000;Nürnberg;M;3244;0;0;0;0;1;1;61;150;211;416;628;251;275;526;514;687;524;261;104;2616
510000;Betrug §§ 263, 263a, 264, 264a, 265, 265a, 265b StGB;9564000;Nürnberg;W;1401;0;0;0;0;3;3;66;104;170;196;369;139;124;263;214;241;175;93;46;1032
510000;Betrug §§ 263, 263a, 264, 264a, 265, 265a, 265b StGB;9564000;Nürnberg;X;4645;0;0;0;0;4;4;127;254;381;612;997;390;399;789;728;928;699;354;150;3648
510000;Betrug §§ 263, 263a, 264, 264a, 265, 265a, 265b StGB;5119000;Oberhausen;M;1106;0;0;0;0;3;3;17;28;45;125;173;103;103;206;183;268;178;62;36;933
510000;Betrug §§ 263, 263a, 264, 264a, 265, 265a, 265b StGB;5119000;Oberhausen;W;495;0;0;0;0;1;1;4;26;30;80;111;48;27;75;90;104;59;41;15;384
510000;Betrug §§ 263, 263a, 264, 264a, 265, 265a, 265b StGB;5119000;Oberhausen;X;1601;0;0;0;0;4;4;21;54;75;205;284;151;130;281;273;372;237;103;51;1317
510000;Betrug §§ 263, 263a, 264, 264a, 265, 265a, 265b StGB;6413000;Offenbach am Main;M;1261;0;0;0;0;4;4;34;74;108;159;271;90;87;177;216;330;163;72;32;990
510000;Betrug §§ 263, 263a, 264, 264a, 265, 265a, 265b StGB;6413000;Offenbach am Main;W;578;0;0;0;0;2;2;16;55;71;102;175;58;33;91;85;116;66;30;15;403
510000;Betrug §§ 263, 263a, 264, 264a, 265, 265a, 265b StGB;6413000;Offenbach am Main;X;1839;0;0;0;0;6;6;50;129;179;261;446;148;120;268;301;446;229;102;47;1393
510000;Betrug §§ 263, 263a, 264, 264a, 265, 265a, 265b StGB;3403000;Oldenburg (Oldenburg);M;732;0;0;0;0;1;1;16;19;35;63;99;58;65;123;114;182;105;73;36;633
510000;Betrug §§ 263, 263a, 264, 264a, 265, 265a, 265b StGB;3403000;Oldenburg (Oldenburg);W;324;0;0;0;1;2;3;11;9;20;31;54;24;29;53;55;60;53;26;23;270
510000;Betrug §§ 263, 263a, 264, 264a, 265, 265a, 265b StGB;3403000;Oldenburg (Oldenburg);X;1056;0;0;0;1;3;4;27;28;55;94;153;82;94;176;169;242;158;99;59;903
510000;Betrug §§ 263, 263a, 264, 264a, 265, 265a, 265b StGB;3404000;Osnabrück;M;1174;0;0;0;0;2;2;12;44;56;110;168;101;105;206;219;274;175;87;45;1006
510000;Betrug §§ 263, 263a, 264, 264a, 265, 265a, 265b StGB;3404000;Osnabrück;W;505;0;0;0;0;0;0;10;19;29;63;92;58;41;99;83;109;70;40;12;413
510000;Betrug §§ 263, 263a, 264, 264a, 265, 265a, 265b StGB;3404000;Osnabrück;X;1679;0;0;0;0;2;2;22;63;85;173;260;159;146;305;302;383;245;127;57;1419
510000;Betrug §§ 263, 263a, 264, 264a, 265, 265a, 265b StGB;5774032;Paderborn;M;1205;0;0;0;0;3;3;48;116;164;231;398;99;87;186;180;231;131;59;20;807
510000;Betrug §§ 263, 263a, 264, 264a, 265, 265a, 265b StGB;5774032;Paderborn;W;548;0;0;0;1;1;2;50;53;103;104;209;46;41;87;69;99;49;28;7;339
510000;Betrug §§ 263, 263a, 264, 264a, 265, 265a, 265b StGB;5774032;Paderborn;X;1753;0;0;0;1;4;5;98;169;267;335;607;145;128;273;249;330;180;87;27;1146
510000;Betrug §§ 263, 263a, 264, 264a, 265, 265a, 265b StGB;8231000;Pforzheim;M;654;0;0;0;5;8;13;14;35;49;51;113;53;47;100;113;152;107;52;17;541
510000;Betrug §§ 263, 263a, 264, 264a, 265, 265a, 265b StGB;8231000;Pforzheim;W;337;0;0;0;0;11;11;25;19;44;32;87;32;22;54;45;80;38;23;10;250
510000;Betrug §§ 263, 263a, 264, 264a, 265, 265a, 265b StGB;8231000;Pforzheim;X;991;0;0;0;5;19;24;39;54;93;83;200;85;69;154;158;232;145;75;27;791
510000;Betrug §§ 263, 263a, 264, 264a, 265, 265a, 265b StGB;12054000;Potsdam;M;647;0;0;0;0;1;1;9;7;16;23;40;30;42;72;110;169;133;91;32;607
510000;Betrug §§ 263, 263a, 264, 264a, 265, 265a, 265b StGB;12054000;Potsdam;W;335;0;0;0;0;3;3;7;9;16;30;49;16;21;37;50;82;58;30;29;286
510000;Betrug §§ 263, 263a, 264, 264a, 265, 265a, 265b StGB;12054000;Potsdam;X;982;0;0;0;0;4;4;16;16;32;53;89;46;63;109;160;251;191;121;61;893
510000;Betrug §§ 263, 263a, 264, 264a, 265, 265a, 265b StGB;5562032;Recklinghausen;M;612;0;0;0;0;2;2;8;26;34;66;102;58;40;98;81;152;100;58;21;510
510000;Betrug §§ 263, 263a, 264, 264a, 265, 265a, 265b StGB;5562032;Recklinghausen;W;279;0;0;0;0;1;1;5;7;12;33;46;18;15;33;48;63;52;26;11;233
510000;Betrug §§ 263, 263a, 264, 264a, 265, 265a, 265b StGB;5562032;Recklinghausen;X;891;0;0;0;0;3;3;13;33;46;99;148;76;55;131;129;215;152;84;32;743
510000;Betrug §§ 263, 263a, 264, 264a, 265, 265a, 265b StGB;9362000;Regensburg;M;927;0;0;1;0;3;4;28;63;91;111;206;91;87;178;132;196;133;55;27;721
510000;Betrug §§ 263, 263a, 264, 264a, 265, 265a, 265b StGB;9362000;Regensburg;W;415;0;0;0;1;3;4;18;38;56;81;141;39;20;59;52;71;53;25;14;274
510000;Betrug §§ 263, 263a, 264, 264a, 265, 265a, 265b StGB;9362000;Regensburg;X;1342;0;0;1;1;6;8;46;101;147;192;347;130;107;237;184;267;186;80;41;995
510000;Betrug §§ 263, 263a, 264, 264a, 265, 265a, 265b StGB;5120000;Remscheid;M;361;0;0;1;2;3;6;4;15;19;28;53;22;27;49;45;95;58;40;21;308
510000;Betrug §§ 263, 263a, 264, 264a, 265, 265a, 265b StGB;5120000;Remscheid;W;155;0;0;0;0;0;0;2;6;8;12;20;9;12;21;23;39;30;14;8;135
510000;Betrug §§ 263, 263a, 264, 264a, 265, 265a, 265b StGB;5120000;Remscheid;X;516;0;0;1;2;3;6;6;21;27;40;73;31;39;70;68;134;88;54;29;443
510000;Betrug §§ 263, 263a, 264, 264a, 265, 265a, 265b StGB;8415061;Reutlingen;M;379;0;0;0;1;3;4;11;13;24;51;79;33;24;57;64;77;58;29;15;300
510000;Betrug §§ 263, 263a, 264, 264a, 265, 265a, 265b StGB;8415061;Reutlingen;W;188;0;0;0;0;2;2;6;6;12;21;35;17;11;28;21;41;36;18;9;153
510000;Betrug §§ 263, 263a, 264, 264a, 265, 265a, 265b StGB;8415061;Reutlingen;X;567;0;0;0;1;5;6;17;19;36;72;114;50;35;85;85;118;94;47;24;453
510000;Betrug §§ 263, 263a, 264, 264a, 265, 265a, 265b StGB;13003000;Rostock;M;1774;1;0;0;2;0;3;16;63;79;175;257;156;170;326;376;408;218;130;59;1517
510000;Betrug §§ 263, 263a, 264, 264a, 265, 265a, 265b StGB;13003000;Rostock;W;854;0;0;0;1;4;5;17;46;63;100;168;72;93;165;148;169;113;67;24;686
510000;Betrug §§ 263, 263a, 264, 264a, 265, 265a, 265b StGB;13003000;Rostock;X;2628;1;0;0;3;4;8;33;109;142;275;425;228;263;491;524;577;331;197;83;2203
510000;Betrug §§ 263, 263a, 264, 264a, 265, 265a, 265b StGB;10041100;Saarbrücken;M;1210;0;0;0;0;5;5;30;50;80;115;200;78;98;176;198;266;219;116;35;1010
510000;Betrug §§ 263, 263a, 264, 264a, 265, 265a, 265b StGB;10041100;Saarbrücken;W;477;0;0;0;0;1;1;12;22;34;79;114;45;35;80;71;99;54;42;17;363
510000;Betrug §§ 263, 263a, 264, 264a, 265, 265a, 265b StGB;10041100;Saarbrücken;X;1687;0;0;0;0;6;6;42;72;114;194;314;123;133;256;269;365;273;158;52;1373
510000;Betrug §§ 263, 263a, 264, 264a, 265, 265a, 265b StGB;5122000;Solingen;M;721;0;0;1;0;3;4;8;19;27;85;116;62;61;123;95;164;132;48;43;605
510000;Betrug §§ 263, 263a, 264, 264a, 265, 265a, 265b StGB;5122000;Solingen;W;314;0;0;0;0;0;0;5;11;16;40;56;14;23;37;40;74;56;25;26;258
510000;Betrug §§ 263, 263a, 264, 264a, 265, 265a, 265b StGB;5122000;Solingen;X;1035;0;0;1;0;3;4;13;30;43;125;172;76;84;160;135;238;188;73;69;863
510000;Betrug §§ 263, 263a, 264, 264a, 265, 265a, 265b StGB;8111000;Stuttgart;M;5772;0;0;0;0;9;9;89;271;360;731;1100;542;506;1048;986;1231;792;420;195;4672
510000;Betrug §§ 263, 263a, 264, 264a, 265, 265a, 265b StGB;8111000;Stuttgart;W;2304;0;0;0;2;4;6;87;156;243;365;614;248;212;460;360;386;280;138;66;1690
510000;Betrug §§ 263, 263a, 264, 264a, 265, 265a, 265b StGB;8111000;Stuttgart;X;8076;0;0;0;2;13;15;176;427;603;1096;1714;790;718;1508;1346;1617;1072;558;261;6362
510000;Betrug §§ 263, 263a, 264, 264a, 265, 265a, 265b StGB;7211000;Trier;M;396;0;0;0;1;1;2;4;17;21;44;67;27;40;67;69;81;52;41;19;329
510000;Betrug §§ 263, 263a, 264, 264a, 265, 265a, 265b StGB;7211000;Trier;W;208;0;0;0;0;0;0;8;14;22;22;44;22;20;42;31;38;24;14;15;164
510000;Betrug §§ 263, 263a, 264, 264a, 265, 265a, 265b StGB;7211000;Trier;X;604;0;0;0;1;1;2;12;31;43;66;111;49;60;109;100;119;76;55;34;493
510000;Betrug §§ 263, 263a, 264, 264a, 265, 265a, 265b StGB;8421000;Ulm;M;1163;0;0;1;3;9;13;27;70;97;141;251;87;95;182;200;265;147;80;38;912
510000;Betrug §§ 263, 263a, 264, 264a, 265, 265a, 265b StGB;8421000;Ulm;W;478;0;0;0;1;9;10;23;30;53;85;148;38;24;62;61;97;55;40;15;330
510000;Betrug §§ 263, 263a, 264, 264a, 265, 265a, 265b StGB;8421000;Ulm;X;1641;0;0;1;4;18;23;50;100;150;226;399;125;119;244;261;362;202;120;53;1242
510000;Betrug §§ 263, 263a, 264, 264a, 265, 265a, 265b StGB;6414000;Wiesbaden;M;1697;0;0;0;3;1;4;35;63;98;190;292;130;115;245;248;398;292;152;70;1405
510000;Betrug §§ 263, 263a, 264, 264a, 265, 265a, 265b StGB;6414000;Wiesbaden;W;807;0;1;0;1;2;4;28;34;62;94;160;76;62;138;107;178;115;69;40;647
510000;Betrug §§ 263, 263a, 264, 264a, 265, 265a, 265b StGB;6414000;Wiesbaden;X;2504;0;1;0;4;3;8;63;97;160;284;452;206;177;383;355;576;407;221;110;2052
510000;Betrug §§ 263, 263a, 264, 264a, 265, 265a, 265b StGB;3103000;Wolfsburg;M;525;0;0;0;2;6;8;10;14;24;48;80;38;43;81;85;117;73;55;34;445
510000;Betrug §§ 263, 263a, 264, 264a, 265, 265a, 265b StGB;3103000;Wolfsburg;W;224;0;0;0;0;1;1;12;9;21;24;46;17;20;37;38;52;27;18;6;178
510000;Betrug §§ 263, 263a, 264, 264a, 265, 265a, 265b StGB;3103000;Wolfsburg;X;749;0;0;0;2;7;9;22;23;45;72;126;55;63;118;123;169;100;73;40;623
510000;Betrug §§ 263, 263a, 264, 264a, 265, 265a, 265b StGB;5124000;Wuppertal;M;2438;0;0;0;3;10;13;55;78;133;285;431;200;176;376;432;553;368;189;89;2007
510000;Betrug §§ 263, 263a, 264, 264a, 265, 265a, 265b StGB;5124000;Wuppertal;W;1085;0;0;0;1;13;14;61;60;121;145;280;92;108;200;153;218;130;56;48;805
510000;Betrug §§ 263, 263a, 264, 264a, 265, 265a, 265b StGB;5124000;Wuppertal;X;3523;0;0;0;4;23;27;116;138;254;430;711;292;284;576;585;771;498;245;137;2812
510000;Betrug §§ 263, 263a, 264, 264a, 265, 265a, 265b StGB;9663000;Würzburg;M;1041;0;0;0;1;1;2;16;41;57;91;150;81;76;157;175;271;161;77;50;891
510000;Betrug §§ 263, 263a, 264, 264a, 265, 265a, 265b StGB;9663000;Würzburg;W;337;0;0;0;0;2;2;7;14;21;44;67;29;21;50;55;80;40;31;14;270
510000;Betrug §§ 263, 263a, 264, 264a, 265, 265a, 265b StGB;9663000;Würzburg;X;1378;0;0;0;1;3;4;23;55;78;135;217;110;97;207;230;351;201;108;64;1161
515000;Erschleichen von Leistungen § 265a StGB;5334002;Aachen;M;519;0;0;0;0;0;0;27;64;91;133;224;50;28;78;76;89;31;12;9;295
515000;Erschleichen von Leistungen § 265a StGB;5334002;Aachen;W;224;0;0;0;0;2;2;24;47;71;61;134;15;9;24;18;23;15;9;1;90
515000;Erschleichen von Leistungen § 265a StGB;5334002;Aachen;X;743;0;0;0;0;2;2;51;111;162;194;358;65;37;102;94;112;46;21;10;385
515000;Erschleichen von Leistungen § 265a StGB;9761000;Augsburg;M;1100;0;0;0;1;3;4;44;92;136;199;339;99;96;195;186;219;90;51;20;761
515000;Erschleichen von Leistungen § 265a StGB;9761000;Augsburg;W;412;0;0;0;0;1;1;33;45;78;75;154;33;41;74;54;71;33;18;8;258
515000;Erschleichen von Leistungen § 265a StGB;9761000;Augsburg;X;1512;0;0;0;1;4;5;77;137;214;274;493;132;137;269;240;290;123;69;28;1019
515000;Erschleichen von Leistungen § 265a StGB;5378004;Bergisch Gladbach;M;109;0;0;0;0;1;1;4;6;10;18;29;13;9;22;18;20;11;8;1;80
515000;Erschleichen von Leistungen § 265a StGB;5378004;Bergisch Gladbach;W;44;0;0;0;0;0;0;1;9;10;8;18;5;2;7;7;5;4;2;1;26
515000;Erschleichen von Leistungen § 265a StGB;5378004;Bergisch Gladbach;X;153;0;0;0;0;1;1;5;15;20;26;47;18;11;29;25;25;15;10;2;106
515000;Erschleichen von Leistungen § 265a StGB;11000000;Berlin;M;17632;2;0;1;6;29;38;244;687;931;1728;2697;1447;1650;3097;3694;4634;2185;1046;279;14935
515000;Erschleichen von Leistungen § 265a StGB;11000000;Berlin;W;7726;0;0;1;2;19;22;189;463;652;1125;1799;776;798;1574;1507;1568;806;374;98;5927
515000;Erschleichen von Leistungen § 265a StGB;11000000;Berlin;X;25358;2;0;2;8;48;60;433;1150;1583;2853;4496;2223;2448;4671;5201;6202;2991;1420;377;20862
515000;Erschleichen von Leistungen § 265a StGB;5711000;Bielefeld;M;1437;0;0;0;1;3;4;41;71;112;191;307;137;128;265;249;348;165;69;34;1130
515000;Erschleichen von Leistungen § 265a StGB;5711000;Bielefeld;W;422;0;0;0;0;3;3;36;39;75;49;127;38;33;71;69;73;52;25;5;295
515000;Erschleichen von Leistungen § 265a StGB;5711000;Bielefeld;X;1859;0;0;0;1;6;7;77;110;187;240;434;175;161;336;318;421;217;94;39;1425
515000;Erschleichen von Leistungen § 265a StGB;5911000;Bochum;M;1078;0;1;0;1;2;4;6;53;59;153;216;123;100;223;211;240;126;50;12;862
515000;Erschleichen von Leistungen § 265a StGB;5911000;Bochum;W;343;0;0;1;2;7;10;10;21;31;79;120;43;31;74;64;45;26;10;4;223
515000;Erschleichen von Leistungen § 265a StGB;5911000;Bochum;X;1421;0;1;1;3;9;14;16;74;90;232;336;166;131;297;275;285;152;60;16;1085
515000;Erschleichen von Leistungen § 265a StGB;5314000;Bonn;M;1410;0;0;0;0;2;2;21;72;93;239;334;159;152;311;241;290;144;60;30;1076
515000;Erschleichen von Leistungen § 265a StGB;5314000;Bonn;W;594;0;0;0;1;2;3;28;50;78;106;187;77;67;144;81;92;44;32;14;407
515000;Erschleichen von Leistungen § 265a StGB;5314000;Bonn;X;2004;0;0;0;1;4;5;49;122;171;345;521;236;219;455;322;382;188;92;44;1483
515000;Erschleichen von Leistungen § 265a StGB;5512000;Bottrop;M;219;0;0;0;0;0;0;1;5;6;31;37;30;34;64;52;41;15;6;4;182
515000;Erschleichen von Leistungen § 265a StGB;5512000;Bottrop;W;103;0;0;0;0;1;1;2;8;10;24;35;14;14;28;15;17;6;1;1;68
515000;Erschleichen von Leistungen § 265a StGB;5512000;Bottrop;X;322;0;0;0;0;1;1;3;13;16;55;72;44;48;92;67;58;21;7;5;250
515000;Erschleichen von Leistungen § 265a StGB;3101000;Braunschweig;M;1133;0;0;0;0;1;1;13;54;67;210;278;124;120;244;240;232;86;40;13;855
515000;Erschleichen von Leistungen § 265a StGB;3101000;Braunschweig;W;330;0;0;1;0;2;3;16;30;46;63;112;37;37;74;46;43;34;16;5;218
515000;Erschleichen von Leistungen § 265a StGB;3101000;Braunschweig;X;1463;0;0;1;0;3;4;29;84;113;273;390;161;157;318;286;275;120;56;18;1073
515000;Erschleichen von Leistungen § 265a StGB;4011000;Bremen;M;2398;0;0;0;0;10;10;48;103;151;304;465;231;218;449;432;572;305;142;33;1933
515000;Erschleichen von Leistungen § 265a StGB;4011000;Bremen;W;750;0;0;0;0;1;1;31;61;92;124;217;87;71;158;119;126;75;40;15;533
515000;Erschleichen von Leistungen § 265a StGB;4011000;Bremen;X;3148;0;0;0;0;11;11;79;164;243;428;682;318;289;607;551;698;380;182;48;2466
515000;Erschleichen von Leistungen § 265a StGB;4012000;Bremerhaven;M;63;0;0;0;0;0;0;1;1;2;14;16;5;2;7;15;18;4;3;0;47
515000;Erschleichen von Leistungen § 265a StGB;4012000;Bremerhaven;W;18;0;0;0;0;0;0;4;0;4;5;9;3;1;4;1;1;0;2;1;9
515000;Erschleichen von Leistungen § 265a StGB;4012000;Bremerhaven;X;81;0;0;0;0;0;0;5;1;6;19;25;8;3;11;16;19;4;5;1;56
515000;Erschleichen von Leistungen § 265a StGB;14511000;Chemnitz;M;1170;0;0;0;0;0;0;32;56;88;180;268;104;129;233;259;259;84;49;18;902
515000;Erschleichen von Leistungen § 265a StGB;14511000;Chemnitz;W;300;0;0;0;0;1;1;20;23;43;55;99;22;24;46;54;49;20;18;14;201
515000;Erschleichen von Leistungen § 265a StGB;14511000;Chemnitz;X;1470;0;0;0;0;1;1;52;79;131;235;367;126;153;279;313;308;104;67;32;1103
515000;Erschleichen von Leistungen § 265a StGB;6411000;Darmstadt;M;465;0;0;0;0;0;0;5;25;30;60;90;42;53;95;76;111;64;22;7;375
515000;Erschleichen von Leistungen § 265a StGB;6411000;Darmstadt;W;211;0;0;0;0;0;0;7;16;23;34;57;17;10;27;38;50;22;10;7;154
515000;Erschleichen von Leistungen § 265a StGB;6411000;Darmstadt;X;676;0;0;0;0;0;0;12;41;53;94;147;59;63;122;114;161;86;32;14;529
515000;Erschleichen von Leistungen § 265a StGB;5913000;Dortmund;M;3603;0;0;0;2;11;13;76;205;281;534;828;355;358;713;715;765;377;151;54;2775
515000;Erschleichen von Leistungen § 265a StGB;5913000;Dortmund;W;1058;0;1;0;2;20;23;53;75;128;178;329;138;104;242;184;174;96;24;9;729
515000;Erschleichen von Leistungen § 265a StGB;5913000;Dortmund;X;4661;0;1;0;4;31;36;129;280;409;712;1157;493;462;955;899;939;473;175;63;3504
515000;Erschleichen von Leistungen § 265a StGB;14612000;Dresden;M;2397;0;0;0;0;3;3;43;73;116;253;372;204;237;441;596;630;200;118;40;2025
515000;Erschleichen von Leistungen § 265a StGB;14612000;Dresden;W;803;0;0;0;0;1;1;35;57;92;103;196;75;105;180;165;161;51;38;12;607
515000;Erschleichen von Leistungen § 265a StGB;14612000;Dresden;X;3200;0;0;0;0;4;4;78;130;208;356;568;279;342;621;761;791;251;156;52;2632
515000;Erschleichen von Leistungen § 265a StGB;5112000;Duisburg;M;2974;0;0;2;8;23;33;85;133;218;429;680;339;289;628;559;631;324;120;32;2294
515000;Erschleichen von Leistungen § 265a StGB;5112000;Duisburg;W;1177;0;0;0;5;20;25;48;87;135;235;395;143;114;257;189;184;107;35;10;782
515000;Erschleichen von Leistungen § 265a StGB;5112000;Duisburg;X;4151;0;0;2;13;43;58;133;220;353;664;1075;482;403;885;748;815;431;155;42;3076
515000;Erschleichen von Leistungen § 265a StGB;5111000;Düsseldorf;M;2631;0;0;0;0;4;4;25;106;131;354;489;277;269;546;506;614;314;114;48;2142
515000;Erschleichen von Leistungen § 265a StGB;5111000;Düsseldorf;W;962;0;0;0;0;4;4;33;70;103;201;308;123;88;211;159;152;86;36;10;654
515000;Erschleichen von Leistungen § 265a StGB;5111000;Düsseldorf;X;3593;0;0;0;0;8;8;58;176;234;555;797;400;357;757;665;766;400;150;58;2796
515000;Erschleichen von Leistungen § 265a StGB;16051000;Erfurt;M;1074;0;0;0;0;1;1;40;62;102;138;241;106;126;232;228;204;88;52;29;833
515000;Erschleichen von Leistungen § 265a StGB;16051000;Erfurt;W;621;0;0;1;0;0;1;46;37;83;98;182;75;61;136;108;98;55;33;9;439
515000;Erschleichen von Leistungen § 265a StGB;16051000;Erfurt;X;1695;0;0;1;0;1;2;86;99;185;236;423;181;187;368;336;302;143;85;38;1272
515000;Erschleichen von Leistungen § 265a StGB;9562000;Erlangen;M;87;0;0;0;0;0;0;1;3;4;10;14;7;13;20;15;22;10;3;3;73
515000;Erschleichen von Leistungen § 265a StGB;9562000;Erlangen;W;17;0;0;0;0;0;0;0;2;2;9;11;1;1;2;1;0;3;0;0;6
515000;Erschleichen von Leistungen § 265a StGB;9562000;Erlangen;X;104;0;0;0;0;0;0;1;5;6;19;25;8;14;22;16;22;13;3;3;79
515000;Erschleichen von Leistungen § 265a StGB;5113000;Essen;M;3320;0;0;1;1;1;3;80;148;228;465;696;373;330;703;612;712;392;163;42;2624
515000;Erschleichen von Leistungen § 265a StGB;5113000;Essen;W;1366;0;0;0;0;4;4;49;80;129;243;376;148;119;267;251;257;145;52;18;990
515000;Erschleichen von Leistungen § 265a StGB;5113000;Essen;X;4686;0;0;1;1;5;7;129;228;357;708;1072;521;449;970;863;969;537;215;60;3614
515000;Erschleichen von Leistungen § 265a StGB;6412000;Frankfurt am Main;M;5420;0;0;0;0;5;5;80;231;311;565;881;430;493;923;1017;1402;774;337;86;4539
515000;Erschleichen von Leistungen § 265a StGB;6412000;Frankfurt am Main;W;1825;1;0;2;0;5;8;64;132;196;278;482;173;167;340;276;388;234;84;21;1343
515000;Erschleichen von Leistungen § 265a StGB;6412000;Frankfurt am Main;X;7245;1;0;2;0;10;13;144;363;507;843;1363;603;660;1263;1293;1790;1008;421;107;5882
515000;Erschleichen von Leistungen § 265a StGB;8311000;Freiburg im Breisgau;M;1572;0;0;0;0;6;6;62;137;199;253;458;172;140;312;273;310;125;62;32;1114
515000;Erschleichen von Leistungen § 265a StGB;8311000;Freiburg im Breisgau;W;530;0;0;0;1;2;3;28;44;72;89;164;68;40;108;79;93;51;22;13;366
515000;Erschleichen von Leistungen § 265a StGB;8311000;Freiburg im Breisgau;X;2102;0;0;0;1;8;9;90;181;271;342;622;240;180;420;352;403;176;84;45;1480
515000;Erschleichen von Leistungen § 265a StGB;9563000;Fürth;M;179;0;0;0;0;0;0;7;18;25;23;48;15;19;34;32;41;14;7;3;131
515000;Erschleichen von Leistungen § 265a StGB;9563000;Fürth;W;54;0;0;0;0;0;0;5;9;14;12;26;6;4;10;5;6;2;3;2;28
515000;Erschleichen von Leistungen § 265a StGB;9563000;Fürth;X;233;0;0;0;0;0;0;12;27;39;35;74;21;23;44;37;47;16;10;5;159
515000;Erschleichen von Leistungen § 265a StGB;5513000;Gelsenkirchen;M;302;0;0;0;0;4;4;18;18;36;41;81;30;29;59;52;63;31;11;5;221
515000;Erschleichen von Leistungen § 265a StGB;5513000;Gelsenkirchen;W;127;0;0;1;1;2;4;5;8;13;29;46;11;9;20;21;27;8;3;2;81
515000;Erschleichen von Leistungen § 265a StGB;5513000;Gelsenkirchen;X;429;0;0;1;1;6;8;23;26;49;70;127;41;38;79;73;90;39;14;7;302
515000;Erschleichen von Leistungen § 265a StGB;3152012;Göttingen;M;297;0;0;0;0;2;2;2;16;18;42;62;20;27;47;54;70;39;15;10;235
515000;Erschleichen von Leistungen § 265a StGB;3152012;Göttingen;W;71;0;0;0;0;5;5;1;9;10;10;25;7;7;14;8;4;8;3;9;46
515000;Erschleichen von Leistungen § 265a StGB;3152012;Göttingen;X;368;0;0;0;0;7;7;3;25;28;52;87;27;34;61;62;74;47;18;19;281
515000;Erschleichen von Leistungen § 265a StGB;5914000;Hagen;M;540;0;0;0;1;3;4;8;25;33;84;121;63;62;125;107;106;60;18;3;419
515000;Erschleichen von Leistungen § 265a StGB;5914000;Hagen;W;128;0;0;0;1;5;6;4;19;23;27;56;14;10;24;19;18;7;2;2;72
515000;Erschleichen von Leistungen § 265a StGB;5914000;Hagen;X;668;0;0;0;2;8;10;12;44;56;111;177;77;72;149;126;124;67;20;5;491
515000;Erschleichen von Leistungen § 265a StGB;15002000;Halle (Saale);M;637;0;0;1;2;6;9;21;27;48;77;134;54;57;111;141;143;63;34;11;503
515000;Erschleichen von Leistungen § 265a StGB;15002000;Halle (Saale);W;225;0;0;0;2;9;11;8;22;30;38;79;15;15;30;37;39;19;14;7;146
515000;Erschleichen von Leistungen § 265a StGB;15002000;Halle (Saale);X;862;0;0;1;4;15;20;29;49;78;115;213;69;72;141;178;182;82;48;18;649
515000;Erschleichen von Leistungen § 265a StGB;2000000;Hamburg;M;6149;0;0;0;5;45;50;193;388;581;780;1411;510;509;1019;1123;1295;814;376;111;4738
515000;Erschleichen von Leistungen § 265a StGB;2000000;Hamburg;W;1673;0;0;0;2;29;31;116;129;245;224;500;182;141;323;254;304;194;81;17;1173
515000;Erschleichen von Leistungen § 265a StGB;2000000;Hamburg;X;7822;0;0;0;7;74;81;309;517;826;1004;1911;692;650;1342;1377;1599;1008;457;128;5911
515000;Erschleichen von Leistungen § 265a StGB;5915000;Hamm;M;520;0;0;0;0;1;1;7;25;32;92;125;47;62;109;91;122;41;23;9;395
515000;Erschleichen von Leistungen § 265a StGB;5915000;Hamm;W;107;0;0;0;0;6;6;5;10;15;23;44;4;11;15;22;13;8;3;2;63
515000;Erschleichen von Leistungen § 265a StGB;5915000;Hamm;X;627;0;0;0;0;7;7;12;35;47;115;169;51;73;124;113;135;49;26;11;458
515000;Erschleichen von Leistungen § 265a StGB;3241001;Hannover;M;3355;0;0;2;2;11;15;63;176;239;512;766;352;316;668;601;688;385;187;60;2589
515000;Erschleichen von Leistungen § 265a StGB;3241001;Hannover;W;1153;0;0;0;2;11;13;58;86;144;187;344;135;117;252;171;189;120;52;25;809
515000;Erschleichen von Leistungen § 265a StGB;3241001;Hannover;X;4508;0;0;2;4;22;28;121;262;383;699;1110;487;433;920;772;877;505;239;85;3398
515000;Erschleichen von Leistungen § 265a StGB;8221000;Heidelberg;M;612;0;0;0;1;0;1;13;18;31;99;131;65;66;131;115;133;58;34;10;481
515000;Erschleichen von Leistungen § 265a StGB;8221000;Heidelberg;W;335;0;0;0;0;0;0;10;17;27;58;85;55;35;90;55;52;34;12;7;250
515000;Erschleichen von Leistungen § 265a StGB;8221000;Heidelberg;X;947;0;0;0;1;0;1;23;35;58;157;216;120;101;221;170;185;92;46;17;731
515000;Erschleichen von Leistungen § 265a StGB;8121000;Heilbronn;M;268;0;0;0;0;3;3;16;22;38;49;90;25;30;55;42;41;25;11;4;178
515000;Erschleichen von Leistungen § 265a StGB;8121000;Heilbronn;W;72;0;0;0;0;2;2;6;7;13;12;27;6;6;12;8;10;9;5;1;45
515000;Erschleichen von Leistungen § 265a StGB;8121000;Heilbronn;X;340;0;0;0;0;5;5;22;29;51;61;117;31;36;67;50;51;34;16;5;223
515000;Erschleichen von Leistungen § 265a StGB;5916000;Herne;M;266;0;0;0;0;3;3;3;19;22;47;72;34;33;67;47;49;22;8;1;194
515000;Erschleichen von Leistungen § 265a StGB;5916000;Herne;W;75;0;0;0;0;2;2;1;6;7;12;21;8;4;12;12;19;6;5;0;54
515000;Erschleichen von Leistungen § 265a StGB;5916000;Herne;X;341;0;0;0;0;5;5;4;25;29;59;93;42;37;79;59;68;28;13;1;248
515000;Erschleichen von Leistungen § 265a StGB;9161000;Ingolstadt;M;336;0;0;0;0;0;0;8;30;38;50;88;34;29;63;51;67;35;20;12;248
515000;Erschleichen von Leistungen § 265a StGB;9161000;Ingolstadt;W;76;0;0;0;0;0;0;2;6;8;15;23;4;16;20;10;8;8;5;2;53
515000;Erschleichen von Leistungen § 265a StGB;9161000;Ingolstadt;X;412;0;0;0;0;0;0;10;36;46;65;111;38;45;83;61;75;43;25;14;301
515000;Erschleichen von Leistungen § 265a StGB;16053000;Jena;M;249;0;0;0;0;0;0;1;7;8;31;39;29;30;59;57;63;20;8;3;210
515000;Erschleichen von Leistungen § 265a StGB;16053000;Jena;W;65;0;0;0;0;0;0;1;1;2;10;12;10;3;13;13;10;9;5;3;53
515000;Erschleichen von Leistungen § 265a StGB;16053000;Jena;X;314;0;0;0;0;0;0;2;8;10;41;51;39;33;72;70;73;29;13;6;263
515000;Erschleichen von Leistungen § 265a StGB;8212000;Karlsruhe;M;2887;0;1;0;3;5;9;63;148;211;448;668;366;300;666;564;570;247;134;38;2219
515000;Erschleichen von Leistungen § 265a StGB;8212000;Karlsruhe;W;857;0;0;0;0;4;4;49;72;121;162;287;87;80;167;123;150;66;51;13;570
515000;Erschleichen von Leistungen § 265a StGB;8212000;Karlsruhe;X;3744;0;1;0;3;9;13;112;220;332;610;955;453;380;833;687;720;313;185;51;2789
515000;Erschleichen von Leistungen § 265a StGB;6611000;Kassel;M;840;0;1;0;1;1;3;29;46;75;101;179;71;59;130;178;201;81;59;12;661
515000;Erschleichen von Leistungen § 265a StGB;6611000;Kassel;W;332;0;1;0;0;3;4;22;30;52;47;103;39;41;80;40;53;32;17;7;229
515000;Erschleichen von Leistungen § 265a StGB;6611000;Kassel;X;1172;0;2;0;1;4;7;51;76;127;148;282;110;100;210;218;254;113;76;19;890
515000;Erschleichen von Leistungen § 265a StGB;1002000;Kiel;M;242;0;0;0;0;0;0;11;19;30;37;67;18;26;44;39;49;33;7;3;175
515000;Erschleichen von Leistungen § 265a StGB;1002000;Kiel;W;85;0;0;0;0;1;1;3;9;12;8;21;14;12;26;14;9;11;2;2;64
515000;Erschleichen von Leistungen § 265a StGB;1002000;Kiel;X;327;0;0;0;0;1;1;14;28;42;45;88;32;38;70;53;58;44;9;5;239
515000;Erschleichen von Leistungen § 265a StGB;7111000;Koblenz;M;354;0;0;0;0;0;0;9;23;32;50;82;25;43;68;62;82;33;21;6;272
515000;Erschleichen von Leistungen § 265a StGB;7111000;Koblenz;W;98;0;0;0;0;0;0;7;12;19;16;35;13;7;20;8;17;13;2;3;63
515000;Erschleichen von Leistungen § 265a StGB;7111000;Koblenz;X;452;0;0;0;0;0;0;16;35;51;66;117;38;50;88;70;99;46;23;9;335
515000;Erschleichen von Leistungen § 265a StGB;5315000;Köln;M;3740;0;0;0;0;5;5;73;302;375;596;976;434;370;804;678;730;346;166;40;2764
515000;Erschleichen von Leistungen § 265a StGB;5315000;Köln;W;1631;0;0;0;0;3;3;83;189;272;343;618;201;142;343;260;201;130;54;25;1013
515000;Erschleichen von Leistungen § 265a StGB;5315000;Köln;X;5371;0;0;0;0;8;8;156;491;647;939;1594;635;512;1147;938;931;476;220;65;3777
515000;Erschleichen von Leistungen § 265a StGB;5114000;Krefeld;M;906;0;0;0;0;0;0;9;43;52;155;207;100;94;194;180;197;88;29;11;699
515000;Erschleichen von Leistungen § 265a StGB;5114000;Krefeld;W;357;0;0;1;1;1;3;10;33;43;86;132;40;35;75;57;60;24;9;0;225
515000;Erschleichen von Leistungen § 265a StGB;5114000;Krefeld;X;1263;0;0;1;1;1;3;19;76;95;241;339;140;129;269;237;257;112;38;11;924
515000;Erschleichen von Leistungen § 265a StGB;14713000;Leipzig;M;1986;0;0;0;0;1;1;34;53;87;204;292;210;212;422;480;504;177;85;26;1694
515000;Erschleichen von Leistungen § 265a StGB;14713000;Leipzig;W;756;0;0;0;0;2;2;30;31;61;105;168;75;97;172;170;143;59;32;12;588
515000;Erschleichen von Leistungen § 265a StGB;14713000;Leipzig;X;2742;0;0;0;0;3;3;64;84;148;309;460;285;309;594;650;647;236;117;38;2282
515000;Erschleichen von Leistungen § 265a StGB;5316000;Leverkusen;M;411;0;0;0;0;0;0;1;24;25;62;87;46;49;95;92;95;31;8;3;324
515000;Erschleichen von Leistungen § 265a StGB;5316000;Leverkusen;W;162;0;0;0;0;0;0;2;13;15;51;66;22;16;38;19;18;15;4;2;96
515000;Erschleichen von Leistungen § 265a StGB;5316000;Leverkusen;X;573;0;0;0;0;0;0;3;37;40;113;153;68;65;133;111;113;46;12;5;420
515000;Erschleichen von Leistungen § 265a StGB;1003000;Lübeck;M;310;0;0;0;1;1;2;12;21;33;41;76;22;30;52;55;68;28;23;8;234
515000;Erschleichen von Leistungen § 265a StGB;1003000;Lübeck;W;82;0;0;0;0;1;1;7;8;15;15;31;3;7;10;11;18;6;5;1;51
515000;Erschleichen von Leistungen § 265a StGB;1003000;Lübeck;X;392;0;0;0;1;2;3;19;29;48;56;107;25;37;62;66;86;34;28;9;285
515000;Erschleichen von Leistungen § 265a StGB;7314000;Ludwigshafen am Rhein;M;832;0;0;0;0;0;0;17;44;61;124;185;104;90;194;179;163;67;37;7;647
515000;Erschleichen von Leistungen § 265a StGB;7314000;Ludwigshafen am Rhein;W;399;0;0;0;0;2;2;15;34;49;61;112;52;37;89;74;66;42;14;2;287
515000;Erschleichen von Leistungen § 265a StGB;7314000;Ludwigshafen am Rhein;X;1231;0;0;0;0;2;2;32;78;110;185;297;156;127;283;253;229;109;51;9;934
515000;Erschleichen von Leistungen § 265a StGB;15003000;Magdeburg;M;796;0;0;0;2;7;9;49;49;98;134;241;79;65;144;149;133;61;49;19;555
515000;Erschleichen von Leistungen § 265a StGB;15003000;Magdeburg;W;336;0;0;0;3;7;10;42;29;71;58;139;38;29;67;28;41;29;20;12;197
515000;Erschleichen von Leistungen § 265a StGB;15003000;Magdeburg;X;1132;0;0;0;5;14;19;91;78;169;192;380;117;94;211;177;174;90;69;31;752
515000;Erschleichen von Leistungen § 265a StGB;7315000;Mainz;M;1205;0;0;0;0;11;11;27;100;127;200;338;120;123;243;205;218;109;62;30;867
515000;Erschleichen von Leistungen § 265a StGB;7315000;Mainz;W;435;0;0;0;0;7;7;27;45;72;84;163;58;27;85;50;63;42;20;12;272
515000;Erschleichen von Leistungen § 265a StGB;7315000;Mainz;X;1640;0;0;0;0;18;18;54;145;199;284;501;178;150;328;255;281;151;82;42;1139
515000;Erschleichen von Leistungen § 265a StGB;8222000;Mannheim;M;2386;0;0;0;0;9;9;25;107;132;316;457;270;266;536;465;497;262;124;45;1929
515000;Erschleichen von Leistungen § 265a StGB;8222000;Mannheim;W;1106;0;0;0;0;6;6;36;55;91;190;287;123;104;227;197;206;120;58;11;819
515000;Erschleichen von Leistungen § 265a StGB;8222000;Mannheim;X;3492;0;0;0;0;15;15;61;162;223;506;744;393;370;763;662;703;382;182;56;2748
515000;Erschleichen von Leistungen § 265a StGB;5170024;Moers;M;101;0;0;0;0;0;0;0;7;7;28;35;4;10;14;17;22;8;5;0;66
515000;Erschleichen von Leistungen § 265a StGB;5170024;Moers;W;28;0;0;0;0;0;0;1;4;5;8;13;2;2;4;3;5;2;0;1;15
515000;Erschleichen von Leistungen § 265a StGB;5170024;Moers;X;129;0;0;0;0;0;0;1;11;12;36;48;6;12;18;20;27;10;5;1;81
515000;Erschleichen von Leistungen § 265a StGB;5116000;Mönchengladbach;M;685;0;0;0;0;1;1;8;33;41;121;163;67;92;159;144;143;55;17;4;522
515000;Erschleichen von Leistungen § 265a StGB;5116000;Mönchengladbach;W;239;0;0;0;0;3;3;14;24;38;54;95;33;27;60;31;34;16;2;1;144
515000;Erschleichen von Leistungen § 265a StGB;5116000;Mönchengladbach;X;924;0;0;0;0;4;4;22;57;79;175;258;100;119;219;175;177;71;19;5;666
515000;Erschleichen von Leistungen § 265a StGB;5117000;Mülheim an der Ruhr;M;891;0;0;0;0;1;1;11;28;39;113;153;101;100;201;194;188;98;40;17;738
515000;Erschleichen von Leistungen § 265a StGB;5117000;Mülheim an der Ruhr;W;339;0;0;0;0;1;1;10;18;28;61;90;30;35;65;66;63;31;17;7;249
515000;Erschleichen von Leistungen § 265a StGB;5117000;Mülheim an der Ruhr;X;1230;0;0;0;0;2;2;21;46;67;174;243;131;135;266;260;251;129;57;24;987
515000;Erschleichen von Leistungen § 265a StGB;9162000;München;M;2954;0;0;0;0;2;2;32;133;165;437;604;308;312;620;519;658;362;158;33;2350
515000;Erschleichen von Leistungen § 265a StGB;9162000;München;W;1218;0;0;0;1;4;5;22;62;84;225;314;142;97;239;220;234;133;64;14;904
515000;Erschleichen von Leistungen § 265a StGB;9162000;München;X;4172;0;0;0;1;6;7;54;195;249;662;918;450;409;859;739;892;495;222;47;3254
515000;Erschleichen von Leistungen § 265a StGB;5515000;Münster;M;507;0;0;0;0;1;1;17;32;49;77;127;61;50;111;86;110;45;20;8;380
515000;Erschleichen von Leistungen § 265a StGB;5515000;Münster;W;155;0;0;0;0;2;2;10;14;24;34;60;18;12;30;23;22;12;6;2;95
515000;Erschleichen von Leistungen § 265a StGB;5515000;Münster;X;662;0;0;0;0;3;3;27;46;73;111;187;79;62;141;109;132;57;26;10;475
515000;Erschleichen von Leistungen § 265a StGB;5162024;Neuss;M;849;0;0;0;0;1;1;14;26;40;142;183;77;96;173;181;201;69;35;7;666
515000;Erschleichen von Leistungen § 265a StGB;5162024;Neuss;W;331;0;0;0;0;0;0;10;33;43;61;104;40;29;69;71;47;26;10;4;227
515000;Erschleichen von Leistungen § 265a StGB;5162024;Neuss;X;1180;0;0;0;0;1;1;24;59;83;203;287;117;125;242;252;248;95;45;11;893
515000;Erschleichen von Leistungen § 265a StGB;9564000;Nürnberg;M;1682;0;0;0;0;0;0;53;133;186;304;490;165;171;336;298;298;162;80;18;1192
515000;Erschleichen von Leistungen § 265a StGB;9564000;Nürnberg;W;649;0;0;0;0;1;1;53;87;140;135;276;83;54;137;77;81;52;21;5;373
515000;Erschleichen von Leistungen § 265a StGB;9564000;Nürnberg;X;2331;0;0;0;0;1;1;106;220;326;439;766;248;225;473;375;379;214;101;23;1565
515000;Erschleichen von Leistungen § 265a StGB;5119000;Oberhausen;M;446;0;0;0;0;0;0;5;15;20;73;93;49;48;97;83;108;50;15;0;353
515000;Erschleichen von Leistungen § 265a StGB;5119000;Oberhausen;W;162;0;0;0;0;0;0;3;15;18;46;64;27;8;35;24;22;12;5;0;98
515000;Erschleichen von Leistungen § 265a StGB;5119000;Oberhausen;X;608;0;0;0;0;0;0;8;30;38;119;157;76;56;132;107;130;62;20;0;451
515000;Erschleichen von Leistungen § 265a StGB;6413000;Offenbach am Main;M;663;0;0;0;0;3;3;27;51;78;100;181;56;60;116;109;173;61;20;3;482
515000;Erschleichen von Leistungen § 265a StGB;6413000;Offenbach am Main;W;307;0;0;0;0;2;2;16;38;54;71;127;31;12;43;45;56;22;9;5;180
515000;Erschleichen von Leistungen § 265a StGB;6413000;Offenbach am Main;X;970;0;0;0;0;5;5;43;89;132;171;308;87;72;159;154;229;83;29;8;662
515000;Erschleichen von Leistungen § 265a StGB;3403000;Oldenburg (Oldenburg);M;102;0;0;0;0;0;0;3;3;6;15;21;10;12;22;18;24;14;1;2;81
515000;Erschleichen von Leistungen § 265a StGB;3403000;Oldenburg (Oldenburg);W;23;0;0;0;1;0;1;4;3;7;5;13;1;2;3;1;4;2;0;0;10
515000;Erschleichen von Leistungen § 265a StGB;3403000;Oldenburg (Oldenburg);X;125;0;0;0;1;0;1;7;6;13;20;34;11;14;25;19;28;16;1;2;91
515000;Erschleichen von Leistungen § 265a StGB;3404000;Osnabrück;M;354;0;0;0;0;0;0;6;25;31;44;75;37;30;67;84;74;37;12;5;279
515000;Erschleichen von Leistungen § 265a StGB;3404000;Osnabrück;W;100;0;0;0;0;0;0;4;7;11;24;35;16;10;26;13;14;8;2;2;65
515000;Erschleichen von Leistungen § 265a StGB;3404000;Osnabrück;X;454;0;0;0;0;0;0;10;32;42;68;110;53;40;93;97;88;45;14;7;344
515000;Erschleichen von Leistungen § 265a StGB;5774032;Paderborn;M;726;0;0;0;0;2;2;45;111;156;182;340;73;54;127;98;98;47;14;2;386
515000;Erschleichen von Leistungen § 265a StGB;5774032;Paderborn;W;339;0;0;0;0;0;0;45;50;95;82;177;35;18;53;41;42;18;8;0;162
515000;Erschleichen von Leistungen § 265a StGB;5774032;Paderborn;X;1065;0;0;0;0;2;2;90;161;251;264;517;108;72;180;139;140;65;22;2;548
515000;Erschleichen von Leistungen § 265a StGB;8231000;Pforzheim;M;277;0;0;0;5;8;13;12;23;35;37;85;29;24;53;56;45;24;12;2;192
515000;Erschleichen von Leistungen § 265a StGB;8231000;Pforzheim;W;142;0;0;0;0;9;9;22;14;36;21;66;12;14;26;12;21;9;5;3;76
515000;Erschleichen von Leistungen § 265a StGB;8231000;Pforzheim;X;419;0;0;0;5;17;22;34;37;71;58;151;41;38;79;68;66;33;17;5;268
515000;Erschleichen von Leistungen § 265a StGB;12054000;Potsdam;M;133;0;0;0;0;0;0;4;5;9;6;15;8;14;22;20;29;20;19;8;118
515000;Erschleichen von Leistungen § 265a StGB;12054000;Potsdam;W;32;0;0;0;0;2;2;1;3;4;4;10;3;1;4;4;7;4;3;0;22
515000;Erschleichen von Leistungen § 265a StGB;12054000;Potsdam;X;165;0;0;0;0;2;2;5;8;13;10;25;11;15;26;24;36;24;22;8;140
515000;Erschleichen von Leistungen § 265a StGB;5562032;Recklinghausen;M;194;0;0;0;0;2;2;7;18;25;37;64;25;18;43;23;37;15;10;2;130
515000;Erschleichen von Leistungen § 265a StGB;5562032;Recklinghausen;W;78;0;0;0;0;1;1;3;7;10;17;28;4;4;8;20;11;8;2;1;50
515000;Erschleichen von Leistungen § 265a StGB;5562032;Recklinghausen;X;272;0;0;0;0;3;3;10;25;35;54;92;29;22;51;43;48;23;12;3;180
515000;Erschleichen von Leistungen § 265a StGB;9362000;Regensburg;M;572;0;0;0;0;1;1;25;60;85;93;179;70;57;127;83;108;50;18;7;393
515000;Erschleichen von Leistungen § 265a StGB;9362000;Regensburg;W;259;0;0;0;1;1;2;17;38;55;64;121;26;9;35;31;41;18;9;4;138
515000;Erschleichen von Leistungen § 265a StGB;9362000;Regensburg;X;831;0;0;0;1;2;3;42;98;140;157;300;96;66;162;114;149;68;27;11;531
515000;Erschleichen von Leistungen § 265a StGB;5120000;Remscheid;M;35;0;0;0;0;0;0;1;3;4;4;8;3;5;8;7;8;4;0;0;27
515000;Erschleichen von Leistungen § 265a StGB;5120000;Remscheid;W;9;0;0;0;0;0;0;0;2;2;0;2;3;0;3;1;2;0;0;1;7
515000;Erschleichen von Leistungen § 265a StGB;5120000;Remscheid;X;44;0;0;0;0;0;0;1;5;6;4;10;6;5;11;8;10;4;0;1;34
515000;Erschleichen von Leistungen § 265a StGB;8415061;Reutlingen;M;87;0;0;0;0;1;1;6;7;13;15;29;12;6;18;17;14;6;3;0;58
515000;Erschleichen von Leistungen § 265a StGB;8415061;Reutlingen;W;26;0;0;0;0;2;2;1;3;4;7;13;5;1;6;2;1;3;1;0;13
515000;Erschleichen von Leistungen § 265a StGB;8415061;Reutlingen;X;113;0;0;0;0;3;3;7;10;17;22;42;17;7;24;19;15;9;4;0;71
515000;Erschleichen von Leistungen § 265a StGB;13003000;Rostock;M;1154;0;0;0;2;0;2;15;52;67;148;217;123;133;256;262;244;103;58;14;937
515000;Erschleichen von Leistungen § 265a StGB;13003000;Rostock;W;523;0;0;0;1;2;3;13;38;51;84;138;58;58;116;95;68;56;41;9;385
515000;Erschleichen von Leistungen § 265a StGB;13003000;Rostock;X;1677;0;0;0;3;2;5;28;90;118;232;355;181;191;372;357;312;159;99;23;1322
515000;Erschleichen von Leistungen § 265a StGB;10041100;Saarbrücken;M;384;0;0;0;0;4;4;18;33;51;49;104;29;40;69;73;84;37;15;2;280
515000;Erschleichen von Leistungen § 265a StGB;10041100;Saarbrücken;W;85;0;0;0;0;1;1;6;8;14;23;38;8;5;13;9;10;8;4;3;47
515000;Erschleichen von Leistungen § 265a StGB;10041100;Saarbrücken;X;469;0;0;0;0;5;5;24;41;65;72;142;37;45;82;82;94;45;19;5;327
515000;Erschleichen von Leistungen § 265a StGB;5122000;Solingen;M;213;0;0;0;0;1;1;4;6;10;36;47;24;29;53;37;46;22;7;1;166
515000;Erschleichen von Leistungen § 265a StGB;5122000;Solingen;W;67;0;0;0;0;0;0;1;1;2;12;14;3;9;12;11;14;13;1;2;53
515000;Erschleichen von Leistungen § 265a StGB;5122000;Solingen;X;280;0;0;0;0;1;1;5;7;12;48;61;27;38;65;48;60;35;8;3;219
515000;Erschleichen von Leistungen § 265a StGB;8111000;Stuttgart;M;4218;0;0;0;0;4;4;74;247;321;629;954;442;400;842;753;839;476;252;102;3264
515000;Erschleichen von Leistungen § 265a StGB;8111000;Stuttgart;W;1633;0;0;0;1;1;2;74;135;209;313;524;195;147;342;265;244;149;80;29;1109
515000;Erschleichen von Leistungen § 265a StGB;8111000;Stuttgart;X;5851;0;0;0;1;5;6;148;382;530;942;1478;637;547;1184;1018;1083;625;332;131;4373
515000;Erschleichen von Leistungen § 265a StGB;7211000;Trier;M;75;0;0;0;0;1;1;0;3;3;13;17;11;10;21;14;13;6;3;1;58
515000;Erschleichen von Leistungen § 265a StGB;7211000;Trier;W;27;0;0;0;0;0;0;0;4;4;2;6;6;1;7;4;2;3;2;3;21
515000;Erschleichen von Leistungen § 265a StGB;7211000;Trier;X;102;0;0;0;0;1;1;0;7;7;15;23;17;11;28;18;15;9;5;4;79
515000;Erschleichen von Leistungen § 265a StGB;8421000;Ulm;M;734;0;0;1;2;8;11;22;62;84;110;205;57;73;130;129;154;64;37;15;529
515000;Erschleichen von Leistungen § 265a StGB;8421000;Ulm;W;233;0;0;0;1;7;8;18;25;43;56;107;23;11;34;20;37;20;12;3;126
515000;Erschleichen von Leistungen § 265a StGB;8421000;Ulm;X;967;0;0;1;3;15;19;40;87;127;166;312;80;84;164;149;191;84;49;18;655
515000;Erschleichen von Leistungen § 265a StGB;6414000;Wiesbaden;M;642;0;0;0;1;1;2;26;39;65;106;173;57;49;106;92;142;79;38;12;469
515000;Erschleichen von Leistungen § 265a StGB;6414000;Wiesbaden;W;286;0;1;0;0;0;1;23;25;48;47;96;31;23;54;39;55;19;12;11;190
515000;Erschleichen von Leistungen § 265a StGB;6414000;Wiesbaden;X;928;0;1;0;1;1;3;49;64;113;153;269;88;72;160;131;197;98;50;23;659
515000;Erschleichen von Leistungen § 265a StGB;3103000;Wolfsburg;M;189;0;0;0;1;4;5;6;8;14;22;41;16;16;32;34;38;16;18;10;148
515000;Erschleichen von Leistungen § 265a StGB;3103000;Wolfsburg;W;44;0;0;0;0;0;0;1;5;6;10;16;5;3;8;4;6;6;3;1;28
515000;Erschleichen von Leistungen § 265a StGB;3103000;Wolfsburg;X;233;0;0;0;1;4;5;7;13;20;32;57;21;19;40;38;44;22;21;11;176
515000;Erschleichen von Leistungen § 265a StGB;5124000;Wuppertal;M;1175;0;0;0;2;8;10;38;53;91;200;301;123;111;234;212;249;109;51;19;874
515000;Erschleichen von Leistungen § 265a StGB;5124000;Wuppertal;W;458;0;0;0;1;7;8;46;43;89;87;184;43;45;88;57;65;35;16;13;274
515000;Erschleichen von Leistungen § 265a StGB;5124000;Wuppertal;X;1633;0;0;0;3;15;18;84;96;180;287;485;166;156;322;269;314;144;67;32;1148
515000;Erschleichen von Leistungen § 265a StGB;9663000;Würzburg;M;525;0;0;0;1;1;2;11;31;42;51;95;40;39;79;95;143;66;33;14;430
515000;Erschleichen von Leistungen § 265a StGB;9663000;Würzburg;W;125;0;0;0;0;2;2;7;8;15;30;47;15;8;23;18;20;7;8;2;78
515000;Erschleichen von Leistungen § 265a StGB;9663000;Würzburg;X;650;0;0;0;1;3;4;18;39;57;81;142;55;47;102;113;163;73;41;16;508
515001;Beförderungserschleichung;5334002;Aachen;M;514;0;0;0;0;0;0;27;63;90;132;222;49;28;77;76;88;30;12;9;292
515001;Beförderungserschleichung;5334002;Aachen;W;213;0;0;0;0;2;2;24;40;64;58;124;15;9;24;18;23;15;8;1;89
515001;Beförderungserschleichung;5334002;Aachen;X;727;0;0;0;0;2;2;51;103;154;190;346;64;37;101;94;111;45;20;10;381
515001;Beförderungserschleichung;9761000;Augsburg;M;1094;0;0;0;1;2;3;43;91;134;199;336;99;96;195;186;219;88;51;19;758
515001;Beförderungserschleichung;9761000;Augsburg;W;412;0;0;0;0;1;1;33;45;78;75;154;33;41;74;54;71;33;18;8;258
515001;Beförderungserschleichung;9761000;Augsburg;X;1506;0;0;0;1;3;4;76;136;212;274;490;132;137;269;240;290;121;69;27;1016
515001;Beförderungserschleichung;5378004;Bergisch Gladbach;M;96;0;0;0;0;1;1;4;5;9;15;25;11;8;19;15;18;11;7;1;71
515001;Beförderungserschleichung;5378004;Bergisch Gladbach;W;37;0;0;0;0;0;0;1;8;9;8;17;2;2;4;6;4;3;2;1;20
515001;Beförderungserschleichung;5378004;Bergisch Gladbach;X;133;0;0;0;0;1;1;5;13;18;23;42;13;10;23;21;22;14;9;2;91
515001;Beförderungserschleichung;11000000;Berlin;M;17511;2;0;0;3;27;32;235;675;910;1711;2653;1436;1641;3077;3673;4620;2169;1042;277;14858
515001;Beförderungserschleichung;11000000;Berlin;W;7672;0;0;1;2;19;22;179;462;641;1120;1783;773;793;1566;1500;1554;801;373;95;5889
515001;Beförderungserschleichung;11000000;Berlin;X;25183;2;0;1;5;46;54;414;1137;1551;2831;4436;2209;2434;4643;5173;6174;2970;1415;372;20747
515001;Beförderungserschleichung;5711000;Bielefeld;M;1430;0;0;0;1;3;4;41;69;110;191;305;137;128;265;248;345;164;69;34;1125
515001;Beförderungserschleichung;5711000;Bielefeld;W;422;0;0;0;0;3;3;36;39;75;49;127;38;33;71;69;73;52;25;5;295
515001;Beförderungserschleichung;5711000;Bielefeld;X;1852;0;0;0;1;6;7;77;108;185;240;432;175;161;336;317;418;216;94;39;1420
515001;Beförderungserschleichung;5911000;Bochum;M;1042;0;1;0;1;1;3;6;47;53;147;203;117;100;217;205;233;125;47;12;839
515001;Beförderungserschleichung;5911000;Bochum;W;324;0;0;1;2;6;9;8;20;28;77;114;41;30;71;60;42;23;10;4;210
515001;Beförderungserschleichung;5911000;Bochum;X;1366;0;1;1;3;7;12;14;67;81;224;317;158;130;288;265;275;148;57;16;1049
515001;Beförderungserschleichung;5314000;Bonn;M;1379;0;0;0;0;2;2;19;67;86;235;323;156;147;303;239;283;142;59;30;1056
515001;Beförderungserschleichung;5314000;Bonn;W;575;0;0;0;1;1;2;26;47;73;104;179;76;65;141;80;87;43;31;14;396
515001;Beförderungserschleichung;5314000;Bonn;X;1954;0;0;0;1;3;4;45;114;159;339;502;232;212;444;319;370;185;90;44;1452
515001;Beförderungserschleichung;5512000;Bottrop;M;217;0;0;0;0;0;0;1;5;6;31;37;30;33;63;52;41;14;6;4;180
515001;Beförderungserschleichung;5512000;Bottrop;W;102;0;0;0;0;1;1;2;8;10;24;35;14;14;28;15;16;6;1;1;67
515001;Beförderungserschleichung;5512000;Bottrop;X;319;0;0;0;0;1;1;3;13;16;55;72;44;47;91;67;57;20;7;5;247
515001;Beförderungserschleichung;3101000;Braunschweig;M;1132;0;0;0;0;1;1;13;54;67;210;278;123;120;243;240;232;86;40;13;854
515001;Beförderungserschleichung;3101000;Braunschweig;W;329;0;0;1;0;2;3;16;29;45;63;111;37;37;74;46;43;34;16;5;218
515001;Beförderungserschleichung;3101000;Braunschweig;X;1461;0;0;1;0;3;4;29;83;112;273;389;160;157;317;286;275;120;56;18;1072
515001;Beförderungserschleichung;4011000;Bremen;M;2383;0;0;0;0;10;10;47;99;146;303;459;229;216;445;432;567;305;142;33;1924
515001;Beförderungserschleichung;4011000;Bremen;W;746;0;0;0;0;0;0;30;60;90;124;214;86;71;157;119;126;75;40;15;532
515001;Beförderungserschleichung;4011000;Bremen;X;3129;0;0;0;0;10;10;77;159;236;427;673;315;287;602;551;693;380;182;48;2456
515001;Beförderungserschleichung;4012000;Bremerhaven;M;63;0;0;0;0;0;0;1;1;2;14;16;5;2;7;15;18;4;3;0;47
515001;Beförderungserschleichung;4012000;Bremerhaven;W;18;0;0;0;0;0;0;4;0;4;5;9;3;1;4;1;1;0;2;1;9
515001;Beförderungserschleichung;4012000;Bremerhaven;X;81;0;0;0;0;0;0;5;1;6;19;25;8;3;11;16;19;4;5;1;56
515001;Beförderungserschleichung;14511000;Chemnitz;M;1170;0;0;0;0;0;0;32;56;88;180;268;104;129;233;259;259;84;49;18;902
515001;Beförderungserschleichung;14511000;Chemnitz;W;300;0;0;0;0;1;1;20;23;43;55;99;22;24;46;54;49;20;18;14;201
515001;Beförderungserschleichung;14511000;Chemnitz;X;1470;0;0;0;0;1;1;52;79;131;235;367;126;153;279;313;308;104;67;32;1103
515001;Beförderungserschleichung;6411000;Darmstadt;M;460;0;0;0;0;0;0;5;25;30;60;90;42;50;92;75;110;64;22;7;370
515001;Beförderungserschleichung;6411000;Darmstadt;W;211;0;0;0;0;0;0;7;16;23;34;57;17;10;27;38;50;22;10;7;154
515001;Beförderungserschleichung;6411000;Darmstadt;X;671;0;0;0;0;0;0;12;41;53;94;147;59;60;119;113;160;86;32;14;524
515001;Beförderungserschleichung;5913000;Dortmund;M;3579;0;0;0;2;11;13;76;203;279;525;817;354;356;710;715;761;374;150;52;2762
515001;Beförderungserschleichung;5913000;Dortmund;W;1050;0;1;0;2;20;23;52;74;126;177;326;137;104;241;182;173;95;24;9;724
515001;Beförderungserschleichung;5913000;Dortmund;X;4629;0;1;0;4;31;36;128;277;405;702;1143;491;460;951;897;934;469;174;61;3486
515001;Beförderungserschleichung;14612000;Dresden;M;2392;0;0;0;0;3;3;42;73;115;252;370;203;237;440;595;630;200;118;39;2022
515001;Beförderungserschleichung;14612000;Dresden;W;802;0;0;0;0;1;1;35;56;91;103;195;75;105;180;165;161;51;38;12;607
515001;Beförderungserschleichung;14612000;Dresden;X;3194;0;0;0;0;4;4;77;129;206;355;565;278;342;620;760;791;251;156;51;2629
515001;Beförderungserschleichung;5112000;Duisburg;M;2926;0;0;1;5;20;26;83;127;210;421;657;333;286;619;550;628;324;117;31;2269
515001;Beförderungserschleichung;5112000;Duisburg;W;1156;0;0;0;4;17;21;45;85;130;234;385;142;112;254;189;180;105;34;9;771
515001;Beförderungserschleichung;5112000;Duisburg;X;4082;0;0;1;9;37;47;128;212;340;655;1042;475;398;873;739;808;429;151;40;3040
515001;Beförderungserschleichung;5111000;Düsseldorf;M;2623;0;0;0;0;4;4;25;105;130;353;487;277;269;546;504;612;312;114;48;2136
515001;Beförderungserschleichung;5111000;Düsseldorf;W;957;0;0;0;0;4;4;31;70;101;200;305;122;88;210;158;152;86;36;10;652
515001;Beförderungserschleichung;5111000;Düsseldorf;X;3580;0;0;0;0;8;8;56;175;231;553;792;399;357;756;662;764;398;150;58;2788
515001;Beförderungserschleichung;16051000;Erfurt;M;1071;0;0;0;0;1;1;40;62;102;137;240;106;125;231;228;204;88;52;28;831
515001;Beförderungserschleichung;16051000;Erfurt;W;618;0;0;1;0;0;1;46;37;83;98;182;75;60;135;108;97;54;33;9;436
515001;Beförderungserschleichung;16051000;Erfurt;X;1689;0;0;1;0;1;2;86;99;185;235;422;181;185;366;336;301;142;85;37;1267
515001;Beförderungserschleichung;9562000;Erlangen;M;87;0;0;0;0;0;0;1;3;4;10;14;7;13;20;15;22;10;3;3;73
515001;Beförderungserschleichung;9562000;Erlangen;W;17;0;0;0;0;0;0;0;2;2;9;11;1;1;2;1;0;3;0;0;6
515001;Beförderungserschleichung;9562000;Erlangen;X;104;0;0;0;0;0;0;1;5;6;19;25;8;14;22;16;22;13;3;3;79
515001;Beförderungserschleichung;5113000;Essen;M;3304;0;0;1;1;1;3;79;146;225;461;689;372;330;702;611;707;392;162;41;2615
515001;Beförderungserschleichung;5113000;Essen;W;1365;0;0;0;0;4;4;49;80;129;243;376;148;119;267;251;256;145;52;18;989
515001;Beförderungserschleichung;5113000;Essen;X;4669;0;0;1;1;5;7;128;226;354;704;1065;520;449;969;862;963;537;214;59;3604
515001;Beförderungserschleichung;6412000;Frankfurt am Main;M;5403;0;0;0;0;5;5;80;229;309;562;876;429;492;921;1013;1400;771;336;86;4527
515001;Beförderungserschleichung;6412000;Frankfurt am Main;W;1821;1;0;2;0;5;8;64;132;196;277;481;172;167;339;276;387;233;84;21;1340
515001;Beförderungserschleichung;6412000;Frankfurt am Main;X;7224;1;0;2;0;10;13;144;361;505;839;1357;601;659;1260;1289;1787;1004;420;107;5867
515001;Beförderungserschleichung;8311000;Freiburg im Breisgau;M;1563;0;0;0;0;6;6;62;134;196;253;455;169;140;309;273;309;125;61;31;1108
515001;Beförderungserschleichung;8311000;Freiburg im Breisgau;W;525;0;0;0;1;1;2;28;44;72;89;163;68;39;107;78;91;51;22;13;362
515001;Beförderungserschleichung;8311000;Freiburg im Breisgau;X;2088;0;0;0;1;7;8;90;178;268;342;618;237;179;416;351;400;176;83;44;1470
515001;Beförderungserschleichung;9563000;Fürth;M;176;0;0;0;0;0;0;5;18;23;23;46;15;19;34;32;40;14;7;3;130
515001;Beförderungserschleichung;9563000;Fürth;W;54;0;0;0;0;0;0;5;9;14;12;26;6;4;10;5;6;2;3;2;28
515001;Beförderungserschleichung;9563000;Fürth;X;230;0;0;0;0;0;0;10;27;37;35;72;21;23;44;37;46;16;10;5;158
515001;Beförderungserschleichung;5513000;Gelsenkirchen;M;283;0;0;0;0;4;4;18;18;36;39;79;28;24;52;50;60;29;9;4;204
515001;Beförderungserschleichung;5513000;Gelsenkirchen;W;122;0;0;1;1;2;4;5;6;11;29;44;11;9;20;21;24;8;3;2;78
515001;Beförderungserschleichung;5513000;Gelsenkirchen;X;405;0;0;1;1;6;8;23;24;47;68;123;39;33;72;71;84;37;12;6;282
515001;Beförderungserschleichung;3152012;Göttingen;M;296;0;0;0;0;2;2;2;16;18;42;62;20;26;46;54;70;39;15;10;234
515001;Beförderungserschleichung;3152012;Göttingen;W;71;0;0;0;0;5;5;1;9;10;10;25;7;7;14;8;4;8;3;9;46
515001;Beförderungserschleichung;3152012;Göttingen;X;367;0;0;0;0;7;7;3;25;28;52;87;27;33;60;62;74;47;18;19;280
515001;Beförderungserschleichung;5914000;Hagen;M;528;0;0;0;1;3;4;8;25;33;82;119;63;61;124;106;102;59;15;3;409
515001;Beförderungserschleichung;5914000;Hagen;W;126;0;0;0;0;5;5;4;19;23;27;55;14;10;24;19;18;7;2;1;71
515001;Beförderungserschleichung;5914000;Hagen;X;654;0;0;0;1;8;9;12;44;56;109;174;77;71;148;125;120;66;17;4;480
515001;Beförderungserschleichung;15002000;Halle (Saale);M;619;0;0;1;2;6;9;21;27;48;77;134;53;56;109;137;140;58;31;10;485
515001;Beförderungserschleichung;15002000;Halle (Saale);W;216;0;0;0;2;9;11;8;21;29;38;78;15;14;29;36;36;17;14;6;138
515001;Beförderungserschleichung;15002000;Halle (Saale);X;835;0;0;1;4;15;20;29;48;77;115;212;68;70;138;173;176;75;45;16;623
515001;Beförderungserschleichung;2000000;Hamburg;M;6027;0;0;0;5;42;47;186;375;561;757;1365;503;497;1000;1098;1276;807;373;108;4662
515001;Beförderungserschleichung;2000000;Hamburg;W;1639;0;0;0;2;23;25;114;128;242;218;485;180;139;319;245;301;192;81;16;1154
515001;Beförderungserschleichung;2000000;Hamburg;X;7666;0;0;0;7;65;72;300;503;803;975;1850;683;636;1319;1343;1577;999;454;124;5816
515001;Beförderungserschleichung;5915000;Hamm;M;510;0;0;0;0;1;1;7;25;32;88;121;47;62;109;90;119;40;23;8;389
515001;Beförderungserschleichung;5915000;Hamm;W;102;0;0;0;0;6;6;5;10;15;21;42;3;11;14;20;13;8;3;2;60
515001;Beförderungserschleichung;5915000;Hamm;X;612;0;0;0;0;7;7;12;35;47;109;163;50;73;123;110;132;48;26;10;449
515001;Beförderungserschleichung;3241001;Hannover;M;3347;0;0;2;2;11;15;63;176;239;510;764;352;316;668;600;685;385;187;58;2583
515001;Beförderungserschleichung;3241001;Hannover;W;1151;0;0;0;2;11;13;58;86;144;187;344;135;117;252;170;189;119;52;25;807
515001;Beförderungserschleichung;3241001;Hannover;X;4498;0;0;2;4;22;28;121;262;383;697;1108;487;433;920;770;874;504;239;83;3390
515001;Beförderungserschleichung;8221000;Heidelberg;M;609;0;0;0;1;0;1;13;18;31;99;131;65;65;130;114;133;57;34;10;478
515001;Beförderungserschleichung;8221000;Heidelberg;W;334;0;0;0;0;0;0;10;16;26;58;84;55;35;90;55;52;34;12;7;250
515001;Beförderungserschleichung;8221000;Heidelberg;X;943;0;0;0;1;0;1;23;34;57;157;215;120;100;220;169;185;91;46;17;728
515001;Beförderungserschleichung;8121000;Heilbronn;M;267;0;0;0;0;3;3;16;22;38;49;90;25;30;55;42;41;24;11;4;177
515001;Beförderungserschleichung;8121000;Heilbronn;W;72;0;0;0;0;2;2;6;7;13;12;27;6;6;12;8;10;9;5;1;45
515001;Beförderungserschleichung;8121000;Heilbronn;X;339;0;0;0;0;5;5;22;29;51;61;117;31;36;67;50;51;33;16;5;222
515001;Beförderungserschleichung;5916000;Herne;M;238;0;0;0;0;2;2;0;17;17;43;62;30;30;60;43;43;22;7;1;176
515001;Beförderungserschleichung;5916000;Herne;W;72;0;0;0;0;2;2;1;6;7;11;20;7;4;11;12;18;6;5;0;52
515001;Beförderungserschleichung;5916000;Herne;X;310;0;0;0;0;4;4;1;23;24;54;82;37;34;71;55;61;28;12;1;228
515001;Beförderungserschleichung;9161000;Ingolstadt;M;334;0;0;0;0;0;0;8;30;38;49;87;34;29;63;50;67;35;20;12;247
515001;Beförderungserschleichung;9161000;Ingolstadt;W;76;0;0;0;0;0;0;2;6;8;15;23;4;16;20;10;8;8;5;2;53
515001;Beförderungserschleichung;9161000;Ingolstadt;X;410;0;0;0;0;0;0;10;36;46;64;110;38;45;83;60;75;43;25;14;300
515001;Beförderungserschleichung;16053000;Jena;M;243;0;0;0;0;0;0;1;7;8;27;35;29;29;58;57;63;20;7;3;208
515001;Beförderungserschleichung;16053000;Jena;W;65;0;0;0;0;0;0;1;1;2;10;12;10;3;13;13;10;9;5;3;53
515001;Beförderungserschleichung;16053000;Jena;X;308;0;0;0;0;0;0;2;8;10;37;47;39;32;71;70;73;29;12;6;261
515001;Beförderungserschleichung;8212000;Karlsruhe;M;2878;0;1;0;3;5;9;62;148;210;449;668;365;298;663;561;568;247;133;38;2210
515001;Beförderungserschleichung;8212000;Karlsruhe;W;855;0;0;0;0;4;4;49;71;120;162;286;87;80;167;122;150;66;51;13;569
515001;Beförderungserschleichung;8212000;Karlsruhe;X;3733;0;1;0;3;9;13;111;219;330;611;954;452;378;830;683;718;313;184;51;2779
515001;Beförderungserschleichung;6611000;Kassel;M;839;0;1;0;1;1;3;29;46;75;101;179;71;59;130;178;200;81;59;12;660
515001;Beförderungserschleichung;6611000;Kassel;W;332;0;1;0;0;3;4;22;30;52;47;103;39;41;80;40;53;32;17;7;229
515001;Beförderungserschleichung;6611000;Kassel;X;1171;0;2;0;1;4;7;51;76;127;148;282;110;100;210;218;253;113;76;19;889
515001;Beförderungserschleichung;1002000;Kiel;M;233;0;0;0;0;0;0;11;19;30;36;66;18;25;43;37;46;33;6;2;167
515001;Beförderungserschleichung;1002000;Kiel;W;82;0;0;0;0;1;1;2;9;11;8;20;13;12;25;13;9;11;2;2;62
515001;Beförderungserschleichung;1002000;Kiel;X;315;0;0;0;0;1;1;13;28;41;44;86;31;37;68;50;55;44;8;4;229
515001;Beförderungserschleichung;7111000;Koblenz;M;351;0;0;0;0;0;0;9;23;32;50;82;24;43;67;62;82;31;21;6;269
515001;Beförderungserschleichung;7111000;Koblenz;W;98;0;0;0;0;0;0;7;12;19;16;35;13;7;20;8;17;13;2;3;63
515001;Beförderungserschleichung;7111000;Koblenz;X;449;0;0;0;0;0;0;16;35;51;66;117;37;50;87;70;99;44;23;9;332
515001;Beförderungserschleichung;5315000;Köln;M;3700;0;0;0;0;5;5;70;284;354;594;953;431;370;801;673;729;341;163;40;2747
515001;Beförderungserschleichung;5315000;Köln;W;1586;0;0;0;0;2;2;73;172;245;338;585;200;142;342;258;197;126;54;24;1001
515001;Beförderungserschleichung;5315000;Köln;X;5286;0;0;0;0;7;7;143;456;599;932;1538;631;512;1143;931;926;467;217;64;3748
515001;Beförderungserschleichung;5114000;Krefeld;M;857;0;0;0;0;0;0;7;39;46;146;192;96;91;187;169;190;84;27;8;665
515001;Beförderungserschleichung;5114000;Krefeld;W;333;0;0;0;0;0;0;9;27;36;81;117;40;35;75;55;55;23;8;0;216
515001;Beförderungserschleichung;5114000;Krefeld;X;1190;0;0;0;0;0;0;16;66;82;227;309;136;126;262;224;245;107;35;8;881
515001;Beförderungserschleichung;14713000;Leipzig;M;1984;0;0;0;0;1;1;34;53;87;204;292;210;212;422;479;504;176;85;26;1692
515001;Beförderungserschleichung;14713000;Leipzig;W;755;0;0;0;0;2;2;30;31;61;104;167;75;97;172;170;143;59;32;12;588
515001;Beförderungserschleichung;14713000;Leipzig;X;2739;0;0;0;0;3;3;64;84;148;308;459;285;309;594;649;647;235;117;38;2280
515001;Beförderungserschleichung;5316000;Leverkusen;M;397;0;0;0;0;0;0;1;23;24;61;85;45;48;93;86;93;31;6;3;312
515001;Beförderungserschleichung;5316000;Leverkusen;W;161;0;0;0;0;0;0;2;12;14;51;65;22;16;38;19;18;15;4;2;96
515001;Beförderungserschleichung;5316000;Leverkusen;X;558;0;0;0;0;0;0;3;35;38;112;150;67;64;131;105;111;46;10;5;408
515001;Beförderungserschleichung;1003000;Lübeck;M;310;0;0;0;1;1;2;12;21;33;41;76;22;30;52;55;68;28;23;8;234
515001;Beförderungserschleichung;1003000;Lübeck;W;81;0;0;0;0;1;1;7;8;15;14;30;3;7;10;11;18;6;5;1;51
515001;Beförderungserschleichung;1003000;Lübeck;X;391;0;0;0;1;2;3;19;29;48;55;106;25;37;62;66;86;34;28;9;285
515001;Beförderungserschleichung;7314000;Ludwigshafen am Rhein;M;828;0;0;0;0;0;0;15;43;58;123;181;104;90;194;179;163;67;37;7;647
515001;Beförderungserschleichung;7314000;Ludwigshafen am Rhein;W;399;0;0;0;0;2;2;15;34;49;61;112;52;37;89;74;66;42;14;2;287
515001;Beförderungserschleichung;7314000;Ludwigshafen am Rhein;X;1227;0;0;0;0;2;2;30;77;107;184;293;156;127;283;253;229;109;51;9;934
515001;Beförderungserschleichung;15003000;Magdeburg;M;794;0;0;0;2;7;9;49;49;98;134;241;79;65;144;148;133;61;49;18;553
515001;Beförderungserschleichung;15003000;Magdeburg;W;336;0;0;0;3;7;10;42;29;71;58;139;38;29;67;28;41;29;20;12;197
515001;Beförderungserschleichung;15003000;Magdeburg;X;1130;0;0;0;5;14;19;91;78;169;192;380;117;94;211;176;174;90;69;30;750
515001;Beförderungserschleichung;7315000;Mainz;M;1200;0;0;0;0;11;11;27;100;127;200;338;119;122;241;204;217;109;62;29;862
515001;Beförderungserschleichung;7315000;Mainz;W;433;0;0;0;0;7;7;27;45;72;84;163;58;27;85;50;62;41;20;12;270
515001;Beförderungserschleichung;7315000;Mainz;X;1633;0;0;0;0;18;18;54;145;199;284;501;177;149;326;254;279;150;82;41;1132
515001;Beförderungserschleichung;8222000;Mannheim;M;2380;0;0;0;0;9;9;25;107;132;316;457;268;266;534;463;496;261;124;45;1923
515001;Beförderungserschleichung;8222000;Mannheim;W;1104;0;0;0;0;6;6;36;55;91;190;287;123;104;227;197;204;120;58;11;817
515001;Beförderungserschleichung;8222000;Mannheim;X;3484;0;0;0;0;15;15;61;162;223;506;744;391;370;761;660;700;381;182;56;2740
515001;Beförderungserschleichung;5170024;Moers;M;99;0;0;0;0;0;0;0;7;7;28;35;4;10;14;17;21;7;5;0;64
515001;Beförderungserschleichung;5170024;Moers;W;28;0;0;0;0;0;0;1;4;5;8;13;2;2;4;3;5;2;0;1;15
515001;Beförderungserschleichung;5170024;Moers;X;127;0;0;0;0;0;0;1;11;12;36;48;6;12;18;20;26;9;5;1;79
515001;Beförderungserschleichung;5116000;Mönchengladbach;M;673;0;0;0;0;1;1;8;33;41;120;162;66;90;156;139;141;54;17;4;511
515001;Beförderungserschleichung;5116000;Mönchengladbach;W;234;0;0;0;0;3;3;12;22;34;54;91;33;27;60;31;33;16;2;1;143
515001;Beförderungserschleichung;5116000;Mönchengladbach;X;907;0;0;0;0;4;4;20;55;75;174;253;99;117;216;170;174;70;19;5;654
515001;Beförderungserschleichung;5117000;Mülheim an der Ruhr;M;878;0;0;0;0;1;1;11;28;39;112;152;100;98;198;192;186;96;37;17;726
515001;Beförderungserschleichung;5117000;Mülheim an der Ruhr;W;336;0;0;0;0;1;1;9;18;27;61;89;30;35;65;66;61;31;17;7;247
515001;Beförderungserschleichung;5117000;Mülheim an der Ruhr;X;1214;0;0;0;0;2;2;20;46;66;173;241;130;133;263;258;247;127;54;24;973
515001;Beförderungserschleichung;9162000;München;M;2913;0;0;0;0;1;1;31;129;160;433;594;304;308;612;511;651;356;156;33;2319
515001;Beförderungserschleichung;9162000;München;W;1207;0;0;0;1;4;5;22;58;80;221;306;141;97;238;220;232;133;64;14;901
515001;Beförderungserschleichung;9162000;München;X;4120;0;0;0;1;5;6;53;187;240;654;900;445;405;850;731;883;489;220;47;3220
515001;Beförderungserschleichung;5515000;Münster;M;493;0;0;0;0;1;1;16;32;48;73;122;58;50;108;82;110;45;18;8;371
515001;Beförderungserschleichung;5515000;Münster;W;151;0;0;0;0;1;1;9;14;23;34;58;17;11;28;23;22;12;6;2;93
515001;Beförderungserschleichung;5515000;Münster;X;644;0;0;0;0;2;2;25;46;71;107;180;75;61;136;105;132;57;24;10;464
515001;Beförderungserschleichung;5162024;Neuss;M;849;0;0;0;0;1;1;14;26;40;142;183;77;96;173;181;201;69;35;7;666
515001;Beförderungserschleichung;5162024;Neuss;W;327;0;0;0;0;0;0;10;32;42;60;102;40;29;69;70;46;26;10;4;225
515001;Beförderungserschleichung;5162024;Neuss;X;1176;0;0;0;0;1;1;24;58;82;202;285;117;125;242;251;247;95;45;11;891
515001;Beförderungserschleichung;9564000;Nürnberg;M;1665;0;0;0;0;0;0;52;132;184;301;485;163;167;330;295;297;161;79;18;1180
515001;Beförderungserschleichung;9564000;Nürnberg;W;646;0;0;0;0;1;1;53;86;139;134;274;83;54;137;77;81;51;21;5;372
515001;Beförderungserschleichung;9564000;Nürnberg;X;2311;0;0;0;0;1;1;105;218;323;435;759;246;221;467;372;378;212;100;23;1552
515001;Beförderungserschleichung;5119000;Oberhausen;M;437;0;0;0;0;0;0;5;15;20;73;93;47;47;94;83;105;48;14;0;344
515001;Beförderungserschleichung;5119000;Oberhausen;W;162;0;0;0;0;0;0;3;15;18;46;64;27;8;35;24;22;12;5;0;98
515001;Beförderungserschleichung;5119000;Oberhausen;X;599;0;0;0;0;0;0;8;30;38;119;157;74;55;129;107;127;60;19;0;442
515001;Beförderungserschleichung;6413000;Offenbach am Main;M;663;0;0;0;0;3;3;27;51;78;100;181;56;60;116;109;173;61;20;3;482
515001;Beförderungserschleichung;6413000;Offenbach am Main;W;306;0;0;0;0;2;2;16;38;54;70;126;31;12;43;45;56;22;9;5;180
515001;Beförderungserschleichung;6413000;Offenbach am Main;X;969;0;0;0;0;5;5;43;89;132;170;307;87;72;159;154;229;83;29;8;662
515001;Beförderungserschleichung;3403000;Oldenburg (Oldenburg);M;102;0;0;0;0;0;0;3;3;6;15;21;10;12;22;18;24;14;1;2;81
515001;Beförderungserschleichung;3403000;Oldenburg (Oldenburg);W;23;0;0;0;1;0;1;4;3;7;5;13;1;2;3;1;4;2;0;0;10
515001;Beförderungserschleichung;3403000;Oldenburg (Oldenburg);X;125;0;0;0;1;0;1;7;6;13;20;34;11;14;25;19;28;16;1;2;91
515001;Beförderungserschleichung;3404000;Osnabrück;M;353;0;0;0;0;0;0;6;25;31;43;74;37;30;67;84;74;37;12;5;279
515001;Beförderungserschleichung;3404000;Osnabrück;W;98;0;0;0;0;0;0;3;7;10;23;33;16;10;26;13;14;8;2;2;65
515001;Beförderungserschleichung;3404000;Osnabrück;X;451;0;0;0;0;0;0;9;32;41;66;107;53;40;93;97;88;45;14;7;344
515001;Beförderungserschleichung;5774032;Paderborn;M;721;0;0;0;0;2;2;45;111;156;181;339;73;54;127;97;96;46;14;2;382
515001;Beförderungserschleichung;5774032;Paderborn;W;337;0;0;0;0;0;0;45;50;95;82;177;34;18;52;40;42;18;8;0;160
515001;Beförderungserschleichung;5774032;Paderborn;X;1058;0;0;0;0;2;2;90;161;251;263;516;107;72;179;137;138;64;22;2;542
515001;Beförderungserschleichung;8231000;Pforzheim;M;276;0;0;0;5;8;13;12;23;35;37;85;29;23;52;56;45;24;12;2;191
515001;Beförderungserschleichung;8231000;Pforzheim;W;139;0;0;0;0;9;9;22;13;35;21;65;12;13;25;11;21;9;5;3;74
515001;Beförderungserschleichung;8231000;Pforzheim;X;415;0;0;0;5;17;22;34;36;70;58;150;41;36;77;67;66;33;17;5;265
515001;Beförderungserschleichung;12054000;Potsdam;M;127;0;0;0;0;0;0;4;5;9;6;15;8;14;22;19;27;18;18;8;112
515001;Beförderungserschleichung;12054000;Potsdam;W;29;0;0;0;0;1;1;1;2;3;4;8;3;1;4;3;7;4;3;0;21
515001;Beförderungserschleichung;12054000;Potsdam;X;156;0;0;0;0;1;1;5;7;12;10;23;11;15;26;22;34;22;21;8;133
515001;Beförderungserschleichung;5562032;Recklinghausen;M;179;0;0;0;0;2;2;6;15;21;32;55;23;18;41;23;33;15;10;2;124
515001;Beförderungserschleichung;5562032;Recklinghausen;W;76;0;0;0;0;1;1;3;7;10;16;27;4;4;8;19;11;8;2;1;49
515001;Beförderungserschleichung;5562032;Recklinghausen;X;255;0;0;0;0;3;3;9;22;31;48;82;27;22;49;42;44;23;12;3;173
515001;Beförderungserschleichung;9362000;Regensburg;M;572;0;0;0;0;1;1;25;60;85;93;179;70;57;127;83;108;50;18;7;393
515001;Beförderungserschleichung;9362000;Regensburg;W;259;0;0;0;1;1;2;17;38;55;64;121;26;9;35;31;41;18;9;4;138
515001;Beförderungserschleichung;9362000;Regensburg;X;831;0;0;0;1;2;3;42;98;140;157;300;96;66;162;114;149;68;27;11;531
515001;Beförderungserschleichung;5120000;Remscheid;M;30;0;0;0;0;0;0;1;2;3;3;6;3;4;7;7;7;3;0;0;24
515001;Beförderungserschleichung;5120000;Remscheid;W;7;0;0;0;0;0;0;0;0;0;0;0;3;0;3;1;2;0;0;1;7
515001;Beförderungserschleichung;5120000;Remscheid;X;37;0;0;0;0;0;0;1;2;3;3;6;6;4;10;8;9;3;0;1;31
515001;Beförderungserschleichung;8415061;Reutlingen;M;83;0;0;0;0;1;1;5;5;10;15;26;11;6;17;17;14;6;3;0;57
515001;Beförderungserschleichung;8415061;Reutlingen;W;26;0;0;0;0;2;2;1;3;4;7;13;5;1;6;2;1;3;1;0;13
515001;Beförderungserschleichung;8415061;Reutlingen;X;109;0;0;0;0;3;3;6;8;14;22;39;16;7;23;19;15;9;4;0;70
515001;Beförderungserschleichung;13003000;Rostock;M;1153;0;0;0;2;0;2;15;52;67;148;217;123;133;256;262;243;103;58;14;936
515001;Beförderungserschleichung;13003000;Rostock;W;523;0;0;0;1;2;3;13;38;51;84;138;58;58;116;95;68;56;41;9;385
515001;Beförderungserschleichung;13003000;Rostock;X;1676;0;0;0;3;2;5;28;90;118;232;355;181;191;372;357;311;159;99;23;1321
515001;Beförderungserschleichung;10041100;Saarbrücken;M;373;0;0;0;0;3;3;18;30;48;49;100;29;39;68;70;84;36;13;2;273
515001;Beförderungserschleichung;10041100;Saarbrücken;W;79;0;0;0;0;0;0;4;8;12;22;34;8;5;13;8;10;8;4;2;45
515001;Beförderungserschleichung;10041100;Saarbrücken;X;452;0;0;0;0;3;3;22;38;60;71;134;37;44;81;78;94;44;17;4;318
515001;Beförderungserschleichung;5122000;Solingen;M;210;0;0;0;0;1;1;4;6;10;36;47;23;28;51;37;46;21;7;1;163
515001;Beförderungserschleichung;5122000;Solingen;W;65;0;0;0;0;0;0;1;1;2;12;14;3;8;11;11;14;12;1;2;51
515001;Beförderungserschleichung;5122000;Solingen;X;275;0;0;0;0;1;1;5;7;12;48;61;26;36;62;48;60;33;8;3;214
515001;Beförderungserschleichung;8111000;Stuttgart;M;4213;0;0;0;0;4;4;74;247;321;627;952;442;400;842;751;839;476;252;101;3261
515001;Beförderungserschleichung;8111000;Stuttgart;W;1632;0;0;0;1;1;2;74;135;209;313;524;195;146;341;265;244;149;80;29;1108
515001;Beförderungserschleichung;8111000;Stuttgart;X;5845;0;0;0;1;5;6;148;382;530;940;1476;637;546;1183;1016;1083;625;332;130;4369
515001;Beförderungserschleichung;7211000;Trier;M;74;0;0;0;0;1;1;0;3;3;13;17;11;10;21;14;12;6;3;1;57
515001;Beförderungserschleichung;7211000;Trier;W;27;0;0;0;0;0;0;0;4;4;2;6;6;1;7;4;2;3;2;3;21
515001;Beförderungserschleichung;7211000;Trier;X;101;0;0;0;0;1;1;0;7;7;15;23;17;11;28;18;14;9;5;4;78
515001;Beförderungserschleichung;8421000;Ulm;M;732;0;0;1;2;7;10;21;62;83;110;203;57;73;130;129;154;64;37;15;529
515001;Beförderungserschleichung;8421000;Ulm;W;228;0;0;0;1;5;6;15;25;40;56;102;23;11;34;20;37;20;12;3;126
515001;Beförderungserschleichung;8421000;Ulm;X;960;0;0;1;3;12;16;36;87;123;166;305;80;84;164;149;191;84;49;18;655
515001;Beförderungserschleichung;6414000;Wiesbaden;M;642;0;0;0;1;1;2;26;39;65;106;173;57;49;106;92;142;79;38;12;469
515001;Beförderungserschleichung;6414000;Wiesbaden;W;284;0;1;0;0;0;1;23;24;47;46;94;31;23;54;39;55;19;12;11;190
515001;Beförderungserschleichung;6414000;Wiesbaden;X;926;0;1;0;1;1;3;49;63;112;152;267;88;72;160;131;197;98;50;23;659
515001;Beförderungserschleichung;3103000;Wolfsburg;M;187;0;0;0;0;4;4;5;8;13;22;39;16;16;32;34;38;16;18;10;148
515001;Beförderungserschleichung;3103000;Wolfsburg;W;44;0;0;0;0;0;0;1;5;6;10;16;5;3;8;4;6;6;3;1;28
515001;Beförderungserschleichung;3103000;Wolfsburg;X;231;0;0;0;0;4;4;6;13;19;32;55;21;19;40;38;44;22;21;11;176
515001;Beförderungserschleichung;5124000;Wuppertal;M;1112;0;0;0;2;7;9;38;48;86;192;287;119;102;221;196;236;104;50;18;825
515001;Beförderungserschleichung;5124000;Wuppertal;W;432;0;0;0;1;7;8;44;39;83;83;174;43;42;85;53;62;34;14;10;258
515001;Beförderungserschleichung;5124000;Wuppertal;X;1544;0;0;0;3;14;17;82;87;169;275;461;162;144;306;249;298;138;64;28;1083
515001;Beförderungserschleichung;9663000;Würzburg;M;521;0;0;0;1;1;2;11;31;42;51;95;40;39;79;94;141;65;33;14;426
515001;Beförderungserschleichung;9663000;Würzburg;W;125;0;0;0;0;2;2;7;8;15;30;47;15;8;23;18;20;7;8;2;78
515001;Beförderungserschleichung;9663000;Würzburg;X;646;0;0;0;1;3;4;18;39;57;81;142;55;47;102;112;161;72;41;16;504
530000;Unterschlagung §§ 246, 247, 248a StGB;5334002;Aachen;M;171;0;0;0;0;1;1;2;10;12;24;37;11;13;24;21;30;27;19;13;134
530000;Unterschlagung §§ 246, 247, 248a StGB;5334002;Aachen;W;58;0;0;0;0;0;0;0;2;2;2;4;5;5;10;9;12;14;7;2;54
530000;Unterschlagung §§ 246, 247, 248a StGB;5334002;Aachen;X;229;0;0;0;0;1;1;2;12;14;26;41;16;18;34;30;42;41;26;15;188
530000;Unterschlagung §§ 246, 247, 248a StGB;9761000;Augsburg;M;183;0;0;0;0;1;1;12;12;24;14;39;12;14;26;27;30;32;19;10;144
530000;Unterschlagung §§ 246, 247, 248a StGB;9761000;Augsburg;W;50;0;0;0;0;1;1;2;4;6;3;10;3;2;5;3;8;7;11;6;40
530000;Unterschlagung §§ 246, 247, 248a StGB;9761000;Augsburg;X;233;0;0;0;0;2;2;14;16;30;17;49;15;16;31;30;38;39;30;16;184
530000;Unterschlagung §§ 246, 247, 248a StGB;5378004;Bergisch Gladbach;M;62;0;0;1;1;0;2;3;6;9;6;17;1;4;5;4;15;12;7;2;45
530000;Unterschlagung §§ 246, 247, 248a StGB;5378004;Bergisch Gladbach;W;17;0;0;0;0;0;0;0;1;1;2;3;1;1;2;2;3;5;2;0;14
530000;Unterschlagung §§ 246, 247, 248a StGB;5378004;Bergisch Gladbach;X;79;0;0;1;1;0;2;3;7;10;8;20;2;5;7;6;18;17;9;2;59
530000;Unterschlagung §§ 246, 247, 248a StGB;11000000;Berlin;M;2404;0;0;1;3;15;19;34;83;117;147;283;124;137;261;379;615;482;261;123;2121
530000;Unterschlagung §§ 246, 247, 248a StGB;11000000;Berlin;W;922;0;0;0;3;9;12;28;30;58;49;119;52;73;125;126;219;182;92;59;803
530000;Unterschlagung §§ 246, 247, 248a StGB;11000000;Berlin;X;3326;0;0;1;6;24;31;62;113;175;196;402;176;210;386;505;834;664;353;182;2924
530000;Unterschlagung §§ 246, 247, 248a StGB;5711000;Bielefeld;M;173;0;0;0;0;0;0;3;8;11;11;22;14;10;24;29;37;31;22;8;151
530000;Unterschlagung §§ 246, 247, 248a StGB;5711000;Bielefeld;W;59;0;0;0;0;0;0;2;4;6;4;10;1;5;6;7;11;9;13;3;49
530000;Unterschlagung §§ 246, 247, 248a StGB;5711000;Bielefeld;X;232;0;0;0;0;0;0;5;12;17;15;32;15;15;30;36;48;40;35;11;200
530000;Unterschlagung §§ 246, 247, 248a StGB;5911000;Bochum;M;252;0;0;0;1;1;2;5;16;21;24;47;13;19;32;30;61;45;23;14;205
530000;Unterschlagung §§ 246, 247, 248a StGB;5911000;Bochum;W;117;0;0;0;0;0;0;4;6;10;12;22;6;8;14;15;21;28;12;5;95
530000;Unterschlagung §§ 246, 247, 248a StGB;5911000;Bochum;X;369;0;0;0;1;1;2;9;22;31;36;69;19;27;46;45;82;73;35;19;300
530000;Unterschlagung §§ 246, 247, 248a StGB;5314000;Bonn;M;204;0;0;0;2;1;3;4;8;12;11;26;10;15;25;26;41;45;27;14;178
530000;Unterschlagung §§ 246, 247, 248a StGB;5314000;Bonn;W;69;0;0;0;0;0;0;5;2;7;6;13;3;3;6;10;11;18;5;6;56
530000;Unterschlagung §§ 246, 247, 248a StGB;5314000;Bonn;X;273;0;0;0;2;1;3;9;10;19;17;39;13;18;31;36;52;63;32;20;234
530000;Unterschlagung §§ 246, 247, 248a StGB;5512000;Bottrop;M;52;0;0;0;0;0;0;0;4;4;8;12;2;4;6;7;13;5;6;3;40
530000;Unterschlagung §§ 246, 247, 248a StGB;5512000;Bottrop;W;24;0;0;0;0;1;1;0;0;0;1;2;1;0;1;6;5;1;4;5;22
530000;Unterschlagung §§ 246, 247, 248a StGB;5512000;Bottrop;X;76;0;0;0;0;1;1;0;4;4;9;14;3;4;7;13;18;6;10;8;62
530000;Unterschlagung §§ 246, 247, 248a StGB;3101000;Braunschweig;M;144;0;0;0;0;1;1;4;7;11;18;30;6;10;16;17;28;27;17;9;114
530000;Unterschlagung §§ 246, 247, 248a StGB;3101000;Braunschweig;W;67;0;0;0;1;2;3;2;4;6;7;16;6;6;12;10;12;8;6;3;51
530000;Unterschlagung §§ 246, 247, 248a StGB;3101000;Braunschweig;X;211;0;0;0;1;3;4;6;11;17;25;46;12;16;28;27;40;35;23;12;165
530000;Unterschlagung §§ 246, 247, 248a StGB;4011000;Bremen;M;351;0;0;0;0;1;1;8;21;29;39;69;27;28;55;53;70;56;30;18;282
530000;Unterschlagung §§ 246, 247, 248a StGB;4011000;Bremen;W;117;0;0;0;0;0;0;1;3;4;11;15;6;10;16;17;24;21;18;6;102
530000;Unterschlagung §§ 246, 247, 248a StGB;4011000;Bremen;X;468;0;0;0;0;1;1;9;24;33;50;84;33;38;71;70;94;77;48;24;384
530000;Unterschlagung §§ 246, 247, 248a StGB;4012000;Bremerhaven;M;90;0;0;0;0;0;0;3;8;11;10;21;5;8;13;13;20;10;10;3;69
530000;Unterschlagung §§ 246, 247, 248a StGB;4012000;Bremerhaven;W;36;0;0;0;0;1;1;0;1;1;4;6;2;1;3;8;7;7;3;2;30
530000;Unterschlagung §§ 246, 247, 248a StGB;4012000;Bremerhaven;X;126;0;0;0;0;1;1;3;9;12;14;27;7;9;16;21;27;17;13;5;99
530000;Unterschlagung §§ 246, 247, 248a StGB;14511000;Chemnitz;M;184;0;0;0;0;0;0;0;3;3;9;12;6;12;18;37;46;36;25;10;172
530000;Unterschlagung §§ 246, 247, 248a StGB;14511000;Chemnitz;W;73;0;0;0;0;1;1;1;0;1;6;8;2;5;7;9;19;16;11;3;65
530000;Unterschlagung §§ 246, 247, 248a StGB;14511000;Chemnitz;X;257;0;0;0;0;1;1;1;3;4;15;20;8;17;25;46;65;52;36;13;237
530000;Unterschlagung §§ 246, 247, 248a StGB;6411000;Darmstadt;M;88;0;0;0;1;4;5;2;15;17;7;29;3;6;9;10;17;10;5;8;59
530000;Unterschlagung §§ 246, 247, 248a StGB;6411000;Darmstadt;W;30;0;0;0;0;0;0;0;3;3;3;6;1;1;2;4;4;7;5;2;24
530000;Unterschlagung §§ 246, 247, 248a StGB;6411000;Darmstadt;X;118;0;0;0;1;4;5;2;18;20;10;35;4;7;11;14;21;17;10;10;83
530000;Unterschlagung §§ 246, 247, 248a StGB;5913000;Dortmund;M;476;0;0;0;0;7;7;9;16;25;47;79;25;30;55;51;104;107;54;26;397
530000;Unterschlagung §§ 246, 247, 248a StGB;5913000;Dortmund;W;181;0;0;0;0;2;2;6;10;16;17;35;10;19;29;20;37;31;18;11;146
530000;Unterschlagung §§ 246, 247, 248a StGB;5913000;Dortmund;X;657;0;0;0;0;9;9;15;26;41;64;114;35;49;84;71;141;138;72;37;543
530000;Unterschlagung §§ 246, 247, 248a StGB;14612000;Dresden;M;348;0;0;0;0;0;0;3;11;14;15;29;18;26;44;79;99;59;23;15;319
530000;Unterschlagung §§ 246, 247, 248a StGB;14612000;Dresden;W;148;0;0;0;0;4;4;1;5;6;14;24;8;9;17;24;36;26;13;8;124
530000;Unterschlagung §§ 246, 247, 248a StGB;14612000;Dresden;X;496;0;0;0;0;4;4;4;16;20;29;53;26;35;61;103;135;85;36;23;443
530000;Unterschlagung §§ 246, 247, 248a StGB;5112000;Duisburg;M;240;0;0;0;0;1;1;5;5;10;16;27;11;21;32;36;48;52;26;19;213
530000;Unterschlagung §§ 246, 247, 248a StGB;5112000;Duisburg;W;89;0;0;0;0;1;1;3;3;6;6;13;6;5;11;13;30;14;5;3;76
530000;Unterschlagung §§ 246, 247, 248a StGB;5112000;Duisburg;X;329;0;0;0;0;2;2;8;8;16;22;40;17;26;43;49;78;66;31;22;289
530000;Unterschlagung §§ 246, 247, 248a StGB;5111000;Düsseldorf;M;370;0;0;0;0;3;3;7;16;23;27;53;24;21;45;35;112;66;34;25;317
530000;Unterschlagung §§ 246, 247, 248a StGB;5111000;Düsseldorf;W;125;0;0;0;0;5;5;4;5;9;9;23;6;3;9;17;26;22;16;12;102
530000;Unterschlagung §§ 246, 247, 248a StGB;5111000;Düsseldorf;X;495;0;0;0;0;8;8;11;21;32;36;76;30;24;54;52;138;88;50;37;419
530000;Unterschlagung §§ 246, 247, 248a StGB;16051000;Erfurt;M;171;0;0;1;0;0;1;2;8;10;11;22;7;13;20;30;48;25;16;10;149
530000;Unterschlagung §§ 246, 247, 248a StGB;16051000;Erfurt;W;64;0;0;0;0;1;1;0;1;1;5;7;4;1;5;8;23;9;9;3;57
530000;Unterschlagung §§ 246, 247, 248a StGB;16051000;Erfurt;X;235;0;0;1;0;1;2;2;9;11;16;29;11;14;25;38;71;34;25;13;206
530000;Unterschlagung §§ 246, 247, 248a StGB;9562000;Erlangen;M;32;0;0;0;0;0;0;3;5;8;4;12;2;5;7;3;0;7;2;1;20
530000;Unterschlagung §§ 246, 247, 248a StGB;9562000;Erlangen;W;12;0;0;0;0;0;0;1;1;2;0;2;0;0;0;2;2;2;3;1;10
530000;Unterschlagung §§ 246, 247, 248a StGB;9562000;Erlangen;X;44;0;0;0;0;0;0;4;6;10;4;14;2;5;7;5;2;9;5;2;30
530000;Unterschlagung §§ 246, 247, 248a StGB;5113000;Essen;M;289;0;0;0;0;1;1;4;16;20;21;42;20;17;37;43;52;60;38;17;247
530000;Unterschlagung §§ 246, 247, 248a StGB;5113000;Essen;W;136;0;0;0;0;1;1;1;4;5;14;20;6;8;14;19;21;27;25;10;116
530000;Unterschlagung §§ 246, 247, 248a StGB;5113000;Essen;X;425;0;0;0;0;2;2;5;20;25;35;62;26;25;51;62;73;87;63;27;363
530000;Unterschlagung §§ 246, 247, 248a StGB;6412000;Frankfurt am Main;M;496;0;0;0;0;2;2;8;27;35;41;78;24;26;50;58;131;113;41;25;418
530000;Unterschlagung §§ 246, 247, 248a StGB;6412000;Frankfurt am Main;W;170;0;0;0;0;1;1;3;7;10;13;24;9;9;18;32;44;23;19;10;146
530000;Unterschlagung §§ 246, 247, 248a StGB;6412000;Frankfurt am Main;X;666;0;0;0;0;3;3;11;34;45;54;102;33;35;68;90;175;136;60;35;564
530000;Unterschlagung §§ 246, 247, 248a StGB;8311000;Freiburg im Breisgau;M;135;0;0;1;2;2;5;10;18;28;13;46;8;7;15;17;24;18;11;4;89
530000;Unterschlagung §§ 246, 247, 248a StGB;8311000;Freiburg im Breisgau;W;34;0;0;0;0;0;0;0;5;5;2;7;2;3;5;4;8;3;5;2;27
530000;Unterschlagung §§ 246, 247, 248a StGB;8311000;Freiburg im Breisgau;X;169;0;0;1;2;2;5;10;23;33;15;53;10;10;20;21;32;21;16;6;116
530000;Unterschlagung §§ 246, 247, 248a StGB;9563000;Fürth;M;48;0;0;0;0;0;0;4;4;8;4;12;2;1;3;10;13;7;3;0;36
530000;Unterschlagung §§ 246, 247, 248a StGB;9563000;Fürth;W;12;0;0;0;0;0;0;0;3;3;0;3;1;2;3;3;2;0;0;1;9
530000;Unterschlagung §§ 246, 247, 248a StGB;9563000;Fürth;X;60;0;0;0;0;0;0;4;7;11;4;15;3;3;6;13;15;7;3;1;45
530000;Unterschlagung §§ 246, 247, 248a StGB;5513000;Gelsenkirchen;M;132;0;0;0;0;0;0;5;8;13;11;24;10;5;15;28;27;18;17;3;108
530000;Unterschlagung §§ 246, 247, 248a StGB;5513000;Gelsenkirchen;W;50;0;0;0;0;0;0;2;2;4;7;11;2;3;5;5;15;6;5;3;39
530000;Unterschlagung §§ 246, 247, 248a StGB;5513000;Gelsenkirchen;X;182;0;0;0;0;0;0;7;10;17;18;35;12;8;20;33;42;24;22;6;147
530000;Unterschlagung §§ 246, 247, 248a StGB;3152012;Göttingen;M;74;0;0;0;0;0;0;3;4;7;3;10;4;4;8;14;14;12;9;7;64
530000;Unterschlagung §§ 246, 247, 248a StGB;3152012;Göttingen;W;31;0;0;0;0;0;0;0;0;0;0;0;4;2;6;6;10;5;2;2;31
530000;Unterschlagung §§ 246, 247, 248a StGB;3152012;Göttingen;X;105;0;0;0;0;0;0;3;4;7;3;10;8;6;14;20;24;17;11;9;95
530000;Unterschlagung §§ 246, 247, 248a StGB;5914000;Hagen;M;113;0;0;1;0;1;2;3;8;11;8;21;7;8;15;13;18;29;12;5;92
530000;Unterschlagung §§ 246, 247, 248a StGB;5914000;Hagen;W;43;0;0;0;0;0;0;1;2;3;6;9;3;8;11;4;2;9;6;2;34
530000;Unterschlagung §§ 246, 247, 248a StGB;5914000;Hagen;X;156;0;0;1;0;1;2;4;10;14;14;30;10;16;26;17;20;38;18;7;126
530000;Unterschlagung §§ 246, 247, 248a StGB;15002000;Halle (Saale);M;168;0;0;1;1;1;3;0;3;3;9;15;4;11;15;34;42;37;19;6;153
530000;Unterschlagung §§ 246, 247, 248a StGB;15002000;Halle (Saale);W;72;0;0;0;0;0;0;2;2;4;9;13;6;3;9;16;10;11;10;3;59
530000;Unterschlagung §§ 246, 247, 248a StGB;15002000;Halle (Saale);X;240;0;0;1;1;1;3;2;5;7;18;28;10;14;24;50;52;48;29;9;212
530000;Unterschlagung §§ 246, 247, 248a StGB;2000000;Hamburg;M;1497;0;0;0;5;11;16;52;76;128;124;268;85;116;201;225;337;227;157;82;1229
530000;Unterschlagung §§ 246, 247, 248a StGB;2000000;Hamburg;W;537;0;0;0;1;3;4;10;24;34;66;104;29;32;61;87;100;94;59;32;433
530000;Unterschlagung §§ 246, 247, 248a StGB;2000000;Hamburg;X;2034;0;0;0;6;14;20;62;100;162;190;372;114;148;262;312;437;321;216;114;1662
530000;Unterschlagung §§ 246, 247, 248a StGB;5915000;Hamm;M;90;0;0;0;0;0;0;1;3;4;18;22;3;6;9;12;20;10;10;7;68
530000;Unterschlagung §§ 246, 247, 248a StGB;5915000;Hamm;W;49;0;0;0;0;0;0;0;3;3;4;7;2;2;4;7;10;9;8;4;42
530000;Unterschlagung §§ 246, 247, 248a StGB;5915000;Hamm;X;139;0;0;0;0;0;0;1;6;7;22;29;5;8;13;19;30;19;18;11;110
530000;Unterschlagung §§ 246, 247, 248a StGB;3241001;Hannover;M;475;0;0;0;1;1;2;18;20;38;38;78;28;29;57;83;116;72;41;28;397
530000;Unterschlagung §§ 246, 247, 248a StGB;3241001;Hannover;W;184;0;0;0;0;3;3;2;8;10;16;29;11;22;33;23;46;26;17;10;155
530000;Unterschlagung §§ 246, 247, 248a StGB;3241001;Hannover;X;659;0;0;0;1;4;5;20;28;48;54;107;39;51;90;106;162;98;58;38;552
530000;Unterschlagung §§ 246, 247, 248a StGB;8221000;Heidelberg;M;85;0;0;0;0;0;0;8;12;20;9;29;7;6;13;10;10;10;6;7;56
530000;Unterschlagung §§ 246, 247, 248a StGB;8221000;Heidelberg;W;21;0;0;0;0;0;0;1;4;5;3;8;1;3;4;2;2;3;1;1;13
530000;Unterschlagung §§ 246, 247, 248a StGB;8221000;Heidelberg;X;106;0;0;0;0;0;0;9;16;25;12;37;8;9;17;12;12;13;7;8;69
530000;Unterschlagung §§ 246, 247, 248a StGB;8121000;Heilbronn;M;81;0;0;0;0;1;1;2;3;5;13;19;5;4;9;16;12;19;5;1;62
530000;Unterschlagung §§ 246, 247, 248a StGB;8121000;Heilbronn;W;32;0;0;0;0;0;0;0;3;3;5;8;4;1;5;7;5;5;1;1;24
530000;Unterschlagung §§ 246, 247, 248a StGB;8121000;Heilbronn;X;113;0;0;0;0;1;1;2;6;8;18;27;9;5;14;23;17;24;6;2;86
530000;Unterschlagung §§ 246, 247, 248a StGB;5916000;Herne;M;115;0;0;0;0;0;0;5;4;9;4;13;6;8;14;15;27;27;13;6;102
530000;Unterschlagung §§ 246, 247, 248a StGB;5916000;Herne;W;37;0;0;0;0;0;0;3;3;6;2;8;4;3;7;3;3;5;9;2;29
530000;Unterschlagung §§ 246, 247, 248a StGB;5916000;Herne;X;152;0;0;0;0;0;0;8;7;15;6;21;10;11;21;18;30;32;22;8;131
530000;Unterschlagung §§ 246, 247, 248a StGB;9161000;Ingolstadt;M;61;0;0;0;0;0;0;1;5;6;3;9;6;3;9;6;14;14;8;1;52
530000;Unterschlagung §§ 246, 247, 248a StGB;9161000;Ingolstadt;W;18;0;0;0;1;0;1;1;2;3;2;6;1;1;2;1;3;4;1;1;12
530000;Unterschlagung §§ 246, 247, 248a StGB;9161000;Ingolstadt;X;79;0;0;0;1;0;1;2;7;9;5;15;7;4;11;7;17;18;9;2;64
530000;Unterschlagung §§ 246, 247, 248a StGB;16053000;Jena;M;50;0;0;0;0;0;0;1;1;2;5;7;1;1;2;9;9;14;7;2;43
530000;Unterschlagung §§ 246, 247, 248a StGB;16053000;Jena;W;10;0;0;0;0;0;0;0;0;0;3;3;0;0;0;3;2;0;1;1;7
530000;Unterschlagung §§ 246, 247, 248a StGB;16053000;Jena;X;60;0;0;0;0;0;0;1;1;2;8;10;1;1;2;12;11;14;8;3;50
530000;Unterschlagung §§ 246, 247, 248a StGB;8212000;Karlsruhe;M;176;0;0;0;0;2;2;13;18;31;17;50;14;10;24;19;31;28;14;10;126
530000;Unterschlagung §§ 246, 247, 248a StGB;8212000;Karlsruhe;W;50;0;0;0;0;1;1;4;1;5;0;6;4;2;6;7;12;11;4;4;44
530000;Unterschlagung §§ 246, 247, 248a StGB;8212000;Karlsruhe;X;226;0;0;0;0;3;3;17;19;36;17;56;18;12;30;26;43;39;18;14;170
530000;Unterschlagung §§ 246, 247, 248a StGB;6611000;Kassel;M;134;0;0;0;0;0;0;3;6;9;11;20;7;11;18;17;37;22;14;6;114
530000;Unterschlagung §§ 246, 247, 248a StGB;6611000;Kassel;W;36;0;0;0;0;0;0;0;0;0;2;2;5;3;8;7;6;7;3;3;34
530000;Unterschlagung §§ 246, 247, 248a StGB;6611000;Kassel;X;170;0;0;0;0;0;0;3;6;9;13;22;12;14;26;24;43;29;17;9;148
530000;Unterschlagung §§ 246, 247, 248a StGB;1002000;Kiel;M;140;0;0;0;0;2;2;3;13;16;15;33;6;16;22;24;22;21;13;5;107
530000;Unterschlagung §§ 246, 247, 248a StGB;1002000;Kiel;W;64;0;0;0;0;0;0;0;1;1;8;9;5;3;8;8;9;12;5;13;55
530000;Unterschlagung §§ 246, 247, 248a StGB;1002000;Kiel;X;204;0;0;0;0;2;2;3;14;17;23;42;11;19;30;32;31;33;18;18;162
530000;Unterschlagung §§ 246, 247, 248a StGB;7111000;Koblenz;M;70;0;0;0;0;1;1;1;2;3;10;14;5;2;7;15;13;10;6;5;56
530000;Unterschlagung §§ 246, 247, 248a StGB;7111000;Koblenz;W;32;0;0;0;0;0;0;2;1;3;2;5;3;1;4;6;8;7;2;0;27
530000;Unterschlagung §§ 246, 247, 248a StGB;7111000;Koblenz;X;102;0;0;0;0;1;1;3;3;6;12;19;8;3;11;21;21;17;8;5;83
530000;Unterschlagung §§ 246, 247, 248a StGB;5315000;Köln;M;815;0;0;2;1;4;7;11;32;43;67;117;39;41;80;115;182;173;100;48;698
530000;Unterschlagung §§ 246, 247, 248a StGB;5315000;Köln;W;298;0;0;0;1;6;7;8;11;19;22;48;17;17;34;46;73;56;21;20;250
530000;Unterschlagung §§ 246, 247, 248a StGB;5315000;Köln;X;1113;0;0;2;2;10;14;19;43;62;89;165;56;58;114;161;255;229;121;68;948
530000;Unterschlagung §§ 246, 247, 248a StGB;5114000;Krefeld;M;108;0;0;0;0;0;0;2;2;4;7;11;8;3;11;16;29;21;14;6;97
530000;Unterschlagung §§ 246, 247, 248a StGB;5114000;Krefeld;W;49;0;0;0;0;0;0;2;0;2;2;4;5;1;6;8;11;9;6;5;45
530000;Unterschlagung §§ 246, 247, 248a StGB;5114000;Krefeld;X;157;0;0;0;0;0;0;4;2;6;9;15;13;4;17;24;40;30;20;11;142
530000;Unterschlagung §§ 246, 247, 248a StGB;14713000;Leipzig;M;507;0;0;0;0;3;3;7;6;13;30;46;36;33;69;97;148;87;39;21;461
530000;Unterschlagung §§ 246, 247, 248a StGB;14713000;Leipzig;W;245;0;0;0;0;1;1;1;3;4;22;27;19;26;45;46;55;39;25;8;218
530000;Unterschlagung §§ 246, 247, 248a StGB;14713000;Leipzig;X;752;0;0;0;0;4;4;8;9;17;52;73;55;59;114;143;203;126;64;29;679
530000;Unterschlagung §§ 246, 247, 248a StGB;5316000;Leverkusen;M;103;0;0;0;1;0;1;2;9;11;15;27;10;4;14;15;19;16;6;6;76
530000;Unterschlagung §§ 246, 247, 248a StGB;5316000;Leverkusen;W;53;0;0;0;0;0;0;0;0;0;5;5;3;3;6;6;11;8;11;6;48
530000;Unterschlagung §§ 246, 247, 248a StGB;5316000;Leverkusen;X;156;0;0;0;1;0;1;2;9;11;20;32;13;7;20;21;30;24;17;12;124
530000;Unterschlagung §§ 246, 247, 248a StGB;1003000;Lübeck;M;197;0;0;0;0;1;1;12;11;23;13;37;15;12;27;31;46;34;15;7;160
530000;Unterschlagung §§ 246, 247, 248a StGB;1003000;Lübeck;W;77;0;0;0;0;0;0;0;4;4;6;10;6;6;12;10;19;15;8;3;67
530000;Unterschlagung §§ 246, 247, 248a StGB;1003000;Lübeck;X;274;0;0;0;0;1;1;12;15;27;19;47;21;18;39;41;65;49;23;10;227
530000;Unterschlagung §§ 246, 247, 248a StGB;7314000;Ludwigshafen am Rhein;M;122;0;0;0;0;0;0;5;4;9;12;21;10;5;15;11;31;31;7;6;101
530000;Unterschlagung §§ 246, 247, 248a StGB;7314000;Ludwigshafen am Rhein;W;68;0;0;0;0;2;2;0;2;2;6;10;3;7;10;12;20;12;4;0;58
530000;Unterschlagung §§ 246, 247, 248a StGB;7314000;Ludwigshafen am Rhein;X;190;0;0;0;0;2;2;5;6;11;18;31;13;12;25;23;51;43;11;6;159
530000;Unterschlagung §§ 246, 247, 248a StGB;15003000;Magdeburg;M;201;0;0;0;1;0;1;2;13;15;12;28;9;16;25;32;41;40;25;10;173
530000;Unterschlagung §§ 246, 247, 248a StGB;15003000;Magdeburg;W;108;0;0;0;0;1;1;5;2;7;4;12;7;9;16;21;28;14;12;5;96
530000;Unterschlagung §§ 246, 247, 248a StGB;15003000;Magdeburg;X;309;0;0;0;1;1;2;7;15;22;16;40;16;25;41;53;69;54;37;15;269
530000;Unterschlagung §§ 246, 247, 248a StGB;7315000;Mainz;M;136;0;0;0;0;0;0;3;5;8;15;23;10;6;16;23;28;20;21;5;113
530000;Unterschlagung §§ 246, 247, 248a StGB;7315000;Mainz;W;39;0;0;0;0;0;0;0;4;4;3;7;1;6;7;5;9;6;4;1;32
530000;Unterschlagung §§ 246, 247, 248a StGB;7315000;Mainz;X;175;0;0;0;0;0;0;3;9;12;18;30;11;12;23;28;37;26;25;6;145
530000;Unterschlagung §§ 246, 247, 248a StGB;8222000;Mannheim;M;150;0;0;0;0;0;0;5;9;14;14;28;11;8;19;18;38;25;12;10;122
530000;Unterschlagung §§ 246, 247, 248a StGB;8222000;Mannheim;W;67;0;0;0;0;0;0;2;2;4;7;11;6;9;15;12;11;9;4;5;56
530000;Unterschlagung §§ 246, 247, 248a StGB;8222000;Mannheim;X;217;0;0;0;0;0;0;7;11;18;21;39;17;17;34;30;49;34;16;15;178
530000;Unterschlagung §§ 246, 247, 248a StGB;5170024;Moers;M;69;0;0;0;0;2;2;0;0;0;6;8;3;7;10;10;21;12;5;3;61
530000;Unterschlagung §§ 246, 247, 248a StGB;5170024;Moers;W;26;0;0;0;0;0;0;0;2;2;3;5;3;0;3;1;6;4;6;1;21
530000;Unterschlagung §§ 246, 247, 248a StGB;5170024;Moers;X;95;0;0;0;0;2;2;0;2;2;9;13;6;7;13;11;27;16;11;4;82
530000;Unterschlagung §§ 246, 247, 248a StGB;5116000;Mönchengladbach;M;198;0;0;3;0;2;5;6;5;11;14;30;16;10;26;33;44;25;26;14;168
530000;Unterschlagung §§ 246, 247, 248a StGB;5116000;Mönchengladbach;W;79;0;0;0;0;3;3;3;5;8;7;18;3;9;12;6;13;15;13;2;61
530000;Unterschlagung §§ 246, 247, 248a StGB;5116000;Mönchengladbach;X;277;0;0;3;0;5;8;9;10;19;21;48;19;19;38;39;57;40;39;16;229
530000;Unterschlagung §§ 246, 247, 248a StGB;5117000;Mülheim an der Ruhr;M;100;0;0;0;0;1;1;1;5;6;8;15;6;7;13;9;22;13;14;14;85
530000;Unterschlagung §§ 246, 247, 248a StGB;5117000;Mülheim an der Ruhr;W;45;0;0;0;0;2;2;1;2;3;2;7;2;3;5;5;9;7;9;3;38
530000;Unterschlagung §§ 246, 247, 248a StGB;5117000;Mülheim an der Ruhr;X;145;0;0;0;0;3;3;2;7;9;10;22;8;10;18;14;31;20;23;17;123
530000;Unterschlagung §§ 246, 247, 248a StGB;9162000;München;M;669;0;0;1;1;4;6;16;41;57;52;115;38;38;76;91;134;130;84;39;554
530000;Unterschlagung §§ 246, 247, 248a StGB;9162000;München;W;225;0;0;0;0;1;1;10;12;22;16;39;10;15;25;27;50;47;20;17;186
530000;Unterschlagung §§ 246, 247, 248a StGB;9162000;München;X;894;0;0;1;1;5;7;26;53;79;68;154;48;53;101;118;184;177;104;56;740
530000;Unterschlagung §§ 246, 247, 248a StGB;5515000;Münster;M;182;0;0;0;0;5;5;5;7;12;13;30;16;20;36;35;41;22;11;7;152
530000;Unterschlagung §§ 246, 247, 248a StGB;5515000;Münster;W;55;0;0;0;0;2;2;3;1;4;3;9;4;4;8;10;11;8;5;4;46
530000;Unterschlagung §§ 246, 247, 248a StGB;5515000;Münster;X;237;0;0;0;0;7;7;8;8;16;16;39;20;24;44;45;52;30;16;11;198
530000;Unterschlagung §§ 246, 247, 248a StGB;5162024;Neuss;M;98;0;0;0;0;0;0;2;5;7;7;14;1;6;7;10;30;17;16;4;84
530000;Unterschlagung §§ 246, 247, 248a StGB;5162024;Neuss;W;43;0;0;0;0;0;0;1;3;4;3;7;1;1;2;13;9;8;2;2;36
530000;Unterschlagung §§ 246, 247, 248a StGB;5162024;Neuss;X;141;0;0;0;0;0;0;3;8;11;10;21;2;7;9;23;39;25;18;6;120
530000;Unterschlagung §§ 246, 247, 248a StGB;9564000;Nürnberg;M;301;0;0;1;0;3;4;5;19;24;29;57;14;20;34;44;67;51;32;16;244
530000;Unterschlagung §§ 246, 247, 248a StGB;9564000;Nürnberg;W;93;0;0;0;1;2;3;4;1;5;7;15;8;7;15;14;15;13;12;9;78
530000;Unterschlagung §§ 246, 247, 248a StGB;9564000;Nürnberg;X;394;0;0;1;1;5;7;9;20;29;36;72;22;27;49;58;82;64;44;25;322
530000;Unterschlagung §§ 246, 247, 248a StGB;5119000;Oberhausen;M;122;0;0;0;0;1;1;2;9;11;14;26;6;5;11;12;27;25;13;8;96
530000;Unterschlagung §§ 246, 247, 248a StGB;5119000;Oberhausen;W;53;0;0;0;0;2;2;2;2;4;7;13;3;3;6;6;11;9;5;3;40
530000;Unterschlagung §§ 246, 247, 248a StGB;5119000;Oberhausen;X;175;0;0;0;0;3;3;4;11;15;21;39;9;8;17;18;38;34;18;11;136
530000;Unterschlagung §§ 246, 247, 248a StGB;6413000;Offenbach am Main;M;93;0;0;0;0;0;0;5;5;10;7;17;4;6;10;14;28;10;6;8;76
530000;Unterschlagung §§ 246, 247, 248a StGB;6413000;Offenbach am Main;W;39;0;0;0;0;2;2;0;3;3;2;7;2;1;3;4;10;11;1;3;32
530000;Unterschlagung §§ 246, 247, 248a StGB;6413000;Offenbach am Main;X;132;0;0;0;0;2;2;5;8;13;9;24;6;7;13;18;38;21;7;11;108
530000;Unterschlagung §§ 246, 247, 248a StGB;3403000;Oldenburg (Oldenburg);M;260;0;0;0;0;2;2;10;14;24;27;53;29;22;51;53;46;39;10;8;207
530000;Unterschlagung §§ 246, 247, 248a StGB;3403000;Oldenburg (Oldenburg);W;101;0;0;0;0;0;0;3;2;5;14;19;16;11;27;13;23;16;3;0;82
530000;Unterschlagung §§ 246, 247, 248a StGB;3403000;Oldenburg (Oldenburg);X;361;0;0;0;0;2;2;13;16;29;41;72;45;33;78;66;69;55;13;8;289
530000;Unterschlagung §§ 246, 247, 248a StGB;3404000;Osnabrück;M;146;0;0;0;0;0;0;2;3;5;12;17;11;15;26;23;39;24;12;5;129
530000;Unterschlagung §§ 246, 247, 248a StGB;3404000;Osnabrück;W;75;0;0;0;0;0;0;1;2;3;11;14;9;6;15;9;15;13;4;5;61
530000;Unterschlagung §§ 246, 247, 248a StGB;3404000;Osnabrück;X;221;0;0;0;0;0;0;3;5;8;23;31;20;21;41;32;54;37;16;10;190
530000;Unterschlagung §§ 246, 247, 248a StGB;5774032;Paderborn;M;69;0;0;0;0;0;0;1;4;5;10;15;5;8;13;12;12;9;5;3;54
530000;Unterschlagung §§ 246, 247, 248a StGB;5774032;Paderborn;W;25;0;0;0;0;0;0;1;3;4;3;7;2;0;2;4;6;2;3;1;18
530000;Unterschlagung §§ 246, 247, 248a StGB;5774032;Paderborn;X;94;0;0;0;0;0;0;2;7;9;13;22;7;8;15;16;18;11;8;4;72
530000;Unterschlagung §§ 246, 247, 248a StGB;8231000;Pforzheim;M;63;0;0;0;0;3;3;4;7;11;6;20;1;5;6;11;7;11;6;2;43
530000;Unterschlagung §§ 246, 247, 248a StGB;8231000;Pforzheim;W;19;0;0;0;0;0;0;0;0;0;1;1;3;0;3;2;4;3;5;1;18
530000;Unterschlagung §§ 246, 247, 248a StGB;8231000;Pforzheim;X;82;0;0;0;0;3;3;4;7;11;7;21;4;5;9;13;11;14;11;3;61
530000;Unterschlagung §§ 246, 247, 248a StGB;12054000;Potsdam;M;97;0;0;0;0;0;0;1;3;4;6;10;4;5;9;18;23;22;9;6;87
530000;Unterschlagung §§ 246, 247, 248a StGB;12054000;Potsdam;W;39;0;0;0;0;0;0;0;1;1;1;2;0;2;2;4;13;12;5;1;37
530000;Unterschlagung §§ 246, 247, 248a StGB;12054000;Potsdam;X;136;0;0;0;0;0;0;1;4;5;7;12;4;7;11;22;36;34;14;7;124
530000;Unterschlagung §§ 246, 247, 248a StGB;5562032;Recklinghausen;M;85;0;0;1;0;1;2;2;2;4;9;15;7;3;10;13;20;14;6;7;70
530000;Unterschlagung §§ 246, 247, 248a StGB;5562032;Recklinghausen;W;36;0;0;0;0;1;1;3;1;4;4;9;3;4;7;4;1;9;4;2;27
530000;Unterschlagung §§ 246, 247, 248a StGB;5562032;Recklinghausen;X;121;0;0;1;0;2;3;5;3;8;13;24;10;7;17;17;21;23;10;9;97
530000;Unterschlagung §§ 246, 247, 248a StGB;9362000;Regensburg;M;73;0;0;0;0;0;0;2;4;6;7;13;5;4;9;6;21;13;8;3;60
530000;Unterschlagung §§ 246, 247, 248a StGB;9362000;Regensburg;W;18;0;0;0;0;0;0;0;2;2;2;4;3;3;6;0;5;1;0;2;14
530000;Unterschlagung §§ 246, 247, 248a StGB;9362000;Regensburg;X;91;0;0;0;0;0;0;2;6;8;9;17;8;7;15;6;26;14;8;5;74
530000;Unterschlagung §§ 246, 247, 248a StGB;5120000;Remscheid;M;68;0;0;0;0;0;0;1;4;5;7;12;5;5;10;9;9;16;7;5;56
530000;Unterschlagung §§ 246, 247, 248a StGB;5120000;Remscheid;W;22;0;0;0;0;0;0;0;0;0;2;2;2;1;3;3;6;2;4;2;20
530000;Unterschlagung §§ 246, 247, 248a StGB;5120000;Remscheid;X;90;0;0;0;0;0;0;1;4;5;9;14;7;6;13;12;15;18;11;7;76
530000;Unterschlagung §§ 246, 247, 248a StGB;8415061;Reutlingen;M;40;0;0;0;0;0;0;2;8;10;9;19;1;2;3;3;9;5;1;0;21
530000;Unterschlagung §§ 246, 247, 248a StGB;8415061;Reutlingen;W;10;0;0;0;0;0;0;1;1;2;1;3;0;1;1;3;1;1;1;0;7
530000;Unterschlagung §§ 246, 247, 248a StGB;8415061;Reutlingen;X;50;0;0;0;0;0;0;3;9;12;10;22;1;3;4;6;10;6;2;0;28
530000;Unterschlagung §§ 246, 247, 248a StGB;13003000;Rostock;M;122;0;0;0;0;1;1;3;7;10;6;17;6;13;19;18;29;17;16;6;105
530000;Unterschlagung §§ 246, 247, 248a StGB;13003000;Rostock;W;74;0;0;0;0;0;0;0;3;3;7;10;5;10;15;11;16;12;9;1;64
530000;Unterschlagung §§ 246, 247, 248a StGB;13003000;Rostock;X;196;0;0;0;0;1;1;3;10;13;13;27;11;23;34;29;45;29;25;7;169
530000;Unterschlagung §§ 246, 247, 248a StGB;10041100;Saarbrücken;M;138;0;0;0;0;1;1;7;6;13;13;27;6;10;16;18;30;25;16;6;111
530000;Unterschlagung §§ 246, 247, 248a StGB;10041100;Saarbrücken;W;46;0;0;0;0;0;0;2;1;3;8;11;3;1;4;9;6;7;9;0;35
530000;Unterschlagung §§ 246, 247, 248a StGB;10041100;Saarbrücken;X;184;0;0;0;0;1;1;9;7;16;21;38;9;11;20;27;36;32;25;6;146
530000;Unterschlagung §§ 246, 247, 248a StGB;5122000;Solingen;M;100;0;0;0;1;1;2;2;3;5;4;11;8;9;17;13;13;26;11;9;89
530000;Unterschlagung §§ 246, 247, 248a StGB;5122000;Solingen;W;48;0;0;0;0;1;1;0;1;1;1;3;2;0;2;5;11;12;12;3;45
530000;Unterschlagung §§ 246, 247, 248a StGB;5122000;Solingen;X;148;0;0;0;1;2;3;2;4;6;5;14;10;9;19;18;24;38;23;12;134
530000;Unterschlagung §§ 246, 247, 248a StGB;8111000;Stuttgart;M;399;0;0;0;0;5;5;20;44;64;43;112;19;15;34;47;86;69;27;24;287
530000;Unterschlagung §§ 246, 247, 248a StGB;8111000;Stuttgart;W;102;0;0;0;0;0;0;9;5;14;9;23;3;5;8;15;24;19;8;5;79
530000;Unterschlagung §§ 246, 247, 248a StGB;8111000;Stuttgart;X;501;0;0;0;0;5;5;29;49;78;52;135;22;20;42;62;110;88;35;29;366
530000;Unterschlagung §§ 246, 247, 248a StGB;7211000;Trier;M;66;0;0;0;0;0;0;2;8;10;5;15;5;6;11;9;10;10;6;5;51
530000;Unterschlagung §§ 246, 247, 248a StGB;7211000;Trier;W;26;0;0;0;0;0;0;0;3;3;4;7;3;2;5;3;6;2;2;1;19
530000;Unterschlagung §§ 246, 247, 248a StGB;7211000;Trier;X;92;0;0;0;0;0;0;2;11;13;9;22;8;8;16;12;16;12;8;6;70
530000;Unterschlagung §§ 246, 247, 248a StGB;8421000;Ulm;M;55;0;0;0;0;0;0;4;3;7;4;11;2;3;5;4;11;12;9;3;44
530000;Unterschlagung §§ 246, 247, 248a StGB;8421000;Ulm;W;19;0;0;0;0;1;1;1;2;3;2;6;2;0;2;2;4;2;3;0;13
530000;Unterschlagung §§ 246, 247, 248a StGB;8421000;Ulm;X;74;0;0;0;0;1;1;5;5;10;6;17;4;3;7;6;15;14;12;3;57
530000;Unterschlagung §§ 246, 247, 248a StGB;6414000;Wiesbaden;M;193;0;1;0;2;0;3;11;8;19;21;43;13;9;22;19;48;34;17;10;150
530000;Unterschlagung §§ 246, 247, 248a StGB;6414000;Wiesbaden;W;72;0;0;0;0;1;1;6;2;8;12;21;4;2;6;7;15;11;7;5;51
530000;Unterschlagung §§ 246, 247, 248a StGB;6414000;Wiesbaden;X;265;0;1;0;2;1;4;17;10;27;33;64;17;11;28;26;63;45;24;15;201
530000;Unterschlagung §§ 246, 247, 248a StGB;3103000;Wolfsburg;M;50;0;0;0;0;0;0;1;3;4;3;7;1;2;3;6;17;6;10;1;43
530000;Unterschlagung §§ 246, 247, 248a StGB;3103000;Wolfsburg;W;24;0;0;0;0;3;3;1;1;2;1;6;2;3;5;2;2;4;3;2;18
530000;Unterschlagung §§ 246, 247, 248a StGB;3103000;Wolfsburg;X;74;0;0;0;0;3;3;2;4;6;4;13;3;5;8;8;19;10;13;3;61
530000;Unterschlagung §§ 246, 247, 248a StGB;5124000;Wuppertal;M;247;0;0;0;0;0;0;5;18;23;17;40;10;21;31;33;47;48;35;13;207
530000;Unterschlagung §§ 246, 247, 248a StGB;5124000;Wuppertal;W;116;0;0;0;0;0;0;3;3;6;10;16;9;12;21;10;27;15;18;9;100
530000;Unterschlagung §§ 246, 247, 248a StGB;5124000;Wuppertal;X;363;0;0;0;0;0;0;8;21;29;27;56;19;33;52;43;74;63;53;22;307
530000;Unterschlagung §§ 246, 247, 248a StGB;9663000;Würzburg;M;85;0;0;0;0;1;1;3;5;8;9;18;4;4;8;12;22;12;8;5;67
530000;Unterschlagung §§ 246, 247, 248a StGB;9663000;Würzburg;W;25;0;0;0;0;0;0;1;2;3;5;8;2;2;4;3;3;2;2;3;17
530000;Unterschlagung §§ 246, 247, 248a StGB;9663000;Würzburg;X;110;0;0;0;0;1;1;4;7;11;14;26;6;6;12;15;25;14;10;8;84
540000;Urkundenfälschung §§ 267-271, 273-279, 281 StGB;5334002;Aachen;M;168;0;0;0;0;3;3;1;8;9;10;22;9;20;29;29;40;29;15;4;146
540000;Urkundenfälschung §§ 267-271, 273-279, 281 StGB;5334002;Aachen;W;37;0;0;0;0;0;0;4;4;8;1;9;2;2;4;2;9;7;5;1;28
540000;Urkundenfälschung §§ 267-271, 273-279, 281 StGB;5334002;Aachen;X;205;0;0;0;0;3;3;5;12;17;11;31;11;22;33;31;49;36;20;5;174
540000;Urkundenfälschung §§ 267-271, 273-279, 281 StGB;9761000;Augsburg;M;142;0;0;0;0;0;0;11;13;24;5;29;5;6;11;25;30;24;11;12;113
540000;Urkundenfälschung §§ 267-271, 273-279, 281 StGB;9761000;Augsburg;W;57;0;0;0;0;0;0;5;17;22;8;30;3;2;5;1;9;7;4;1;27
540000;Urkundenfälschung §§ 267-271, 273-279, 281 StGB;9761000;Augsburg;X;199;0;0;0;0;0;0;16;30;46;13;59;8;8;16;26;39;31;15;13;140
540000;Urkundenfälschung §§ 267-271, 273-279, 281 StGB;5378004;Bergisch Gladbach;M;32;0;0;0;0;0;0;0;0;0;1;1;3;0;3;7;7;9;5;0;31
540000;Urkundenfälschung §§ 267-271, 273-279, 281 StGB;5378004;Bergisch Gladbach;W;1;0;0;0;0;0;0;0;0;0;0;0;0;0;0;0;1;0;0;0;1
540000;Urkundenfälschung §§ 267-271, 273-279, 281 StGB;5378004;Bergisch Gladbach;X;33;0;0;0;0;0;0;0;0;0;1;1;3;0;3;7;8;9;5;0;32
540000;Urkundenfälschung §§ 267-271, 273-279, 281 StGB;11000000;Berlin;M;2582;0;0;0;1;3;4;25;56;81;186;271;151;203;354;413;697;494;229;124;2311
540000;Urkundenfälschung §§ 267-271, 273-279, 281 StGB;11000000;Berlin;W;685;0;0;0;1;3;4;24;28;52;52;108;35;52;87;104;164;118;69;35;577
540000;Urkundenfälschung §§ 267-271, 273-279, 281 StGB;11000000;Berlin;X;3267;0;0;0;2;6;8;49;84;133;238;379;186;255;441;517;861;612;298;159;2888
540000;Urkundenfälschung §§ 267-271, 273-279, 281 StGB;5711000;Bielefeld;M;183;0;0;0;0;0;0;1;9;10;12;22;10;13;23;22;47;51;10;8;161
540000;Urkundenfälschung §§ 267-271, 273-279, 281 StGB;5711000;Bielefeld;W;34;0;0;0;0;0;0;1;2;3;2;5;3;2;5;6;5;10;1;2;29
540000;Urkundenfälschung §§ 267-271, 273-279, 281 StGB;5711000;Bielefeld;X;217;0;0;0;0;0;0;2;11;13;14;27;13;15;28;28;52;61;11;10;190
540000;Urkundenfälschung §§ 267-271, 273-279, 281 StGB;5911000;Bochum;M;191;0;0;0;0;0;0;0;8;8;9;17;6;16;22;28;45;39;33;7;174
540000;Urkundenfälschung §§ 267-271, 273-279, 281 StGB;5911000;Bochum;W;42;0;0;0;1;1;2;1;4;5;2;9;2;2;4;11;7;6;3;2;33
540000;Urkundenfälschung §§ 267-271, 273-279, 281 StGB;5911000;Bochum;X;233;0;0;0;1;1;2;1;12;13;11;26;8;18;26;39;52;45;36;9;207
540000;Urkundenfälschung §§ 267-271, 273-279, 281 StGB;5314000;Bonn;M;119;0;0;0;0;1;1;3;2;5;2;8;8;6;14;27;30;24;14;2;111
540000;Urkundenfälschung §§ 267-271, 273-279, 281 StGB;5314000;Bonn;W;40;0;0;0;0;0;0;2;2;4;2;6;4;0;4;7;6;10;2;5;34
540000;Urkundenfälschung §§ 267-271, 273-279, 281 StGB;5314000;Bonn;X;159;0;0;0;0;1;1;5;4;9;4;14;12;6;18;34;36;34;16;7;145
540000;Urkundenfälschung §§ 267-271, 273-279, 281 StGB;5512000;Bottrop;M;36;0;0;0;0;0;0;0;0;0;2;2;4;3;7;4;9;6;4;4;34
540000;Urkundenfälschung §§ 267-271, 273-279, 281 StGB;5512000;Bottrop;W;10;0;0;0;0;0;0;0;1;1;0;1;0;3;3;0;2;2;0;2;9
540000;Urkundenfälschung §§ 267-271, 273-279, 281 StGB;5512000;Bottrop;X;46;0;0;0;0;0;0;0;1;1;2;3;4;6;10;4;11;8;4;6;43
540000;Urkundenfälschung §§ 267-271, 273-279, 281 StGB;3101000;Braunschweig;M;109;0;0;0;0;3;3;1;7;8;13;24;3;6;9;11;18;26;16;5;85
540000;Urkundenfälschung §§ 267-271, 273-279, 281 StGB;3101000;Braunschweig;W;57;0;0;0;0;0;0;6;12;18;9;27;2;3;5;3;8;4;6;4;30
540000;Urkundenfälschung §§ 267-271, 273-279, 281 StGB;3101000;Braunschweig;X;166;0;0;0;0;3;3;7;19;26;22;51;5;9;14;14;26;30;22;9;115
540000;Urkundenfälschung §§ 267-271, 273-279, 281 StGB;4011000;Bremen;M;270;0;0;0;0;0;0;3;18;21;19;40;11;17;28;33;83;46;27;13;230
540000;Urkundenfälschung §§ 267-271, 273-279, 281 StGB;4011000;Bremen;W;75;0;0;0;0;0;0;1;25;26;8;34;5;3;8;5;10;9;6;3;41
540000;Urkundenfälschung §§ 267-271, 273-279, 281 StGB;4011000;Bremen;X;345;0;0;0;0;0;0;4;43;47;27;74;16;20;36;38;93;55;33;16;271
540000;Urkundenfälschung §§ 267-271, 273-279, 281 StGB;4012000;Bremerhaven;M;71;0;0;0;0;0;0;0;0;0;3;3;3;3;6;13;17;14;11;7;68
540000;Urkundenfälschung §§ 267-271, 273-279, 281 StGB;4012000;Bremerhaven;W;20;0;0;0;0;0;0;0;0;0;4;4;2;0;2;2;3;4;3;2;16
540000;Urkundenfälschung §§ 267-271, 273-279, 281 StGB;4012000;Bremerhaven;X;91;0;0;0;0;0;0;0;0;0;7;7;5;3;8;15;20;18;14;9;84
540000;Urkundenfälschung §§ 267-271, 273-279, 281 StGB;14511000;Chemnitz;M;82;0;0;0;0;0;0;1;2;3;4;7;1;5;6;21;24;12;8;4;75
540000;Urkundenfälschung §§ 267-271, 273-279, 281 StGB;14511000;Chemnitz;W;18;0;0;0;0;0;0;0;0;0;0;0;2;0;2;4;8;3;0;1;18
540000;Urkundenfälschung §§ 267-271, 273-279, 281 StGB;14511000;Chemnitz;X;100;0;0;0;0;0;0;1;2;3;4;7;3;5;8;25;32;15;8;5;93
540000;Urkundenfälschung §§ 267-271, 273-279, 281 StGB;6411000;Darmstadt;M;55;0;0;0;0;0;0;0;4;4;3;7;4;2;6;12;15;10;4;1;48
540000;Urkundenfälschung §§ 267-271, 273-279, 281 StGB;6411000;Darmstadt;W;4;0;0;0;0;0;0;0;0;0;0;0;0;0;0;1;1;0;2;0;4
540000;Urkundenfälschung §§ 267-271, 273-279, 281 StGB;6411000;Darmstadt;X;59;0;0;0;0;0;0;0;4;4;3;7;4;2;6;13;16;10;6;1;52
540000;Urkundenfälschung §§ 267-271, 273-279, 281 StGB;5913000;Dortmund;M;385;0;0;0;0;1;1;3;13;16;25;42;22;26;48;53;118;60;43;21;343
540000;Urkundenfälschung §§ 267-271, 273-279, 281 StGB;5913000;Dortmund;W;62;0;0;0;0;0;0;0;7;7;7;14;5;5;10;8;14;10;4;2;48
540000;Urkundenfälschung §§ 267-271, 273-279, 281 StGB;5913000;Dortmund;X;447;0;0;0;0;1;1;3;20;23;32;56;27;31;58;61;132;70;47;23;391
540000;Urkundenfälschung §§ 267-271, 273-279, 281 StGB;14612000;Dresden;M;221;0;0;0;0;0;0;2;5;7;10;17;7;9;16;43;79;36;21;9;204
540000;Urkundenfälschung §§ 267-271, 273-279, 281 StGB;14612000;Dresden;W;50;0;0;0;0;0;0;4;0;4;2;6;2;3;5;9;15;11;3;1;44
540000;Urkundenfälschung §§ 267-271, 273-279, 281 StGB;14612000;Dresden;X;271;0;0;0;0;0;0;6;5;11;12;23;9;12;21;52;94;47;24;10;248
540000;Urkundenfälschung §§ 267-271, 273-279, 281 StGB;5112000;Duisburg;M;342;0;0;0;0;2;2;5;10;15;27;44;22;18;40;42;89;83;33;11;298
540000;Urkundenfälschung §§ 267-271, 273-279, 281 StGB;5112000;Duisburg;W;103;0;0;0;0;1;1;4;6;10;8;19;10;9;19;16;18;19;9;3;84
540000;Urkundenfälschung §§ 267-271, 273-279, 281 StGB;5112000;Duisburg;X;445;0;0;0;0;3;3;9;16;25;35;63;32;27;59;58;107;102;42;14;382
540000;Urkundenfälschung §§ 267-271, 273-279, 281 StGB;5111000;Düsseldorf;M;559;0;0;0;0;1;1;5;16;21;41;63;37;52;89;95;143;84;50;35;496
540000;Urkundenfälschung §§ 267-271, 273-279, 281 StGB;5111000;Düsseldorf;W;154;1;0;0;0;1;2;5;15;20;17;39;5;14;19;24;32;19;10;11;115
540000;Urkundenfälschung §§ 267-271, 273-279, 281 StGB;5111000;Düsseldorf;X;713;1;0;0;0;2;3;10;31;41;58;102;42;66;108;119;175;103;60;46;611
540000;Urkundenfälschung §§ 267-271, 273-279, 281 StGB;16051000;Erfurt;M;50;0;0;0;0;0;0;0;1;1;4;5;3;3;6;5;13;8;8;5;45
540000;Urkundenfälschung §§ 267-271, 273-279, 281 StGB;16051000;Erfurt;W;33;0;0;0;0;1;1;1;2;3;4;8;2;3;5;7;7;2;4;0;25
540000;Urkundenfälschung §§ 267-271, 273-279, 281 StGB;16051000;Erfurt;X;83;0;0;0;0;1;1;1;3;4;8;13;5;6;11;12;20;10;12;5;70
540000;Urkundenfälschung §§ 267-271, 273-279, 281 StGB;9562000;Erlangen;M;68;0;0;0;0;0;0;1;7;8;3;11;3;7;10;12;14;13;3;5;57
540000;Urkundenfälschung §§ 267-271, 273-279, 281 StGB;9562000;Erlangen;W;11;0;0;0;0;0;0;2;1;3;1;4;1;0;1;0;2;2;1;1;7
540000;Urkundenfälschung §§ 267-271, 273-279, 281 StGB;9562000;Erlangen;X;79;0;0;0;0;0;0;3;8;11;4;15;4;7;11;12;16;15;4;6;64
540000;Urkundenfälschung §§ 267-271, 273-279, 281 StGB;5113000;Essen;M;255;0;0;1;2;1;4;4;7;11;16;31;16;17;33;39;63;52;21;16;224
540000;Urkundenfälschung §§ 267-271, 273-279, 281 StGB;5113000;Essen;W;58;0;0;0;0;0;0;0;0;0;0;0;1;3;4;11;23;11;5;4;58
540000;Urkundenfälschung §§ 267-271, 273-279, 281 StGB;5113000;Essen;X;313;0;0;1;2;1;4;4;7;11;16;31;17;20;37;50;86;63;26;20;282
540000;Urkundenfälschung §§ 267-271, 273-279, 281 StGB;6412000;Frankfurt am Main;M;822;7;3;2;2;2;16;6;35;41;49;106;39;68;107;174;238;119;48;30;716
540000;Urkundenfälschung §§ 267-271, 273-279, 281 StGB;6412000;Frankfurt am Main;W;229;8;2;1;1;0;12;8;8;16;11;39;16;12;28;46;56;32;19;9;190
540000;Urkundenfälschung §§ 267-271, 273-279, 281 StGB;6412000;Frankfurt am Main;X;1051;15;5;3;3;2;28;14;43;57;60;145;55;80;135;220;294;151;67;39;906
540000;Urkundenfälschung §§ 267-271, 273-279, 281 StGB;8311000;Freiburg im Breisgau;M;127;0;0;0;0;0;0;2;11;13;7;20;5;6;11;22;30;23;16;5;107
540000;Urkundenfälschung §§ 267-271, 273-279, 281 StGB;8311000;Freiburg im Breisgau;W;28;0;0;0;0;1;1;2;5;7;3;11;1;0;1;3;7;4;2;0;17
540000;Urkundenfälschung §§ 267-271, 273-279, 281 StGB;8311000;Freiburg im Breisgau;X;155;0;0;0;0;1;1;4;16;20;10;31;6;6;12;25;37;27;18;5;124
540000;Urkundenfälschung §§ 267-271, 273-279, 281 StGB;9563000;Fürth;M;39;0;0;0;0;1;1;0;2;2;4;7;1;1;2;8;8;8;6;0;32
540000;Urkundenfälschung §§ 267-271, 273-279, 281 StGB;9563000;Fürth;W;11;0;0;0;0;0;0;0;0;0;0;0;0;1;1;1;2;3;2;2;11
540000;Urkundenfälschung §§ 267-271, 273-279, 281 StGB;9563000;Fürth;X;50;0;0;0;0;1;1;0;2;2;4;7;1;2;3;9;10;11;8;2;43
540000;Urkundenfälschung §§ 267-271, 273-279, 281 StGB;5513000;Gelsenkirchen;M;148;0;0;0;0;1;1;1;3;4;8;13;7;6;13;25;39;33;20;5;135
540000;Urkundenfälschung §§ 267-271, 273-279, 281 StGB;5513000;Gelsenkirchen;W;23;0;0;0;0;0;0;0;1;1;2;3;1;2;3;5;3;5;4;0;20
540000;Urkundenfälschung §§ 267-271, 273-279, 281 StGB;5513000;Gelsenkirchen;X;171;0;0;0;0;1;1;1;4;5;10;16;8;8;16;30;42;38;24;5;155
540000;Urkundenfälschung §§ 267-271, 273-279, 281 StGB;3152012;Göttingen;M;47;0;0;0;0;0;0;0;2;2;4;6;3;2;5;5;10;11;7;3;41
540000;Urkundenfälschung §§ 267-271, 273-279, 281 StGB;3152012;Göttingen;W;12;0;0;0;0;0;0;1;2;3;0;3;1;0;1;0;1;4;3;0;9
540000;Urkundenfälschung §§ 267-271, 273-279, 281 StGB;3152012;Göttingen;X;59;0;0;0;0;0;0;1;4;5;4;9;4;2;6;5;11;15;10;3;50
540000;Urkundenfälschung §§ 267-271, 273-279, 281 StGB;5914000;Hagen;M;80;0;0;0;0;0;0;0;2;2;9;11;2;2;4;14;23;21;5;2;69
540000;Urkundenfälschung §§ 267-271, 273-279, 281 StGB;5914000;Hagen;W;19;0;0;0;0;0;0;0;2;2;1;3;2;1;3;0;5;7;0;1;16
540000;Urkundenfälschung §§ 267-271, 273-279, 281 StGB;5914000;Hagen;X;99;0;0;0;0;0;0;0;4;4;10;14;4;3;7;14;28;28;5;3;85
540000;Urkundenfälschung §§ 267-271, 273-279, 281 StGB;15002000;Halle (Saale);M;125;0;0;0;0;1;1;3;2;5;2;8;5;10;15;26;35;26;12;3;117
540000;Urkundenfälschung §§ 267-271, 273-279, 281 StGB;15002000;Halle (Saale);W;35;0;0;0;0;0;0;2;1;3;0;3;2;5;7;6;8;6;0;5;32
540000;Urkundenfälschung §§ 267-271, 273-279, 281 StGB;15002000;Halle (Saale);X;160;0;0;0;0;1;1;5;3;8;2;11;7;15;22;32;43;32;12;8;149
540000;Urkundenfälschung §§ 267-271, 273-279, 281 StGB;2000000;Hamburg;M;858;0;1;1;0;1;3;10;58;68;59;130;65;63;128;126;214;143;81;36;728
540000;Urkundenfälschung §§ 267-271, 273-279, 281 StGB;2000000;Hamburg;W;240;0;0;0;0;2;2;8;46;54;29;85;10;18;28;24;40;34;21;8;155
540000;Urkundenfälschung §§ 267-271, 273-279, 281 StGB;2000000;Hamburg;X;1098;0;1;1;0;3;5;18;104;122;88;215;75;81;156;150;254;177;102;44;883
540000;Urkundenfälschung §§ 267-271, 273-279, 281 StGB;5915000;Hamm;M;105;0;0;0;0;0;0;1;2;3;8;11;3;10;13;19;20;26;14;2;94
540000;Urkundenfälschung §§ 267-271, 273-279, 281 StGB;5915000;Hamm;W;10;0;0;0;0;0;0;0;0;0;0;0;1;0;1;0;5;3;1;0;10
540000;Urkundenfälschung §§ 267-271, 273-279, 281 StGB;5915000;Hamm;X;115;0;0;0;0;0;0;1;2;3;8;11;4;10;14;19;25;29;15;2;104
540000;Urkundenfälschung §§ 267-271, 273-279, 281 StGB;3241001;Hannover;M;426;1;0;0;3;0;4;5;23;28;22;54;28;29;57;65;121;68;41;20;372
540000;Urkundenfälschung §§ 267-271, 273-279, 281 StGB;3241001;Hannover;W;119;1;1;0;0;1;3;5;18;23;10;36;6;8;14;17;19;17;13;3;83
540000;Urkundenfälschung §§ 267-271, 273-279, 281 StGB;3241001;Hannover;X;545;2;1;0;3;1;7;10;41;51;32;90;34;37;71;82;140;85;54;23;455
540000;Urkundenfälschung §§ 267-271, 273-279, 281 StGB;8221000;Heidelberg;M;64;0;0;0;0;0;0;1;6;7;5;12;3;1;4;6;23;10;8;1;52
540000;Urkundenfälschung §§ 267-271, 273-279, 281 StGB;8221000;Heidelberg;W;18;0;0;0;0;0;0;0;0;0;2;2;2;3;5;3;3;4;1;0;16
540000;Urkundenfälschung §§ 267-271, 273-279, 281 StGB;8221000;Heidelberg;X;82;0;0;0;0;0;0;1;6;7;7;14;5;4;9;9;26;14;9;1;68
540000;Urkundenfälschung §§ 267-271, 273-279, 281 StGB;8121000;Heilbronn;M;48;0;0;0;0;0;0;0;0;0;3;3;5;0;5;13;13;8;3;3;45
540000;Urkundenfälschung §§ 267-271, 273-279, 281 StGB;8121000;Heilbronn;W;5;0;0;0;0;0;0;0;0;0;1;1;0;0;0;1;2;0;1;0;4
540000;Urkundenfälschung §§ 267-271, 273-279, 281 StGB;8121000;Heilbronn;X;53;0;0;0;0;0;0;0;0;0;4;4;5;0;5;14;15;8;4;3;49
540000;Urkundenfälschung §§ 267-271, 273-279, 281 StGB;5916000;Herne;M;56;0;0;0;0;1;1;0;1;1;2;4;4;2;6;8;15;12;6;5;52
540000;Urkundenfälschung §§ 267-271, 273-279, 281 StGB;5916000;Herne;W;22;0;0;0;0;0;0;0;1;1;0;1;1;1;2;4;4;4;4;3;21
540000;Urkundenfälschung §§ 267-271, 273-279, 281 StGB;5916000;Herne;X;78;0;0;0;0;1;1;0;2;2;2;5;5;3;8;12;19;16;10;8;73
540000;Urkundenfälschung §§ 267-271, 273-279, 281 StGB;9161000;Ingolstadt;M;32;0;0;0;0;0;0;0;0;0;2;2;5;1;6;6;7;7;3;1;30
540000;Urkundenfälschung §§ 267-271, 273-279, 281 StGB;9161000;Ingolstadt;W;15;0;0;0;0;0;0;1;1;2;0;2;0;2;2;3;4;2;0;2;13
540000;Urkundenfälschung §§ 267-271, 273-279, 281 StGB;9161000;Ingolstadt;X;47;0;0;0;0;0;0;1;1;2;2;4;5;3;8;9;11;9;3;3;43
540000;Urkundenfälschung §§ 267-271, 273-279, 281 StGB;16053000;Jena;M;41;0;0;0;0;0;0;0;0;0;4;4;4;4;8;5;17;4;2;1;37
540000;Urkundenfälschung §§ 267-271, 273-279, 281 StGB;16053000;Jena;W;10;0;0;0;0;1;1;0;0;0;1;2;0;0;0;1;1;2;3;1;8
540000;Urkundenfälschung §§ 267-271, 273-279, 281 StGB;16053000;Jena;X;51;0;0;0;0;1;1;0;0;0;5;6;4;4;8;6;18;6;5;2;45
540000;Urkundenfälschung §§ 267-271, 273-279, 281 StGB;8212000;Karlsruhe;M;132;0;0;0;0;0;0;2;2;4;11;15;5;4;9;28;38;25;11;6;117
540000;Urkundenfälschung §§ 267-271, 273-279, 281 StGB;8212000;Karlsruhe;W;53;0;0;0;0;0;0;1;7;8;5;13;3;1;4;7;12;7;9;1;40
540000;Urkundenfälschung §§ 267-271, 273-279, 281 StGB;8212000;Karlsruhe;X;185;0;0;0;0;0;0;3;9;12;16;28;8;5;13;35;50;32;20;7;157
540000;Urkundenfälschung §§ 267-271, 273-279, 281 StGB;6611000;Kassel;M;144;0;0;0;0;0;0;2;3;5;5;10;10;7;17;22;34;34;15;12;134
540000;Urkundenfälschung §§ 267-271, 273-279, 281 StGB;6611000;Kassel;W;42;0;0;0;0;0;0;0;4;4;2;6;1;5;6;6;7;10;3;4;36
540000;Urkundenfälschung §§ 267-271, 273-279, 281 StGB;6611000;Kassel;X;186;0;0;0;0;0;0;2;7;9;7;16;11;12;23;28;41;44;18;16;170
540000;Urkundenfälschung §§ 267-271, 273-279, 281 StGB;1002000;Kiel;M;128;0;0;0;0;0;0;0;6;6;5;11;5;6;11;12;37;29;17;11;117
540000;Urkundenfälschung §§ 267-271, 273-279, 281 StGB;1002000;Kiel;W;60;0;0;0;0;0;0;1;13;14;10;24;1;2;3;9;9;10;1;4;36
540000;Urkundenfälschung §§ 267-271, 273-279, 281 StGB;1002000;Kiel;X;188;0;0;0;0;0;0;1;19;20;15;35;6;8;14;21;46;39;18;15;153
540000;Urkundenfälschung §§ 267-271, 273-279, 281 StGB;7111000;Koblenz;M;49;0;0;0;0;0;0;2;6;8;4;12;3;3;6;2;15;7;6;1;37
540000;Urkundenfälschung §§ 267-271, 273-279, 281 StGB;7111000;Koblenz;W;14;0;0;0;0;1;1;0;1;1;3;5;0;2;2;1;2;2;2;0;9
540000;Urkundenfälschung §§ 267-271, 273-279, 281 StGB;7111000;Koblenz;X;63;0;0;0;0;1;1;2;7;9;7;17;3;5;8;3;17;9;8;1;46
540000;Urkundenfälschung §§ 267-271, 273-279, 281 StGB;5315000;Köln;M;679;0;0;0;0;6;6;13;20;33;50;89;41;43;84;102;198;99;75;32;590
540000;Urkundenfälschung §§ 267-271, 273-279, 281 StGB;5315000;Köln;W;166;0;0;0;0;2;2;6;10;16;18;36;7;9;16;23;28;28;24;11;130
540000;Urkundenfälschung §§ 267-271, 273-279, 281 StGB;5315000;Köln;X;845;0;0;0;0;8;8;19;30;49;68;125;48;52;100;125;226;127;99;43;720
540000;Urkundenfälschung §§ 267-271, 273-279, 281 StGB;5114000;Krefeld;M;153;0;0;0;0;0;0;2;0;2;7;9;7;10;17;21;29;36;28;13;144
540000;Urkundenfälschung §§ 267-271, 273-279, 281 StGB;5114000;Krefeld;W;28;0;0;0;0;0;0;0;1;1;3;4;2;1;3;4;4;6;7;0;24
540000;Urkundenfälschung §§ 267-271, 273-279, 281 StGB;5114000;Krefeld;X;181;0;0;0;0;0;0;2;1;3;10;13;9;11;20;25;33;42;35;13;168
540000;Urkundenfälschung §§ 267-271, 273-279, 281 StGB;14713000;Leipzig;M;288;0;0;0;0;0;0;0;3;3;23;26;14;21;35;52;83;53;26;13;262
540000;Urkundenfälschung §§ 267-271, 273-279, 281 StGB;14713000;Leipzig;W;64;0;0;0;0;2;2;2;0;2;4;8;3;5;8;10;21;10;7;0;56
540000;Urkundenfälschung §§ 267-271, 273-279, 281 StGB;14713000;Leipzig;X;352;0;0;0;0;2;2;2;3;5;27;34;17;26;43;62;104;63;33;13;318
540000;Urkundenfälschung §§ 267-271, 273-279, 281 StGB;5316000;Leverkusen;M;72;0;0;0;0;0;0;1;2;3;3;6;3;5;8;18;26;8;5;1;66
540000;Urkundenfälschung §§ 267-271, 273-279, 281 StGB;5316000;Leverkusen;W;17;0;0;0;0;0;0;0;0;0;2;2;1;1;2;3;7;2;0;1;15
540000;Urkundenfälschung §§ 267-271, 273-279, 281 StGB;5316000;Leverkusen;X;89;0;0;0;0;0;0;1;2;3;5;8;4;6;10;21;33;10;5;2;81
540000;Urkundenfälschung §§ 267-271, 273-279, 281 StGB;1003000;Lübeck;M;136;0;0;0;0;0;0;4;8;12;10;22;10;5;15;14;25;25;21;14;114
540000;Urkundenfälschung §§ 267-271, 273-279, 281 StGB;1003000;Lübeck;W;58;0;0;0;0;0;0;2;5;7;7;14;4;2;6;8;10;8;4;8;44
540000;Urkundenfälschung §§ 267-271, 273-279, 281 StGB;1003000;Lübeck;X;194;0;0;0;0;0;0;6;13;19;17;36;14;7;21;22;35;33;25;22;158
540000;Urkundenfälschung §§ 267-271, 273-279, 281 StGB;7314000;Ludwigshafen am Rhein;M;88;0;0;0;0;0;0;2;6;8;6;14;9;5;14;8;23;14;13;2;74
540000;Urkundenfälschung §§ 267-271, 273-279, 281 StGB;7314000;Ludwigshafen am Rhein;W;33;0;0;0;0;0;0;1;1;2;2;4;2;2;4;5;7;9;2;2;29
540000;Urkundenfälschung §§ 267-271, 273-279, 281 StGB;7314000;Ludwigshafen am Rhein;X;121;0;0;0;0;0;0;3;7;10;8;18;11;7;18;13;30;23;15;4;103
540000;Urkundenfälschung §§ 267-271, 273-279, 281 StGB;15003000;Magdeburg;M;443;0;0;0;0;0;0;1;4;5;12;17;17;24;41;85;110;113;58;19;426
540000;Urkundenfälschung §§ 267-271, 273-279, 281 StGB;15003000;Magdeburg;W;149;0;0;0;0;0;0;1;1;2;5;7;6;14;20;24;38;27;21;12;142
540000;Urkundenfälschung §§ 267-271, 273-279, 281 StGB;15003000;Magdeburg;X;592;0;0;0;0;0;0;2;5;7;17;24;23;38;61;109;148;140;79;31;568
540000;Urkundenfälschung §§ 267-271, 273-279, 281 StGB;7315000;Mainz;M;90;0;0;0;0;0;0;0;7;7;8;15;8;7;15;18;20;9;7;6;75
540000;Urkundenfälschung §§ 267-271, 273-279, 281 StGB;7315000;Mainz;W;37;0;0;0;0;1;1;1;1;2;3;6;3;4;7;4;5;5;5;5;31
540000;Urkundenfälschung §§ 267-271, 273-279, 281 StGB;7315000;Mainz;X;127;0;0;0;0;1;1;1;8;9;11;21;11;11;22;22;25;14;12;11;106
540000;Urkundenfälschung §§ 267-271, 273-279, 281 StGB;8222000;Mannheim;M;130;0;0;0;0;0;0;3;3;6;4;10;10;9;19;21;34;24;14;8;120
540000;Urkundenfälschung §§ 267-271, 273-279, 281 StGB;8222000;Mannheim;W;43;0;0;0;0;0;0;2;3;5;2;7;3;1;4;6;13;8;4;1;36
540000;Urkundenfälschung §§ 267-271, 273-279, 281 StGB;8222000;Mannheim;X;173;0;0;0;0;0;0;5;6;11;6;17;13;10;23;27;47;32;18;9;156
540000;Urkundenfälschung §§ 267-271, 273-279, 281 StGB;5170024;Moers;M;43;0;0;0;0;0;0;0;2;2;1;3;2;0;2;7;14;8;5;4;40
540000;Urkundenfälschung §§ 267-271, 273-279, 281 StGB;5170024;Moers;W;7;0;0;0;0;0;0;0;0;0;0;0;0;0;0;3;2;0;2;0;7
540000;Urkundenfälschung §§ 267-271, 273-279, 281 StGB;5170024;Moers;X;50;0;0;0;0;0;0;0;2;2;1;3;2;0;2;10;16;8;7;4;47
540000;Urkundenfälschung §§ 267-271, 273-279, 281 StGB;5116000;Mönchengladbach;M;130;0;0;0;0;0;0;1;5;6;9;15;11;9;20;24;30;24;11;6;115
540000;Urkundenfälschung §§ 267-271, 273-279, 281 StGB;5116000;Mönchengladbach;W;44;0;0;0;0;0;0;0;2;2;3;5;4;2;6;5;6;15;7;0;39
540000;Urkundenfälschung §§ 267-271, 273-279, 281 StGB;5116000;Mönchengladbach;X;174;0;0;0;0;0;0;1;7;8;12;20;15;11;26;29;36;39;18;6;154
540000;Urkundenfälschung §§ 267-271, 273-279, 281 StGB;5117000;Mülheim an der Ruhr;M;45;0;0;0;0;0;0;0;2;2;2;4;4;4;8;6;13;9;2;3;41
540000;Urkundenfälschung §§ 267-271, 273-279, 281 StGB;5117000;Mülheim an der Ruhr;W;9;0;0;0;0;0;0;0;0;0;0;0;0;1;1;2;1;3;1;1;9
540000;Urkundenfälschung §§ 267-271, 273-279, 281 StGB;5117000;Mülheim an der Ruhr;X;54;0;0;0;0;0;0;0;2;2;2;4;4;5;9;8;14;12;3;4;50
540000;Urkundenfälschung §§ 267-271, 273-279, 281 StGB;9162000;München;M;851;0;0;0;0;1;1;11;64;75;73;149;41;49;90;119;206;158;84;45;702
540000;Urkundenfälschung §§ 267-271, 273-279, 281 StGB;9162000;München;W;320;0;0;0;0;1;1;12;76;88;33;122;19;30;49;37;48;32;20;12;198
540000;Urkundenfälschung §§ 267-271, 273-279, 281 StGB;9162000;München;X;1171;0;0;0;0;2;2;23;140;163;106;271;60;79;139;156;254;190;104;57;900
540000;Urkundenfälschung §§ 267-271, 273-279, 281 StGB;5515000;Münster;M;130;0;0;0;0;0;0;3;9;12;6;18;7;8;15;22;39;19;13;4;112
540000;Urkundenfälschung §§ 267-271, 273-279, 281 StGB;5515000;Münster;W;31;0;0;0;0;0;0;1;5;6;5;11;0;1;1;6;3;7;2;1;20
540000;Urkundenfälschung §§ 267-271, 273-279, 281 StGB;5515000;Münster;X;161;0;0;0;0;0;0;4;14;18;11;29;7;9;16;28;42;26;15;5;132
540000;Urkundenfälschung §§ 267-271, 273-279, 281 StGB;5162024;Neuss;M;38;0;0;0;0;0;0;1;0;1;1;2;0;2;2;6;12;9;5;2;36
540000;Urkundenfälschung §§ 267-271, 273-279, 281 StGB;5162024;Neuss;W;8;0;0;0;0;0;0;0;0;0;0;0;1;0;1;2;2;0;2;1;8
540000;Urkundenfälschung §§ 267-271, 273-279, 281 StGB;5162024;Neuss;X;46;0;0;0;0;0;0;1;0;1;1;2;1;2;3;8;14;9;7;3;44
540000;Urkundenfälschung §§ 267-271, 273-279, 281 StGB;9564000;Nürnberg;M;424;0;0;0;0;1;1;10;38;48;43;92;30;31;61;43;105;63;33;27;332
540000;Urkundenfälschung §§ 267-271, 273-279, 281 StGB;9564000;Nürnberg;W;164;0;0;0;0;0;0;9;40;49;23;72;2;7;9;13;35;11;14;10;92
540000;Urkundenfälschung §§ 267-271, 273-279, 281 StGB;9564000;Nürnberg;X;588;0;0;0;0;1;1;19;78;97;66;164;32;38;70;56;140;74;47;37;424
540000;Urkundenfälschung §§ 267-271, 273-279, 281 StGB;5119000;Oberhausen;M;108;0;0;0;0;0;0;0;2;2;9;11;5;10;15;19;30;22;10;1;97
540000;Urkundenfälschung §§ 267-271, 273-279, 281 StGB;5119000;Oberhausen;W;37;0;0;0;0;0;0;0;1;1;1;2;2;4;6;11;7;4;5;2;35
540000;Urkundenfälschung §§ 267-271, 273-279, 281 StGB;5119000;Oberhausen;X;145;0;0;0;0;0;0;0;3;3;10;13;7;14;21;30;37;26;15;3;132
540000;Urkundenfälschung §§ 267-271, 273-279, 281 StGB;6413000;Offenbach am Main;M;121;0;0;0;0;0;0;0;2;2;3;5;0;7;7;28;47;20;10;4;116
540000;Urkundenfälschung §§ 267-271, 273-279, 281 StGB;6413000;Offenbach am Main;W;26;0;0;0;0;0;0;0;0;0;0;0;4;1;5;2;8;2;6;3;26
540000;Urkundenfälschung §§ 267-271, 273-279, 281 StGB;6413000;Offenbach am Main;X;147;0;0;0;0;0;0;0;2;2;3;5;4;8;12;30;55;22;16;7;142
540000;Urkundenfälschung §§ 267-271, 273-279, 281 StGB;3403000;Oldenburg (Oldenburg);M;100;0;0;0;0;2;2;8;9;17;4;23;3;5;8;14;25;15;12;3;77
540000;Urkundenfälschung §§ 267-271, 273-279, 281 StGB;3403000;Oldenburg (Oldenburg);W;31;0;0;0;0;0;0;0;1;1;3;4;1;1;2;7;6;1;6;5;27
540000;Urkundenfälschung §§ 267-271, 273-279, 281 StGB;3403000;Oldenburg (Oldenburg);X;131;0;0;0;0;2;2;8;10;18;7;27;4;6;10;21;31;16;18;8;104
540000;Urkundenfälschung §§ 267-271, 273-279, 281 StGB;3404000;Osnabrück;M;92;0;0;0;0;0;0;0;2;2;4;6;4;7;11;20;21;19;8;7;86
540000;Urkundenfälschung §§ 267-271, 273-279, 281 StGB;3404000;Osnabrück;W;33;0;0;0;0;0;0;0;1;1;2;3;5;2;7;4;9;8;1;1;30
540000;Urkundenfälschung §§ 267-271, 273-279, 281 StGB;3404000;Osnabrück;X;125;0;0;0;0;0;0;0;3;3;6;9;9;9;18;24;30;27;9;8;116
540000;Urkundenfälschung §§ 267-271, 273-279, 281 StGB;5774032;Paderborn;M;45;0;0;0;0;0;0;0;1;1;5;6;4;3;7;8;11;10;3;0;39
540000;Urkundenfälschung §§ 267-271, 273-279, 281 StGB;5774032;Paderborn;W;9;0;0;0;0;0;0;0;1;1;0;1;0;2;2;2;1;3;0;0;8
540000;Urkundenfälschung §§ 267-271, 273-279, 281 StGB;5774032;Paderborn;X;54;0;0;0;0;0;0;0;2;2;5;7;4;5;9;10;12;13;3;0;47
540000;Urkundenfälschung §§ 267-271, 273-279, 281 StGB;8231000;Pforzheim;M;69;0;0;0;0;0;0;1;3;4;3;7;3;5;8;7;16;18;7;6;62
540000;Urkundenfälschung §§ 267-271, 273-279, 281 StGB;8231000;Pforzheim;W;19;0;0;0;0;0;0;2;1;3;3;6;0;1;1;3;3;3;3;0;13
540000;Urkundenfälschung §§ 267-271, 273-279, 281 StGB;8231000;Pforzheim;X;88;0;0;0;0;0;0;3;4;7;6;13;3;6;9;10;19;21;10;6;75
540000;Urkundenfälschung §§ 267-271, 273-279, 281 StGB;12054000;Potsdam;M;75;0;0;0;0;0;0;1;0;1;1;2;4;6;10;13;25;10;15;0;73
540000;Urkundenfälschung §§ 267-271, 273-279, 281 StGB;12054000;Potsdam;W;21;0;0;0;0;0;0;0;2;2;2;4;1;1;2;3;7;2;2;1;17
540000;Urkundenfälschung §§ 267-271, 273-279, 281 StGB;12054000;Potsdam;X;96;0;0;0;0;0;0;1;2;3;3;6;5;7;12;16;32;12;17;1;90
540000;Urkundenfälschung §§ 267-271, 273-279, 281 StGB;5562032;Recklinghausen;M;49;0;0;0;0;0;0;0;1;1;2;3;2;2;4;10;14;10;8;0;46
540000;Urkundenfälschung §§ 267-271, 273-279, 281 StGB;5562032;Recklinghausen;W;19;0;0;0;0;0;0;0;0;0;2;2;1;0;1;2;7;4;2;1;17
540000;Urkundenfälschung §§ 267-271, 273-279, 281 StGB;5562032;Recklinghausen;X;68;0;0;0;0;0;0;0;1;1;4;5;3;2;5;12;21;14;10;1;63
540000;Urkundenfälschung §§ 267-271, 273-279, 281 StGB;9362000;Regensburg;M;63;0;0;0;0;0;0;1;3;4;5;9;4;3;7;10;13;13;7;4;54
540000;Urkundenfälschung §§ 267-271, 273-279, 281 StGB;9362000;Regensburg;W;17;0;0;0;0;0;0;0;3;3;3;6;0;0;0;3;1;4;1;2;11
540000;Urkundenfälschung §§ 267-271, 273-279, 281 StGB;9362000;Regensburg;X;80;0;0;0;0;0;0;1;6;7;8;15;4;3;7;13;14;17;8;6;65
540000;Urkundenfälschung §§ 267-271, 273-279, 281 StGB;5120000;Remscheid;M;67;0;0;0;0;0;0;0;1;1;3;4;5;2;7;8;27;12;7;2;63
540000;Urkundenfälschung §§ 267-271, 273-279, 281 StGB;5120000;Remscheid;W;19;0;0;0;0;0;0;0;0;0;1;1;2;2;4;4;5;1;1;3;18
540000;Urkundenfälschung §§ 267-271, 273-279, 281 StGB;5120000;Remscheid;X;86;0;0;0;0;0;0;0;1;1;4;5;7;4;11;12;32;13;8;5;81
540000;Urkundenfälschung §§ 267-271, 273-279, 281 StGB;8415061;Reutlingen;M;30;0;0;0;0;0;0;0;1;1;5;6;4;0;4;3;7;5;2;3;24
540000;Urkundenfälschung §§ 267-271, 273-279, 281 StGB;8415061;Reutlingen;W;5;0;0;0;0;0;0;1;0;1;1;2;0;2;2;0;0;1;0;0;3
540000;Urkundenfälschung §§ 267-271, 273-279, 281 StGB;8415061;Reutlingen;X;35;0;0;0;0;0;0;1;1;2;6;8;4;2;6;3;7;6;2;3;27
540000;Urkundenfälschung §§ 267-271, 273-279, 281 StGB;13003000;Rostock;M;108;1;0;0;0;0;1;1;2;3;4;8;8;8;16;23;28;18;9;6;100
540000;Urkundenfälschung §§ 267-271, 273-279, 281 StGB;13003000;Rostock;W;37;1;0;0;0;0;1;0;1;1;0;2;0;2;2;7;14;3;6;3;35
540000;Urkundenfälschung §§ 267-271, 273-279, 281 StGB;13003000;Rostock;X;145;2;0;0;0;0;2;1;3;4;4;10;8;10;18;30;42;21;15;9;135
540000;Urkundenfälschung §§ 267-271, 273-279, 281 StGB;10041100;Saarbrücken;M;158;0;0;0;0;0;0;3;8;11;7;18;10;11;21;29;33;30;20;7;140
540000;Urkundenfälschung §§ 267-271, 273-279, 281 StGB;10041100;Saarbrücken;W;32;0;0;0;0;1;1;0;0;0;4;5;0;1;1;10;5;2;6;3;27
540000;Urkundenfälschung §§ 267-271, 273-279, 281 StGB;10041100;Saarbrücken;X;190;0;0;0;0;1;1;3;8;11;11;23;10;12;22;39;38;32;26;10;167
540000;Urkundenfälschung §§ 267-271, 273-279, 281 StGB;5122000;Solingen;M;57;0;0;0;0;0;0;0;3;3;1;4;2;3;5;5;11;19;9;4;53
540000;Urkundenfälschung §§ 267-271, 273-279, 281 StGB;5122000;Solingen;W;12;0;0;0;0;0;0;0;0;0;1;1;0;1;1;1;1;3;4;1;11
540000;Urkundenfälschung §§ 267-271, 273-279, 281 StGB;5122000;Solingen;X;69;0;0;0;0;0;0;0;3;3;2;5;2;4;6;6;12;22;13;5;64
540000;Urkundenfälschung §§ 267-271, 273-279, 281 StGB;8111000;Stuttgart;M;374;0;0;0;1;0;1;9;41;50;31;82;24;26;50;54;75;62;37;14;292
540000;Urkundenfälschung §§ 267-271, 273-279, 281 StGB;8111000;Stuttgart;W;143;0;0;0;0;3;3;27;33;60;24;87;5;2;7;11;19;12;4;3;56
540000;Urkundenfälschung §§ 267-271, 273-279, 281 StGB;8111000;Stuttgart;X;517;0;0;0;1;3;4;36;74;110;55;169;29;28;57;65;94;74;41;17;348
540000;Urkundenfälschung §§ 267-271, 273-279, 281 StGB;7211000;Trier;M;67;0;0;0;0;0;0;1;0;1;5;6;4;4;8;16;21;9;4;3;61
540000;Urkundenfälschung §§ 267-271, 273-279, 281 StGB;7211000;Trier;W;18;0;0;0;0;0;0;0;0;0;3;3;2;1;3;2;8;1;1;0;15
540000;Urkundenfälschung §§ 267-271, 273-279, 281 StGB;7211000;Trier;X;85;0;0;0;0;0;0;1;0;1;8;9;6;5;11;18;29;10;5;3;76
540000;Urkundenfälschung §§ 267-271, 273-279, 281 StGB;8421000;Ulm;M;43;0;0;0;1;0;1;2;3;5;2;8;1;4;5;8;11;3;4;4;35
540000;Urkundenfälschung §§ 267-271, 273-279, 281 StGB;8421000;Ulm;W;10;0;0;0;0;0;0;1;3;4;1;5;0;0;0;0;1;3;1;0;5
540000;Urkundenfälschung §§ 267-271, 273-279, 281 StGB;8421000;Ulm;X;53;0;0;0;1;0;1;3;6;9;3;13;1;4;5;8;12;6;5;4;40
540000;Urkundenfälschung §§ 267-271, 273-279, 281 StGB;6414000;Wiesbaden;M;104;0;0;0;0;0;0;1;1;2;6;8;2;6;8;12;27;30;9;10;96
540000;Urkundenfälschung §§ 267-271, 273-279, 281 StGB;6414000;Wiesbaden;W;29;0;0;0;0;0;0;0;7;7;3;10;0;0;0;6;6;4;2;1;19
540000;Urkundenfälschung §§ 267-271, 273-279, 281 StGB;6414000;Wiesbaden;X;133;0;0;0;0;0;0;1;8;9;9;18;2;6;8;18;33;34;11;11;115
540000;Urkundenfälschung §§ 267-271, 273-279, 281 StGB;3103000;Wolfsburg;M;58;0;0;0;0;0;0;1;2;3;3;6;3;5;8;9;11;12;7;5;52
540000;Urkundenfälschung §§ 267-271, 273-279, 281 StGB;3103000;Wolfsburg;W;7;0;0;0;0;0;0;0;0;0;0;0;0;0;0;1;4;1;1;0;7
540000;Urkundenfälschung §§ 267-271, 273-279, 281 StGB;3103000;Wolfsburg;X;65;0;0;0;0;0;0;1;2;3;3;6;3;5;8;10;15;13;8;5;59
540000;Urkundenfälschung §§ 267-271, 273-279, 281 StGB;5124000;Wuppertal;M;221;0;0;0;0;0;0;3;6;9;8;17;4;9;13;31;64;44;39;13;204
540000;Urkundenfälschung §§ 267-271, 273-279, 281 StGB;5124000;Wuppertal;W;47;0;0;0;0;1;1;3;1;4;1;6;1;3;4;4;14;7;10;2;41
540000;Urkundenfälschung §§ 267-271, 273-279, 281 StGB;5124000;Wuppertal;X;268;0;0;0;0;1;1;6;7;13;9;23;5;12;17;35;78;51;49;15;245
540000;Urkundenfälschung §§ 267-271, 273-279, 281 StGB;9663000;Würzburg;M;91;0;0;0;1;1;2;2;6;8;7;17;12;4;16;15;12;16;6;9;74
540000;Urkundenfälschung §§ 267-271, 273-279, 281 StGB;9663000;Würzburg;W;29;0;0;0;0;0;0;2;4;6;3;9;1;2;3;5;5;3;2;2;20
540000;Urkundenfälschung §§ 267-271, 273-279, 281 StGB;9663000;Würzburg;X;120;0;0;0;1;1;2;4;10;14;10;26;13;6;19;20;17;19;8;11;94
621020;Widerstand gegen Vollstreckungsbeamte;5334002;Aachen;M;109;0;0;0;0;0;0;9;13;22;15;37;12;8;20;19;16;9;6;2;72
621020;Widerstand gegen Vollstreckungsbeamte;5334002;Aachen;W;17;0;0;0;0;0;0;0;1;1;3;4;2;3;5;1;4;2;1;0;13
621020;Widerstand gegen Vollstreckungsbeamte;5334002;Aachen;X;126;0;0;0;0;0;0;9;14;23;18;41;14;11;25;20;20;11;7;2;85
621020;Widerstand gegen Vollstreckungsbeamte;9761000;Augsburg;M;85;0;0;0;0;0;0;1;6;7;10;17;11;10;21;15;16;7;8;1;68
621020;Widerstand gegen Vollstreckungsbeamte;9761000;Augsburg;W;5;0;0;0;0;0;0;0;0;0;2;2;1;0;1;1;1;0;0;0;3
621020;Widerstand gegen Vollstreckungsbeamte;9761000;Augsburg;X;90;0;0;0;0;0;0;1;6;7;12;19;12;10;22;16;17;7;8;1;71
621020;Widerstand gegen Vollstreckungsbeamte;5378004;Bergisch Gladbach;M;23;0;0;0;0;0;0;0;1;1;2;3;1;3;4;4;6;3;1;2;20
621020;Widerstand gegen Vollstreckungsbeamte;5378004;Bergisch Gladbach;W;3;0;0;0;0;0;0;0;0;0;0;0;1;0;1;1;0;1;0;0;3
621020;Widerstand gegen Vollstreckungsbeamte;5378004;Bergisch Gladbach;X;26;0;0;0;0;0;0;0;1;1;2;3;2;3;5;5;6;4;1;2;23
621020;Widerstand gegen Vollstreckungsbeamte;11000000;Berlin;M;1676;0;0;0;1;7;8;32;90;122;190;320;131;138;269;325;421;200;101;40;1356
621020;Widerstand gegen Vollstreckungsbeamte;11000000;Berlin;W;261;0;0;0;0;3;3;5;15;20;20;43;17;23;40;31;70;47;19;11;218
621020;Widerstand gegen Vollstreckungsbeamte;11000000;Berlin;X;1937;0;0;0;1;10;11;37;105;142;210;363;148;161;309;356;491;247;120;51;1574
621020;Widerstand gegen Vollstreckungsbeamte;5711000;Bielefeld;M;85;0;0;0;0;0;0;1;3;4;14;18;10;6;16;13;23;9;4;2;67
621020;Widerstand gegen Vollstreckungsbeamte;5711000;Bielefeld;W;10;0;0;0;0;0;0;0;1;1;0;1;0;0;0;2;1;4;2;0;9
621020;Widerstand gegen Vollstreckungsbeamte;5711000;Bielefeld;X;95;0;0;0;0;0;0;1;4;5;14;19;10;6;16;15;24;13;6;2;76
621020;Widerstand gegen Vollstreckungsbeamte;5911000;Bochum;M;149;0;0;0;0;0;0;2;8;10;24;34;16;16;32;18;29;20;9;7;115
621020;Widerstand gegen Vollstreckungsbeamte;5911000;Bochum;W;33;0;0;0;0;0;0;2;1;3;4;7;1;2;3;6;11;5;0;1;26
621020;Widerstand gegen Vollstreckungsbeamte;5911000;Bochum;X;182;0;0;0;0;0;0;4;9;13;28;41;17;18;35;24;40;25;9;8;141
621020;Widerstand gegen Vollstreckungsbeamte;5314000;Bonn;M;109;0;0;0;0;1;1;4;9;13;8;22;6;8;14;13;31;22;5;2;87
621020;Widerstand gegen Vollstreckungsbeamte;5314000;Bonn;W;13;0;0;0;0;0;0;1;0;1;1;2;0;2;2;2;5;1;1;0;11
621020;Widerstand gegen Vollstreckungsbeamte;5314000;Bonn;X;122;0;0;0;0;1;1;5;9;14;9;24;6;10;16;15;36;23;6;2;98
621020;Widerstand gegen Vollstreckungsbeamte;5512000;Bottrop;M;21;0;0;0;0;0;0;0;1;1;3;4;4;2;6;2;4;4;0;1;17
621020;Widerstand gegen Vollstreckungsbeamte;5512000;Bottrop;W;4;0;0;0;0;0;0;0;0;0;0;0;0;0;0;1;2;0;1;0;4
621020;Widerstand gegen Vollstreckungsbeamte;5512000;Bottrop;X;25;0;0;0;0;0;0;0;1;1;3;4;4;2;6;3;6;4;1;1;21
621020;Widerstand gegen Vollstreckungsbeamte;3101000;Braunschweig;M;67;0;0;0;0;0;0;0;3;3;8;11;8;10;18;11;13;5;7;2;56
621020;Widerstand gegen Vollstreckungsbeamte;3101000;Braunschweig;W;3;0;0;0;0;0;0;0;0;0;1;1;0;0;0;0;0;2;0;0;2
621020;Widerstand gegen Vollstreckungsbeamte;3101000;Braunschweig;X;70;0;0;0;0;0;0;0;3;3;9;12;8;10;18;11;13;7;7;2;58
621020;Widerstand gegen Vollstreckungsbeamte;4011000;Bremen;M;233;0;0;0;0;1;1;4;11;15;32;48;26;28;54;46;49;22;9;5;185
621020;Widerstand gegen Vollstreckungsbeamte;4011000;Bremen;W;38;0;0;0;0;1;1;0;1;1;6;8;2;3;5;8;9;4;3;1;30
621020;Widerstand gegen Vollstreckungsbeamte;4011000;Bremen;X;271;0;0;0;0;2;2;4;12;16;38;56;28;31;59;54;58;26;12;6;215
621020;Widerstand gegen Vollstreckungsbeamte;4012000;Bremerhaven;M;36;0;0;0;0;0;0;1;0;1;4;5;4;3;7;4;9;8;2;1;31
621020;Widerstand gegen Vollstreckungsbeamte;4012000;Bremerhaven;W;5;0;0;0;0;0;0;0;2;2;0;2;0;0;0;1;2;0;0;0;3
621020;Widerstand gegen Vollstreckungsbeamte;4012000;Bremerhaven;X;41;0;0;0;0;0;0;1;2;3;4;7;4;3;7;5;11;8;2;1;34
621020;Widerstand gegen Vollstreckungsbeamte;14511000;Chemnitz;M;80;0;0;0;0;0;0;0;1;1;6;7;7;14;21;21;16;9;5;1;73
621020;Widerstand gegen Vollstreckungsbeamte;14511000;Chemnitz;W;10;0;0;0;0;0;0;0;0;0;0;0;1;3;4;0;4;2;0;0;10
621020;Widerstand gegen Vollstreckungsbeamte;14511000;Chemnitz;X;90;0;0;0;0;0;0;0;1;1;6;7;8;17;25;21;20;11;5;1;83
621020;Widerstand gegen Vollstreckungsbeamte;6411000;Darmstadt;M;27;0;0;0;0;0;0;0;1;1;7;8;0;2;2;3;9;3;2;0;19
621020;Widerstand gegen Vollstreckungsbeamte;6411000;Darmstadt;W;4;0;0;0;0;0;0;0;0;0;0;0;0;1;1;2;0;1;0;0;4
621020;Widerstand gegen Vollstreckungsbeamte;6411000;Darmstadt;X;31;0;0;0;0;0;0;0;1;1;7;8;0;3;3;5;9;4;2;0;23
621020;Widerstand gegen Vollstreckungsbeamte;5913000;Dortmund;M;341;0;0;0;0;1;1;3;23;26;47;74;41;31;72;53;84;38;16;4;267
621020;Widerstand gegen Vollstreckungsbeamte;5913000;Dortmund;W;57;0;0;0;0;0;0;1;4;5;5;10;8;1;9;9;11;7;11;0;47
621020;Widerstand gegen Vollstreckungsbeamte;5913000;Dortmund;X;398;0;0;0;0;1;1;4;27;31;52;84;49;32;81;62;95;45;27;4;314
621020;Widerstand gegen Vollstreckungsbeamte;14612000;Dresden;M;146;0;0;0;0;0;0;1;5;6;7;13;13;14;27;45;41;10;4;6;133
621020;Widerstand gegen Vollstreckungsbeamte;14612000;Dresden;W;24;0;0;0;0;0;0;2;0;2;1;3;0;3;3;4;8;3;3;0;21
621020;Widerstand gegen Vollstreckungsbeamte;14612000;Dresden;X;170;0;0;0;0;0;0;3;5;8;8;16;13;17;30;49;49;13;7;6;154
621020;Widerstand gegen Vollstreckungsbeamte;5112000;Duisburg;M;202;0;1;0;1;0;2;3;7;10;20;32;13;16;29;25;56;42;11;7;170
621020;Widerstand gegen Vollstreckungsbeamte;5112000;Duisburg;W;41;0;1;0;0;0;1;3;2;5;0;6;2;2;4;6;11;4;7;3;35
621020;Widerstand gegen Vollstreckungsbeamte;5112000;Duisburg;X;243;0;2;0;1;0;3;6;9;15;20;38;15;18;33;31;67;46;18;10;205
621020;Widerstand gegen Vollstreckungsbeamte;5111000;Düsseldorf;M;333;0;0;0;0;1;1;5;16;21;54;76;43;27;70;52;70;37;21;7;257
621020;Widerstand gegen Vollstreckungsbeamte;5111000;Düsseldorf;W;52;0;0;0;0;0;0;3;0;3;3;6;6;2;8;3;13;14;7;1;46
621020;Widerstand gegen Vollstreckungsbeamte;5111000;Düsseldorf;X;385;0;0;0;0;1;1;8;16;24;57;82;49;29;78;55;83;51;28;8;303
621020;Widerstand gegen Vollstreckungsbeamte;16051000;Erfurt;M;139;0;0;0;0;1;1;1;6;7;14;22;9;14;23;38;38;9;4;5;117
621020;Widerstand gegen Vollstreckungsbeamte;16051000;Erfurt;W;14;0;0;0;0;0;0;1;0;1;0;1;2;0;2;3;4;1;2;1;13
621020;Widerstand gegen Vollstreckungsbeamte;16051000;Erfurt;X;153;0;0;0;0;1;1;2;6;8;14;23;11;14;25;41;42;10;6;6;130
621020;Widerstand gegen Vollstreckungsbeamte;9562000;Erlangen;M;9;0;0;0;0;0;0;0;0;0;1;1;1;1;2;1;2;3;0;0;8
621020;Widerstand gegen Vollstreckungsbeamte;9562000;Erlangen;W;1;0;0;0;0;0;0;0;0;0;0;0;1;0;1;0;0;0;0;0;1
621020;Widerstand gegen Vollstreckungsbeamte;9562000;Erlangen;X;10;0;0;0;0;0;0;0;0;0;1;1;2;1;3;1;2;3;0;0;9
621020;Widerstand gegen Vollstreckungsbeamte;5113000;Essen;M;223;0;0;0;0;0;0;1;12;13;40;53;25;14;39;37;39;38;11;6;170
621020;Widerstand gegen Vollstreckungsbeamte;5113000;Essen;W;59;0;0;0;0;0;0;6;4;10;6;16;3;4;7;10;10;10;5;1;43
621020;Widerstand gegen Vollstreckungsbeamte;5113000;Essen;X;282;0;0;0;0;0;0;7;16;23;46;69;28;18;46;47;49;48;16;7;213
621020;Widerstand gegen Vollstreckungsbeamte;6412000;Frankfurt am Main;M;357;0;0;0;0;0;0;0;11;11;46;57;30;36;66;72;96;45;17;4;300
621020;Widerstand gegen Vollstreckungsbeamte;6412000;Frankfurt am Main;W;63;0;0;0;0;1;1;2;4;6;3;10;3;2;5;12;21;9;4;2;53
621020;Widerstand gegen Vollstreckungsbeamte;6412000;Frankfurt am Main;X;420;0;0;0;0;1;1;2;15;17;49;67;33;38;71;84;117;54;21;6;353
621020;Widerstand gegen Vollstreckungsbeamte;8311000;Freiburg im Breisgau;M;99;0;0;0;0;0;0;6;13;19;16;35;8;6;14;8;21;12;9;0;64
621020;Widerstand gegen Vollstreckungsbeamte;8311000;Freiburg im Breisgau;W;11;0;0;0;0;0;0;0;0;0;2;2;1;2;3;1;2;2;1;0;9
621020;Widerstand gegen Vollstreckungsbeamte;8311000;Freiburg im Breisgau;X;110;0;0;0;0;0;0;6;13;19;18;37;9;8;17;9;23;14;10;0;73
621020;Widerstand gegen Vollstreckungsbeamte;9563000;Fürth;M;8;0;0;0;0;0;0;1;0;1;0;1;0;0;0;4;1;2;0;0;7
621020;Widerstand gegen Vollstreckungsbeamte;9563000;Fürth;W;2;0;0;0;0;1;1;0;0;0;0;1;0;0;0;0;0;0;1;0;1
621020;Widerstand gegen Vollstreckungsbeamte;9563000;Fürth;X;10;0;0;0;0;1;1;1;0;1;0;2;0;0;0;4;1;2;1;0;8
621020;Widerstand gegen Vollstreckungsbeamte;5513000;Gelsenkirchen;M;116;0;0;0;0;0;0;2;5;7;15;22;9;9;18;15;25;22;10;4;94
621020;Widerstand gegen Vollstreckungsbeamte;5513000;Gelsenkirchen;W;31;0;0;0;0;1;1;2;1;3;1;5;1;0;1;5;9;8;3;0;26
621020;Widerstand gegen Vollstreckungsbeamte;5513000;Gelsenkirchen;X;147;0;0;0;0;1;1;4;6;10;16;27;10;9;19;20;34;30;13;4;120
621020;Widerstand gegen Vollstreckungsbeamte;3152012;Göttingen;M;30;0;0;0;0;0;0;0;1;1;6;7;1;0;1;6;6;3;3;4;23
621020;Widerstand gegen Vollstreckungsbeamte;3152012;Göttingen;W;2;0;0;0;0;0;0;0;1;1;1;2;0;0;0;0;0;0;0;0;0
621020;Widerstand gegen Vollstreckungsbeamte;3152012;Göttingen;X;32;0;0;0;0;0;0;0;2;2;7;9;1;0;1;6;6;3;3;4;23
621020;Widerstand gegen Vollstreckungsbeamte;5914000;Hagen;M;64;0;0;0;0;0;0;0;2;2;10;12;3;6;9;9;15;13;6;0;52
621020;Widerstand gegen Vollstreckungsbeamte;5914000;Hagen;W;10;0;0;0;0;0;0;0;2;2;3;5;0;1;1;0;1;3;0;0;5
621020;Widerstand gegen Vollstreckungsbeamte;5914000;Hagen;X;74;0;0;0;0;0;0;0;4;4;13;17;3;7;10;9;16;16;6;0;57
621020;Widerstand gegen Vollstreckungsbeamte;15002000;Halle (Saale);M;102;0;0;0;0;0;0;1;2;3;6;9;8;9;17;23;28;16;5;4;93
621020;Widerstand gegen Vollstreckungsbeamte;15002000;Halle (Saale);W;6;0;0;0;0;0;0;1;0;1;1;2;0;1;1;1;1;0;0;1;4
621020;Widerstand gegen Vollstreckungsbeamte;15002000;Halle (Saale);X;108;0;0;0;0;0;0;2;2;4;7;11;8;10;18;24;29;16;5;5;97
621020;Widerstand gegen Vollstreckungsbeamte;2000000;Hamburg;M;672;0;0;1;0;2;3;13;26;39;77;119;54;63;117;113;180;82;42;19;553
621020;Widerstand gegen Vollstreckungsbeamte;2000000;Hamburg;W;120;0;0;0;0;2;2;5;11;16;9;27;10;11;21;13;29;20;7;3;93
621020;Widerstand gegen Vollstreckungsbeamte;2000000;Hamburg;X;792;0;0;1;0;4;5;18;37;55;86;146;64;74;138;126;209;102;49;22;646
621020;Widerstand gegen Vollstreckungsbeamte;5915000;Hamm;M;59;0;0;0;0;0;0;1;2;3;8;11;8;1;9;8;17;10;4;0;48
621020;Widerstand gegen Vollstreckungsbeamte;5915000;Hamm;W;4;0;0;0;0;0;0;0;0;0;0;0;0;1;1;2;0;1;0;0;4
621020;Widerstand gegen Vollstreckungsbeamte;5915000;Hamm;X;63;0;0;0;0;0;0;1;2;3;8;11;8;2;10;10;17;11;4;0;52
621020;Widerstand gegen Vollstreckungsbeamte;3241001;Hannover;M;222;0;0;0;0;0;0;1;10;11;37;48;22;16;38;39;44;30;19;4;174
621020;Widerstand gegen Vollstreckungsbeamte;3241001;Hannover;W;15;0;0;0;0;0;0;1;1;2;3;5;0;1;1;3;4;1;1;0;10
621020;Widerstand gegen Vollstreckungsbeamte;3241001;Hannover;X;237;0;0;0;0;0;0;2;11;13;40;53;22;17;39;42;48;31;20;4;184
621020;Widerstand gegen Vollstreckungsbeamte;8221000;Heidelberg;M;21;0;0;0;0;0;0;2;0;2;3;5;2;2;4;5;2;1;3;1;16
621020;Widerstand gegen Vollstreckungsbeamte;8221000;Heidelberg;W;1;0;0;0;0;0;0;0;0;0;0;0;0;0;0;0;0;0;0;1;1
621020;Widerstand gegen Vollstreckungsbeamte;8221000;Heidelberg;X;22;0;0;0;0;0;0;2;0;2;3;5;2;2;4;5;2;1;3;2;17
621020;Widerstand gegen Vollstreckungsbeamte;8121000;Heilbronn;M;15;0;0;0;0;0;0;1;1;2;2;4;2;1;3;2;3;3;0;0;11
621020;Widerstand gegen Vollstreckungsbeamte;8121000;Heilbronn;W;0;0;0;0;0;0;0;0;0;0;0;0;0;0;0;0;0;0;0;0;0
621020;Widerstand gegen Vollstreckungsbeamte;8121000;Heilbronn;X;15;0;0;0;0;0;0;1;1;2;2;4;2;1;3;2;3;3;0;0;11
621020;Widerstand gegen Vollstreckungsbeamte;5916000;Herne;M;47;0;0;0;0;0;0;2;2;4;7;11;3;7;10;7;8;8;2;1;36
621020;Widerstand gegen Vollstreckungsbeamte;5916000;Herne;W;6;0;0;0;0;0;0;0;0;0;2;2;0;0;0;1;1;0;2;0;4
621020;Widerstand gegen Vollstreckungsbeamte;5916000;Herne;X;53;0;0;0;0;0;0;2;2;4;9;13;3;7;10;8;9;8;4;1;40
621020;Widerstand gegen Vollstreckungsbeamte;9161000;Ingolstadt;M;15;0;0;0;0;0;0;0;0;0;0;0;2;1;3;3;5;3;1;0;15
621020;Widerstand gegen Vollstreckungsbeamte;9161000;Ingolstadt;W;3;0;0;0;0;0;0;0;0;0;0;0;1;0;1;1;0;1;0;0;3
621020;Widerstand gegen Vollstreckungsbeamte;9161000;Ingolstadt;X;18;0;0;0;0;0;0;0;0;0;0;0;3;1;4;4;5;4;1;0;18
621020;Widerstand gegen Vollstreckungsbeamte;16053000;Jena;M;72;0;0;0;0;0;0;0;2;2;11;13;7;9;16;10;18;7;8;0;59
621020;Widerstand gegen Vollstreckungsbeamte;16053000;Jena;W;7;0;0;0;0;0;0;0;0;0;0;0;1;1;2;2;1;1;1;0;7
621020;Widerstand gegen Vollstreckungsbeamte;16053000;Jena;X;79;0;0;0;0;0;0;0;2;2;11;13;8;10;18;12;19;8;9;0;66
621020;Widerstand gegen Vollstreckungsbeamte;8212000;Karlsruhe;M;46;0;0;0;0;0;0;1;1;2;9;11;7;3;10;11;5;7;2;0;35
621020;Widerstand gegen Vollstreckungsbeamte;8212000;Karlsruhe;W;7;0;0;0;0;0;0;0;0;0;0;0;0;0;0;2;2;2;1;0;7
621020;Widerstand gegen Vollstreckungsbeamte;8212000;Karlsruhe;X;53;0;0;0;0;0;0;1;1;2;9;11;7;3;10;13;7;9;3;0;42
621020;Widerstand gegen Vollstreckungsbeamte;6611000;Kassel;M;59;0;0;0;0;0;0;0;2;2;6;8;2;5;7;12;20;7;4;1;51
621020;Widerstand gegen Vollstreckungsbeamte;6611000;Kassel;W;9;0;0;0;0;0;0;0;1;1;1;2;1;0;1;2;2;2;0;0;7
621020;Widerstand gegen Vollstreckungsbeamte;6611000;Kassel;X;68;0;0;0;0;0;0;0;3;3;7;10;3;5;8;14;22;9;4;1;58
621020;Widerstand gegen Vollstreckungsbeamte;1002000;Kiel;M;83;0;0;0;0;0;0;1;2;3;11;14;4;5;9;24;12;14;6;4;69
621020;Widerstand gegen Vollstreckungsbeamte;1002000;Kiel;W;9;0;0;0;0;0;0;0;0;0;2;2;1;1;2;1;2;1;1;0;7
621020;Widerstand gegen Vollstreckungsbeamte;1002000;Kiel;X;92;0;0;0;0;0;0;1;2;3;13;16;5;6;11;25;14;15;7;4;76
621020;Widerstand gegen Vollstreckungsbeamte;7111000;Koblenz;M;62;0;0;0;0;1;1;1;4;5;8;14;9;6;15;10;10;3;5;5;48
621020;Widerstand gegen Vollstreckungsbeamte;7111000;Koblenz;W;9;0;0;0;0;0;0;0;1;1;1;2;0;0;0;1;2;2;2;0;7
621020;Widerstand gegen Vollstreckungsbeamte;7111000;Koblenz;X;71;0;0;0;0;1;1;1;5;6;9;16;9;6;15;11;12;5;7;5;55
621020;Widerstand gegen Vollstreckungsbeamte;5315000;Köln;M;733;0;0;0;1;0;1;10;44;54;93;148;78;64;142;142;174;88;30;9;585
621020;Widerstand gegen Vollstreckungsbeamte;5315000;Köln;W;117;0;0;0;0;0;0;4;10;14;7;21;4;6;10;21;34;23;7;1;96
621020;Widerstand gegen Vollstreckungsbeamte;5315000;Köln;X;850;0;0;0;1;0;1;14;54;68;100;169;82;70;152;163;208;111;37;10;681
621020;Widerstand gegen Vollstreckungsbeamte;5114000;Krefeld;M;113;0;0;0;0;0;0;4;6;10;9;19;7;13;20;16;32;17;6;3;94
621020;Widerstand gegen Vollstreckungsbeamte;5114000;Krefeld;W;30;0;0;0;0;0;0;2;2;4;0;4;1;0;1;3;8;7;3;4;26
621020;Widerstand gegen Vollstreckungsbeamte;5114000;Krefeld;X;143;0;0;0;0;0;0;6;8;14;9;23;8;13;21;19;40;24;9;7;120
621020;Widerstand gegen Vollstreckungsbeamte;14713000;Leipzig;M;241;0;0;1;0;2;3;4;8;12;27;42;29;31;60;46;59;23;10;1;199
621020;Widerstand gegen Vollstreckungsbeamte;14713000;Leipzig;W;39;0;0;0;0;0;0;3;5;8;5;13;5;4;9;5;7;3;0;2;26
621020;Widerstand gegen Vollstreckungsbeamte;14713000;Leipzig;X;280;0;0;1;0;2;3;7;13;20;32;55;34;35;69;51;66;26;10;3;225
621020;Widerstand gegen Vollstreckungsbeamte;5316000;Leverkusen;M;49;0;0;0;0;0;0;0;2;2;6;8;6;5;11;9;8;10;2;1;41
621020;Widerstand gegen Vollstreckungsbeamte;5316000;Leverkusen;W;12;0;0;0;0;0;0;0;0;0;0;0;0;1;1;2;3;3;3;0;12
621020;Widerstand gegen Vollstreckungsbeamte;5316000;Leverkusen;X;61;0;0;0;0;0;0;0;2;2;6;8;6;6;12;11;11;13;5;1;53
621020;Widerstand gegen Vollstreckungsbeamte;1003000;Lübeck;M;112;0;0;0;0;1;1;2;4;6;9;16;13;6;19;20;29;13;11;4;96
621020;Widerstand gegen Vollstreckungsbeamte;1003000;Lübeck;W;23;0;0;0;0;0;0;2;1;3;1;4;1;1;2;2;5;5;4;1;19
621020;Widerstand gegen Vollstreckungsbeamte;1003000;Lübeck;X;135;0;0;0;0;1;1;4;5;9;10;20;14;7;21;22;34;18;15;5;115
621020;Widerstand gegen Vollstreckungsbeamte;7314000;Ludwigshafen am Rhein;M;40;0;0;0;0;0;0;1;1;2;5;7;4;7;11;4;9;5;3;1;33
621020;Widerstand gegen Vollstreckungsbeamte;7314000;Ludwigshafen am Rhein;W;8;0;0;0;0;0;0;0;0;0;3;3;0;1;1;1;0;1;1;1;5
621020;Widerstand gegen Vollstreckungsbeamte;7314000;Ludwigshafen am Rhein;X;48;0;0;0;0;0;0;1;1;2;8;10;4;8;12;5;9;6;4;2;38
621020;Widerstand gegen Vollstreckungsbeamte;15003000;Magdeburg;M;104;0;0;0;0;1;1;1;8;9;14;24;12;6;18;18;25;11;7;1;80
621020;Widerstand gegen Vollstreckungsbeamte;15003000;Magdeburg;W;12;0;0;0;0;0;0;0;3;3;2;5;0;0;0;2;2;2;1;0;7
621020;Widerstand gegen Vollstreckungsbeamte;15003000;Magdeburg;X;116;0;0;0;0;1;1;1;11;12;16;29;12;6;18;20;27;13;8;1;87
621020;Widerstand gegen Vollstreckungsbeamte;7315000;Mainz;M;85;0;0;0;0;0;0;0;5;5;14;19;8;8;16;16;21;4;4;5;66
621020;Widerstand gegen Vollstreckungsbeamte;7315000;Mainz;W;8;0;0;0;0;0;0;0;1;1;0;1;1;2;3;0;2;0;2;0;7
621020;Widerstand gegen Vollstreckungsbeamte;7315000;Mainz;X;93;0;0;0;0;0;0;0;6;6;14;20;9;10;19;16;23;4;6;5;73
621020;Widerstand gegen Vollstreckungsbeamte;8222000;Mannheim;M;33;0;0;0;0;0;0;1;0;1;0;1;1;8;9;7;10;2;3;1;32
621020;Widerstand gegen Vollstreckungsbeamte;8222000;Mannheim;W;0;0;0;0;0;0;0;0;0;0;0;0;0;0;0;0;0;0;0;0;0
621020;Widerstand gegen Vollstreckungsbeamte;8222000;Mannheim;X;33;0;0;0;0;0;0;1;0;1;0;1;1;8;9;7;10;2;3;1;32
621020;Widerstand gegen Vollstreckungsbeamte;5170024;Moers;M;29;0;0;0;0;0;0;1;0;1;3;4;4;2;6;2;8;5;4;0;25
621020;Widerstand gegen Vollstreckungsbeamte;5170024;Moers;W;8;0;0;0;0;0;0;0;0;0;0;0;1;0;1;3;3;0;1;0;8
621020;Widerstand gegen Vollstreckungsbeamte;5170024;Moers;X;37;0;0;0;0;0;0;1;0;1;3;4;5;2;7;5;11;5;5;0;33
621020;Widerstand gegen Vollstreckungsbeamte;5116000;Mönchengladbach;M;86;0;0;0;0;0;0;0;2;2;13;15;14;8;22;17;12;10;8;2;71
621020;Widerstand gegen Vollstreckungsbeamte;5116000;Mönchengladbach;W;17;0;0;0;0;0;0;0;0;0;3;3;1;1;2;2;7;2;1;0;14
621020;Widerstand gegen Vollstreckungsbeamte;5116000;Mönchengladbach;X;103;0;0;0;0;0;0;0;2;2;16;18;15;9;24;19;19;12;9;2;85
621020;Widerstand gegen Vollstreckungsbeamte;5117000;Mülheim an der Ruhr;M;42;0;0;0;0;0;0;0;4;4;5;9;1;2;3;8;12;7;2;1;33
621020;Widerstand gegen Vollstreckungsbeamte;5117000;Mülheim an der Ruhr;W;11;0;0;0;0;0;0;0;0;0;2;2;2;0;2;0;5;1;1;0;9
621020;Widerstand gegen Vollstreckungsbeamte;5117000;Mülheim an der Ruhr;X;53;0;0;0;0;0;0;0;4;4;7;11;3;2;5;8;17;8;3;1;42
621020;Widerstand gegen Vollstreckungsbeamte;9162000;München;M;225;0;0;0;0;0;0;2;10;12;33;45;27;17;44;34;59;29;7;7;180
621020;Widerstand gegen Vollstreckungsbeamte;9162000;München;W;29;0;0;0;0;0;0;3;3;6;3;9;1;1;2;5;4;5;2;2;20
621020;Widerstand gegen Vollstreckungsbeamte;9162000;München;X;254;0;0;0;0;0;0;5;13;18;36;54;28;18;46;39;63;34;9;9;200
621020;Widerstand gegen Vollstreckungsbeamte;5515000;Münster;M;130;0;0;0;0;1;1;1;6;7;28;36;9;12;21;27;21;13;8;4;94
621020;Widerstand gegen Vollstreckungsbeamte;5515000;Münster;W;24;0;0;0;0;0;0;0;1;1;6;7;3;0;3;3;5;3;3;0;17
621020;Widerstand gegen Vollstreckungsbeamte;5515000;Münster;X;154;0;0;0;0;1;1;1;7;8;34;43;12;12;24;30;26;16;11;4;111
621020;Widerstand gegen Vollstreckungsbeamte;5162024;Neuss;M;41;0;0;0;0;0;0;0;2;2;4;6;3;4;7;11;3;8;5;1;35
621020;Widerstand gegen Vollstreckungsbeamte;5162024;Neuss;W;5;0;0;0;0;0;0;0;0;0;1;1;0;0;0;0;0;2;1;1;4
621020;Widerstand gegen Vollstreckungsbeamte;5162024;Neuss;X;46;0;0;0;0;0;0;0;2;2;5;7;3;4;7;11;3;10;6;2;39
621020;Widerstand gegen Vollstreckungsbeamte;9564000;Nürnberg;M;87;0;0;0;0;0;0;0;6;6;11;17;8;9;17;23;14;9;6;1;70
621020;Widerstand gegen Vollstreckungsbeamte;9564000;Nürnberg;W;6;0;0;0;0;0;0;1;1;2;0;2;0;0;0;2;0;2;0;0;4
621020;Widerstand gegen Vollstreckungsbeamte;9564000;Nürnberg;X;93;0;0;0;0;0;0;1;7;8;11;19;8;9;17;25;14;11;6;1;74
621020;Widerstand gegen Vollstreckungsbeamte;5119000;Oberhausen;M;51;0;0;0;0;1;1;0;0;0;9;10;6;4;10;8;13;8;2;0;41
621020;Widerstand gegen Vollstreckungsbeamte;5119000;Oberhausen;W;6;0;0;0;0;2;2;1;0;1;1;4;0;0;0;0;0;2;0;0;2
621020;Widerstand gegen Vollstreckungsbeamte;5119000;Oberhausen;X;57;0;0;0;0;3;3;1;0;1;10;14;6;4;10;8;13;10;2;0;43
621020;Widerstand gegen Vollstreckungsbeamte;6413000;Offenbach am Main;M;31;0;0;0;0;0;0;0;3;3;3;6;3;0;3;9;7;3;2;1;25
621020;Widerstand gegen Vollstreckungsbeamte;6413000;Offenbach am Main;W;9;0;0;0;0;0;0;0;1;1;1;2;0;1;1;0;6;0;0;0;7
621020;Widerstand gegen Vollstreckungsbeamte;6413000;Offenbach am Main;X;40;0;0;0;0;0;0;0;4;4;4;8;3;1;4;9;13;3;2;1;32
621020;Widerstand gegen Vollstreckungsbeamte;3403000;Oldenburg (Oldenburg);M;27;0;0;0;0;0;0;1;2;3;1;4;2;2;4;7;4;6;2;0;23
621020;Widerstand gegen Vollstreckungsbeamte;3403000;Oldenburg (Oldenburg);W;8;0;0;0;0;0;0;1;0;1;1;2;0;1;1;1;3;0;1;0;6
621020;Widerstand gegen Vollstreckungsbeamte;3403000;Oldenburg (Oldenburg);X;35;0;0;0;0;0;0;2;2;4;2;6;2;3;5;8;7;6;3;0;29
621020;Widerstand gegen Vollstreckungsbeamte;3404000;Osnabrück;M;64;0;0;0;0;0;0;0;0;0;11;11;6;8;14;9;17;9;3;1;53
621020;Widerstand gegen Vollstreckungsbeamte;3404000;Osnabrück;W;12;0;0;0;0;0;0;1;1;2;1;3;0;1;1;1;4;1;2;0;9
621020;Widerstand gegen Vollstreckungsbeamte;3404000;Osnabrück;X;76;0;0;0;0;0;0;1;1;2;12;14;6;9;15;10;21;10;5;1;62
621020;Widerstand gegen Vollstreckungsbeamte;5774032;Paderborn;M;62;0;0;0;0;0;0;3;5;8;6;14;1;2;3;13;24;6;1;1;48
621020;Widerstand gegen Vollstreckungsbeamte;5774032;Paderborn;W;11;0;0;0;0;0;0;2;0;2;2;4;1;0;1;3;1;0;1;1;7
621020;Widerstand gegen Vollstreckungsbeamte;5774032;Paderborn;X;73;0;0;0;0;0;0;5;5;10;8;18;2;2;4;16;25;6;2;2;55
621020;Widerstand gegen Vollstreckungsbeamte;8231000;Pforzheim;M;21;0;0;0;0;0;0;0;1;1;2;3;2;1;3;1;6;4;1;3;18
621020;Widerstand gegen Vollstreckungsbeamte;8231000;Pforzheim;W;2;0;0;0;0;0;0;0;0;0;0;0;0;0;0;2;0;0;0;0;2
621020;Widerstand gegen Vollstreckungsbeamte;8231000;Pforzheim;X;23;0;0;0;0;0;0;0;1;1;2;3;2;1;3;3;6;4;1;3;20
621020;Widerstand gegen Vollstreckungsbeamte;12054000;Potsdam;M;63;0;0;0;0;0;0;0;2;2;7;9;6;6;12;15;18;5;3;1;54
621020;Widerstand gegen Vollstreckungsbeamte;12054000;Potsdam;W;11;0;0;0;0;0;0;0;0;0;0;0;0;0;0;1;3;2;5;0;11
621020;Widerstand gegen Vollstreckungsbeamte;12054000;Potsdam;X;74;0;0;0;0;0;0;0;2;2;7;9;6;6;12;16;21;7;8;1;65
621020;Widerstand gegen Vollstreckungsbeamte;5562032;Recklinghausen;M;57;0;0;0;0;0;0;2;4;6;7;13;12;4;16;12;5;9;0;2;44
621020;Widerstand gegen Vollstreckungsbeamte;5562032;Recklinghausen;W;10;0;0;0;0;0;0;0;2;2;1;3;0;0;0;1;2;2;1;1;7
621020;Widerstand gegen Vollstreckungsbeamte;5562032;Recklinghausen;X;67;0;0;0;0;0;0;2;6;8;8;16;12;4;16;13;7;11;1;3;51
621020;Widerstand gegen Vollstreckungsbeamte;9362000;Regensburg;M;26;0;0;0;0;0;0;0;0;0;3;3;5;1;6;5;6;5;0;1;23
621020;Widerstand gegen Vollstreckungsbeamte;9362000;Regensburg;W;2;0;0;0;0;0;0;0;0;0;0;0;0;1;1;1;0;0;0;0;2
621020;Widerstand gegen Vollstreckungsbeamte;9362000;Regensburg;X;28;0;0;0;0;0;0;0;0;0;3;3;5;2;7;6;6;5;0;1;25
621020;Widerstand gegen Vollstreckungsbeamte;5120000;Remscheid;M;35;0;0;0;0;0;0;0;3;3;3;6;4;3;7;3;8;8;3;0;29
621020;Widerstand gegen Vollstreckungsbeamte;5120000;Remscheid;W;13;0;0;0;0;0;0;0;1;1;2;3;1;1;2;0;3;4;1;0;10
621020;Widerstand gegen Vollstreckungsbeamte;5120000;Remscheid;X;48;0;0;0;0;0;0;0;4;4;5;9;5;4;9;3;11;12;4;0;39
621020;Widerstand gegen Vollstreckungsbeamte;8415061;Reutlingen;M;11;0;0;0;0;0;0;0;0;0;3;3;2;0;2;1;4;0;1;0;8
621020;Widerstand gegen Vollstreckungsbeamte;8415061;Reutlingen;W;1;0;0;0;0;0;0;0;0;0;0;0;0;0;0;0;1;0;0;0;1
621020;Widerstand gegen Vollstreckungsbeamte;8415061;Reutlingen;X;12;0;0;0;0;0;0;0;0;0;3;3;2;0;2;1;5;0;1;0;9
621020;Widerstand gegen Vollstreckungsbeamte;13003000;Rostock;M;65;0;0;0;0;0;0;2;5;7;3;10;9;8;17;14;15;4;4;1;55
621020;Widerstand gegen Vollstreckungsbeamte;13003000;Rostock;W;7;0;0;0;0;1;1;1;1;2;0;3;0;0;0;1;3;0;0;0;4
621020;Widerstand gegen Vollstreckungsbeamte;13003000;Rostock;X;72;0;0;0;0;1;1;3;6;9;3;13;9;8;17;15;18;4;4;1;59
621020;Widerstand gegen Vollstreckungsbeamte;10041100;Saarbrücken;M;144;0;0;0;0;1;1;5;9;14;16;31;7;18;25;23;38;17;8;2;113
621020;Widerstand gegen Vollstreckungsbeamte;10041100;Saarbrücken;W;26;0;0;0;0;0;0;2;0;2;2;4;1;2;3;6;5;4;4;0;22
621020;Widerstand gegen Vollstreckungsbeamte;10041100;Saarbrücken;X;170;0;0;0;0;1;1;7;9;16;18;35;8;20;28;29;43;21;12;2;135
621020;Widerstand gegen Vollstreckungsbeamte;5122000;Solingen;M;50;0;0;0;0;0;0;0;1;1;13;14;3;2;5;9;11;5;5;1;36
621020;Widerstand gegen Vollstreckungsbeamte;5122000;Solingen;W;7;0;0;0;0;0;0;0;0;0;0;0;1;0;1;1;2;1;2;0;7
621020;Widerstand gegen Vollstreckungsbeamte;5122000;Solingen;X;57;0;0;0;0;0;0;0;1;1;13;14;4;2;6;10;13;6;7;1;43
621020;Widerstand gegen Vollstreckungsbeamte;8111000;Stuttgart;M;259;0;0;0;0;0;0;3;10;13;42;55;27;23;50;38;62;32;15;7;204
621020;Widerstand gegen Vollstreckungsbeamte;8111000;Stuttgart;W;32;0;0;0;0;0;0;2;1;3;3;6;3;3;6;3;8;8;0;1;26
621020;Widerstand gegen Vollstreckungsbeamte;8111000;Stuttgart;X;291;0;0;0;0;0;0;5;11;16;45;61;30;26;56;41;70;40;15;8;230
621020;Widerstand gegen Vollstreckungsbeamte;7211000;Trier;M;46;0;0;0;0;0;0;1;1;2;3;5;2;5;7;15;9;5;4;1;41
621020;Widerstand gegen Vollstreckungsbeamte;7211000;Trier;W;8;0;0;0;0;0;0;1;1;2;0;2;0;0;0;1;4;0;0;1;6
621020;Widerstand gegen Vollstreckungsbeamte;7211000;Trier;X;54;0;0;0;0;0;0;2;2;4;3;7;2;5;7;16;13;5;4;2;47
621020;Widerstand gegen Vollstreckungsbeamte;8421000;Ulm;M;15;0;0;0;0;0;0;0;0;0;4;4;2;0;2;2;4;3;0;0;11
621020;Widerstand gegen Vollstreckungsbeamte;8421000;Ulm;W;1;0;0;0;0;0;0;0;0;0;0;0;1;0;1;0;0;0;0;0;1
621020;Widerstand gegen Vollstreckungsbeamte;8421000;Ulm;X;16;0;0;0;0;0;0;0;0;0;4;4;3;0;3;2;4;3;0;0;12
621020;Widerstand gegen Vollstreckungsbeamte;6414000;Wiesbaden;M;55;0;0;0;0;0;0;2;1;3;7;10;5;1;6;9;15;8;5;2;45
621020;Widerstand gegen Vollstreckungsbeamte;6414000;Wiesbaden;W;7;0;0;0;0;0;0;1;0;1;1;2;0;0;0;1;2;1;1;0;5
621020;Widerstand gegen Vollstreckungsbeamte;6414000;Wiesbaden;X;62;0;0;0;0;0;0;3;1;4;8;12;5;1;6;10;17;9;6;2;50
621020;Widerstand gegen Vollstreckungsbeamte;3103000;Wolfsburg;M;35;0;0;0;0;0;0;0;2;2;5;7;5;3;8;7;3;4;3;3;28
621020;Widerstand gegen Vollstreckungsbeamte;3103000;Wolfsburg;W;3;0;0;0;0;0;0;0;0;0;0;0;0;0;0;0;2;0;1;0;3
621020;Widerstand gegen Vollstreckungsbeamte;3103000;Wolfsburg;X;38;0;0;0;0;0;0;0;2;2;5;7;5;3;8;7;5;4;4;3;31
621020;Widerstand gegen Vollstreckungsbeamte;5124000;Wuppertal;M;195;0;0;0;0;0;0;2;10;12;20;32;23;16;39;26;42;32;14;10;163
621020;Widerstand gegen Vollstreckungsbeamte;5124000;Wuppertal;W;61;0;0;0;0;1;1;4;7;11;2;14;6;2;8;6;9;20;3;1;47
621020;Widerstand gegen Vollstreckungsbeamte;5124000;Wuppertal;X;256;0;0;0;0;1;1;6;17;23;22;46;29;18;47;32;51;52;17;11;210
621020;Widerstand gegen Vollstreckungsbeamte;9663000;Würzburg;M;15;0;0;0;0;0;0;0;0;0;2;2;0;1;1;5;2;2;3;0;13
621020;Widerstand gegen Vollstreckungsbeamte;9663000;Würzburg;W;2;0;0;0;0;0;0;0;0;0;1;1;0;0;0;0;0;1;0;0;1
621020;Widerstand gegen Vollstreckungsbeamte;9663000;Würzburg;X;17;0;0;0;0;0;0;0;0;0;3;3;0;1;1;5;2;3;3;0;14
630000;Begünstigung, Strafvereitelung (ohne Strafvereitelung im Amt), Hehlerei und Geldwäsche §§ 257, 258, 259-261 StGB;5334002;Aachen;M;100;0;0;0;0;0;0;3;7;10;12;22;5;6;11;17;23;18;3;6;78
630000;Begünstigung, Strafvereitelung (ohne Strafvereitelung im Amt), Hehlerei und Geldwäsche §§ 257, 258, 259-261 StGB;5334002;Aachen;W;25;0;0;0;0;1;1;1;1;2;1;4;3;1;4;0;7;5;5;0;21
630000;Begünstigung, Strafvereitelung (ohne Strafvereitelung im Amt), Hehlerei und Geldwäsche §§ 257, 258, 259-261 StGB;5334002;Aachen;X;125;0;0;0;0;1;1;4;8;12;13;26;8;7;15;17;30;23;8;6;99
630000;Begünstigung, Strafvereitelung (ohne Strafvereitelung im Amt), Hehlerei und Geldwäsche §§ 257, 258, 259-261 StGB;9761000;Augsburg;M;151;0;0;0;1;3;4;12;16;28;17;49;11;10;21;10;25;35;7;4;102
630000;Begünstigung, Strafvereitelung (ohne Strafvereitelung im Amt), Hehlerei und Geldwäsche §§ 257, 258, 259-261 StGB;9761000;Augsburg;W;43;0;0;0;0;0;0;4;2;6;5;11;1;2;3;10;9;5;2;3;32
630000;Begünstigung, Strafvereitelung (ohne Strafvereitelung im Amt), Hehlerei und Geldwäsche §§ 257, 258, 259-261 StGB;9761000;Augsburg;X;194;0;0;0;1;3;4;16;18;34;22;60;12;12;24;20;34;40;9;7;134
630000;Begünstigung, Strafvereitelung (ohne Strafvereitelung im Amt), Hehlerei und Geldwäsche §§ 257, 258, 259-261 StGB;5378004;Bergisch Gladbach;M;3;0;0;0;0;0;0;0;0;0;0;0;0;0;0;0;0;1;1;1;3
630000;Begünstigung, Strafvereitelung (ohne Strafvereitelung im Amt), Hehlerei und Geldwäsche §§ 257, 258, 259-261 StGB;5378004;Bergisch Gladbach;W;4;0;0;0;0;0;0;0;0;0;1;1;0;0;0;2;0;0;1;0;3
630000;Begünstigung, Strafvereitelung (ohne Strafvereitelung im Amt), Hehlerei und Geldwäsche §§ 257, 258, 259-261 StGB;5378004;Bergisch Gladbach;X;7;0;0;0;0;0;0;0;0;0;1;1;0;0;0;2;0;1;2;1;6
630000;Begünstigung, Strafvereitelung (ohne Strafvereitelung im Amt), Hehlerei und Geldwäsche §§ 257, 258, 259-261 StGB;11000000;Berlin;M;3468;0;0;0;0;3;3;40;87;127;240;370;173;211;384;478;918;664;398;256;3098
630000;Begünstigung, Strafvereitelung (ohne Strafvereitelung im Amt), Hehlerei und Geldwäsche §§ 257, 258, 259-261 StGB;11000000;Berlin;W;1051;0;0;0;0;2;2;4;11;15;51;68;43;41;84;145;276;234;119;125;983
630000;Begünstigung, Strafvereitelung (ohne Strafvereitelung im Amt), Hehlerei und Geldwäsche §§ 257, 258, 259-261 StGB;11000000;Berlin;X;4519;0;0;0;0;5;5;44;98;142;291;438;216;252;468;623;1194;898;517;381;4081
630000;Begünstigung, Strafvereitelung (ohne Strafvereitelung im Amt), Hehlerei und Geldwäsche §§ 257, 258, 259-261 StGB;5711000;Bielefeld;M;99;0;0;0;0;0;0;1;3;4;9;13;6;5;11;15;32;21;6;1;86
630000;Begünstigung, Strafvereitelung (ohne Strafvereitelung im Amt), Hehlerei und Geldwäsche §§ 257, 258, 259-261 StGB;5711000;Bielefeld;W;21;0;0;0;0;0;0;0;1;1;5;6;1;1;2;6;3;3;1;0;15
630000;Begünstigung, Strafvereitelung (ohne Strafvereitelung im Amt), Hehlerei und Geldwäsche §§ 257, 258, 259-261 StGB;5711000;Bielefeld;X;120;0;0;0;0;0;0;1;4;5;14;19;7;6;13;21;35;24;7;1;101
630000;Begünstigung, Strafvereitelung (ohne Strafvereitelung im Amt), Hehlerei und Geldwäsche §§ 257, 258, 259-261 StGB;5911000;Bochum;M;126;0;0;0;0;1;1;2;11;13;19;33;9;11;20;18;35;14;4;2;93
630000;Begünstigung, Strafvereitelung (ohne Strafvereitelung im Amt), Hehlerei und Geldwäsche §§ 257, 258, 259-261 StGB;5911000;Bochum;W;22;0;0;0;0;0;0;0;2;2;3;5;0;1;1;0;5;9;1;1;17
630000;Begünstigung, Strafvereitelung (ohne Strafvereitelung im Amt), Hehlerei und Geldwäsche §§ 257, 258, 259-261 StGB;5911000;Bochum;X;148;0;0;0;0;1;1;2;13;15;22;38;9;12;21;18;40;23;5;3;110
630000;Begünstigung, Strafvereitelung (ohne Strafvereitelung im Amt), Hehlerei und Geldwäsche §§ 257, 258, 259-261 StGB;5314000;Bonn;M;80;0;0;0;0;7;7;6;2;8;6;21;4;3;7;14;23;7;4;4;59
630000;Begünstigung, Strafvereitelung (ohne Strafvereitelung im Amt), Hehlerei und Geldwäsche §§ 257, 258, 259-261 StGB;5314000;Bonn;W;18;0;0;0;0;8;8;0;1;1;2;11;1;0;1;1;3;1;1;0;7
630000;Begünstigung, Strafvereitelung (ohne Strafvereitelung im Amt), Hehlerei und Geldwäsche §§ 257, 258, 259-261 StGB;5314000;Bonn;X;98;0;0;0;0;15;15;6;3;9;8;32;5;3;8;15;26;8;5;4;66
630000;Begünstigung, Strafvereitelung (ohne Strafvereitelung im Amt), Hehlerei und Geldwäsche §§ 257, 258, 259-261 StGB;5512000;Bottrop;M;29;0;0;0;0;0;0;0;0;0;2;2;2;4;6;5;5;5;3;3;27
630000;Begünstigung, Strafvereitelung (ohne Strafvereitelung im Amt), Hehlerei und Geldwäsche §§ 257, 258, 259-261 StGB;5512000;Bottrop;W;1;0;0;0;0;0;0;0;0;0;0;0;0;0;0;0;0;0;1;0;1
630000;Begünstigung, Strafvereitelung (ohne Strafvereitelung im Amt), Hehlerei und Geldwäsche §§ 257, 258, 259-261 StGB;5512000;Bottrop;X;30;0;0;0;0;0;0;0;0;0;2;2;2;4;6;5;5;5;4;3;28
630000;Begünstigung, Strafvereitelung (ohne Strafvereitelung im Amt), Hehlerei und Geldwäsche §§ 257, 258, 259-261 StGB;3101000;Braunschweig;M;140;0;0;0;0;0;0;4;8;12;17;29;11;8;19;19;28;30;10;5;111
630000;Begünstigung, Strafvereitelung (ohne Strafvereitelung im Amt), Hehlerei und Geldwäsche §§ 257, 258, 259-261 StGB;3101000;Braunschweig;W;27;0;0;0;0;0;0;2;0;2;1;3;3;3;6;3;2;5;6;2;24
630000;Begünstigung, Strafvereitelung (ohne Strafvereitelung im Amt), Hehlerei und Geldwäsche §§ 257, 258, 259-261 StGB;3101000;Braunschweig;X;167;0;0;0;0;0;0;6;8;14;18;32;14;11;25;22;30;35;16;7;135
630000;Begünstigung, Strafvereitelung (ohne Strafvereitelung im Amt), Hehlerei und Geldwäsche §§ 257, 258, 259-261 StGB;4011000;Bremen;M;400;0;0;0;0;0;0;7;19;26;49;75;21;22;43;58;101;75;22;26;325
630000;Begünstigung, Strafvereitelung (ohne Strafvereitelung im Amt), Hehlerei und Geldwäsche §§ 257, 258, 259-261 StGB;4011000;Bremen;W;80;0;0;0;0;0;0;2;1;3;9;12;5;10;15;11;20;11;7;4;68
630000;Begünstigung, Strafvereitelung (ohne Strafvereitelung im Amt), Hehlerei und Geldwäsche §§ 257, 258, 259-261 StGB;4011000;Bremen;X;480;0;0;0;0;0;0;9;20;29;58;87;26;32;58;69;121;86;29;30;393
630000;Begünstigung, Strafvereitelung (ohne Strafvereitelung im Amt), Hehlerei und Geldwäsche §§ 257, 258, 259-261 StGB;4012000;Bremerhaven;M;62;0;0;0;0;0;0;0;0;0;6;6;3;3;6;10;18;14;7;1;56
630000;Begünstigung, Strafvereitelung (ohne Strafvereitelung im Amt), Hehlerei und Geldwäsche §§ 257, 258, 259-261 StGB;4012000;Bremerhaven;W;19;0;0;0;0;0;0;0;1;1;4;5;2;1;3;1;6;3;1;0;14
630000;Begünstigung, Strafvereitelung (ohne Strafvereitelung im Amt), Hehlerei und Geldwäsche §§ 257, 258, 259-261 StGB;4012000;Bremerhaven;X;81;0;0;0;0;0;0;0;1;1;10;11;5;4;9;11;24;17;8;1;70
630000;Begünstigung, Strafvereitelung (ohne Strafvereitelung im Amt), Hehlerei und Geldwäsche §§ 257, 258, 259-261 StGB;14511000;Chemnitz;M;79;0;0;0;0;0;0;2;3;5;8;13;6;3;9;20;23;6;6;2;66
630000;Begünstigung, Strafvereitelung (ohne Strafvereitelung im Amt), Hehlerei und Geldwäsche §§ 257, 258, 259-261 StGB;14511000;Chemnitz;W;21;0;0;0;0;1;1;1;0;1;2;4;1;5;6;3;6;1;1;0;17
630000;Begünstigung, Strafvereitelung (ohne Strafvereitelung im Amt), Hehlerei und Geldwäsche §§ 257, 258, 259-261 StGB;14511000;Chemnitz;X;100;0;0;0;0;1;1;3;3;6;10;17;7;8;15;23;29;7;7;2;83
630000;Begünstigung, Strafvereitelung (ohne Strafvereitelung im Amt), Hehlerei und Geldwäsche §§ 257, 258, 259-261 StGB;6411000;Darmstadt;M;75;0;0;0;0;0;0;6;6;12;8;20;9;11;20;8;11;8;5;3;55
630000;Begünstigung, Strafvereitelung (ohne Strafvereitelung im Amt), Hehlerei und Geldwäsche §§ 257, 258, 259-261 StGB;6411000;Darmstadt;W;14;0;0;0;0;0;0;1;0;1;1;2;1;1;2;5;2;3;0;0;12
630000;Begünstigung, Strafvereitelung (ohne Strafvereitelung im Amt), Hehlerei und Geldwäsche §§ 257, 258, 259-261 StGB;6411000;Darmstadt;X;89;0;0;0;0;0;0;7;6;13;9;22;10;12;22;13;13;11;5;3;67
630000;Begünstigung, Strafvereitelung (ohne Strafvereitelung im Amt), Hehlerei und Geldwäsche §§ 257, 258, 259-261 StGB;5913000;Dortmund;M;297;0;0;0;0;2;2;4;25;29;43;74;20;17;37;48;75;47;13;3;223
630000;Begünstigung, Strafvereitelung (ohne Strafvereitelung im Amt), Hehlerei und Geldwäsche §§ 257, 258, 259-261 StGB;5913000;Dortmund;W;45;0;0;0;0;0;0;2;0;2;4;6;2;2;4;5;15;6;7;2;39
630000;Begünstigung, Strafvereitelung (ohne Strafvereitelung im Amt), Hehlerei und Geldwäsche §§ 257, 258, 259-261 StGB;5913000;Dortmund;X;342;0;0;0;0;2;2;6;25;31;47;80;22;19;41;53;90;53;20;5;262
630000;Begünstigung, Strafvereitelung (ohne Strafvereitelung im Amt), Hehlerei und Geldwäsche §§ 257, 258, 259-261 StGB;14612000;Dresden;M;152;0;0;0;0;0;0;1;4;5;10;15;7;7;14;40;55;20;6;2;137
630000;Begünstigung, Strafvereitelung (ohne Strafvereitelung im Amt), Hehlerei und Geldwäsche §§ 257, 258, 259-261 StGB;14612000;Dresden;W;43;0;0;0;0;0;0;0;0;0;4;4;7;6;13;9;10;3;3;1;39
630000;Begünstigung, Strafvereitelung (ohne Strafvereitelung im Amt), Hehlerei und Geldwäsche §§ 257, 258, 259-261 StGB;14612000;Dresden;X;195;0;0;0;0;0;0;1;4;5;14;19;14;13;27;49;65;23;9;3;176
630000;Begünstigung, Strafvereitelung (ohne Strafvereitelung im Amt), Hehlerei und Geldwäsche §§ 257, 258, 259-261 StGB;5112000;Duisburg;M;123;0;0;0;0;2;2;1;2;3;14;19;9;5;14;16;27;32;9;6;104
630000;Begünstigung, Strafvereitelung (ohne Strafvereitelung im Amt), Hehlerei und Geldwäsche §§ 257, 258, 259-261 StGB;5112000;Duisburg;W;21;0;0;0;0;0;0;0;0;0;1;1;3;1;4;5;4;5;1;1;20
630000;Begünstigung, Strafvereitelung (ohne Strafvereitelung im Amt), Hehlerei und Geldwäsche §§ 257, 258, 259-261 StGB;5112000;Duisburg;X;144;0;0;0;0;2;2;1;2;3;15;20;12;6;18;21;31;37;10;7;124
630000;Begünstigung, Strafvereitelung (ohne Strafvereitelung im Amt), Hehlerei und Geldwäsche §§ 257, 258, 259-261 StGB;5111000;Düsseldorf;M;199;0;0;0;0;2;2;5;11;16;22;40;16;13;29;34;52;28;11;5;159
630000;Begünstigung, Strafvereitelung (ohne Strafvereitelung im Amt), Hehlerei und Geldwäsche §§ 257, 258, 259-261 StGB;5111000;Düsseldorf;W;34;0;0;0;0;0;0;2;4;6;3;9;0;0;0;8;8;4;2;3;25
630000;Begünstigung, Strafvereitelung (ohne Strafvereitelung im Amt), Hehlerei und Geldwäsche §§ 257, 258, 259-261 StGB;5111000;Düsseldorf;X;233;0;0;0;0;2;2;7;15;22;25;49;16;13;29;42;60;32;13;8;184
630000;Begünstigung, Strafvereitelung (ohne Strafvereitelung im Amt), Hehlerei und Geldwäsche §§ 257, 258, 259-261 StGB;16051000;Erfurt;M;75;0;0;0;0;0;0;0;3;3;4;7;1;6;7;13;24;16;3;5;68
630000;Begünstigung, Strafvereitelung (ohne Strafvereitelung im Amt), Hehlerei und Geldwäsche §§ 257, 258, 259-261 StGB;16051000;Erfurt;W;17;0;0;0;0;0;0;0;0;0;0;0;0;3;3;3;6;3;1;1;17
630000;Begünstigung, Strafvereitelung (ohne Strafvereitelung im Amt), Hehlerei und Geldwäsche §§ 257, 258, 259-261 StGB;16051000;Erfurt;X;92;0;0;0;0;0;0;0;3;3;4;7;1;9;10;16;30;19;4;6;85
630000;Begünstigung, Strafvereitelung (ohne Strafvereitelung im Amt), Hehlerei und Geldwäsche §§ 257, 258, 259-261 StGB;9562000;Erlangen;M;65;0;0;0;0;0;0;2;9;11;9;20;9;4;13;9;12;5;5;1;45
630000;Begünstigung, Strafvereitelung (ohne Strafvereitelung im Amt), Hehlerei und Geldwäsche §§ 257, 258, 259-261 StGB;9562000;Erlangen;W;15;0;0;0;0;0;0;0;0;0;3;3;1;1;2;2;1;4;1;2;12
630000;Begünstigung, Strafvereitelung (ohne Strafvereitelung im Amt), Hehlerei und Geldwäsche §§ 257, 258, 259-261 StGB;9562000;Erlangen;X;80;0;0;0;0;0;0;2;9;11;12;23;10;5;15;11;13;9;6;3;57
630000;Begünstigung, Strafvereitelung (ohne Strafvereitelung im Amt), Hehlerei und Geldwäsche §§ 257, 258, 259-261 StGB;5113000;Essen;M;130;0;0;0;0;2;2;1;8;9;10;21;12;11;23;18;40;15;10;3;109
630000;Begünstigung, Strafvereitelung (ohne Strafvereitelung im Amt), Hehlerei und Geldwäsche §§ 257, 258, 259-261 StGB;5113000;Essen;W;21;0;0;0;0;0;0;0;2;2;0;2;1;2;3;2;6;4;4;0;19
630000;Begünstigung, Strafvereitelung (ohne Strafvereitelung im Amt), Hehlerei und Geldwäsche §§ 257, 258, 259-261 StGB;5113000;Essen;X;151;0;0;0;0;2;2;1;10;11;10;23;13;13;26;20;46;19;14;3;128
630000;Begünstigung, Strafvereitelung (ohne Strafvereitelung im Amt), Hehlerei und Geldwäsche §§ 257, 258, 259-261 StGB;6412000;Frankfurt am Main;M;614;0;0;0;0;2;2;13;33;46;74;122;43;37;80;108;152;94;37;21;492
630000;Begünstigung, Strafvereitelung (ohne Strafvereitelung im Amt), Hehlerei und Geldwäsche §§ 257, 258, 259-261 StGB;6412000;Frankfurt am Main;W;116;0;0;0;0;1;1;2;3;5;12;18;15;6;21;20;26;21;9;1;98
630000;Begünstigung, Strafvereitelung (ohne Strafvereitelung im Amt), Hehlerei und Geldwäsche §§ 257, 258, 259-261 StGB;6412000;Frankfurt am Main;X;730;0;0;0;0;3;3;15;36;51;86;140;58;43;101;128;178;115;46;22;590
630000;Begünstigung, Strafvereitelung (ohne Strafvereitelung im Amt), Hehlerei und Geldwäsche §§ 257, 258, 259-261 StGB;8311000;Freiburg im Breisgau;M;112;0;0;0;0;1;1;2;12;14;15;30;11;2;13;18;24;13;8;6;82
630000;Begünstigung, Strafvereitelung (ohne Strafvereitelung im Amt), Hehlerei und Geldwäsche §§ 257, 258, 259-261 StGB;8311000;Freiburg im Breisgau;W;30;0;0;0;0;0;0;0;3;3;5;8;4;2;6;4;5;5;1;1;22
630000;Begünstigung, Strafvereitelung (ohne Strafvereitelung im Amt), Hehlerei und Geldwäsche §§ 257, 258, 259-261 StGB;8311000;Freiburg im Breisgau;X;142;0;0;0;0;1;1;2;15;17;20;38;15;4;19;22;29;18;9;7;104
630000;Begünstigung, Strafvereitelung (ohne Strafvereitelung im Amt), Hehlerei und Geldwäsche §§ 257, 258, 259-261 StGB;9563000;Fürth;M;30;0;0;0;0;1;1;0;2;2;2;5;2;0;2;4;9;6;3;1;25
630000;Begünstigung, Strafvereitelung (ohne Strafvereitelung im Amt), Hehlerei und Geldwäsche §§ 257, 258, 259-261 StGB;9563000;Fürth;W;8;0;0;0;0;0;0;0;0;0;2;2;0;0;0;2;2;1;1;0;6
630000;Begünstigung, Strafvereitelung (ohne Strafvereitelung im Amt), Hehlerei und Geldwäsche §§ 257, 258, 259-261 StGB;9563000;Fürth;X;38;0;0;0;0;1;1;0;2;2;4;7;2;0;2;6;11;7;4;1;31
630000;Begünstigung, Strafvereitelung (ohne Strafvereitelung im Amt), Hehlerei und Geldwäsche §§ 257, 258, 259-261 StGB;5513000;Gelsenkirchen;M;78;0;0;0;0;0;0;0;3;3;2;5;8;4;12;12;25;16;6;2;73
630000;Begünstigung, Strafvereitelung (ohne Strafvereitelung im Amt), Hehlerei und Geldwäsche §§ 257, 258, 259-261 StGB;5513000;Gelsenkirchen;W;13;0;0;0;0;0;0;0;0;0;3;3;1;1;2;4;3;1;0;0;10
630000;Begünstigung, Strafvereitelung (ohne Strafvereitelung im Amt), Hehlerei und Geldwäsche §§ 257, 258, 259-261 StGB;5513000;Gelsenkirchen;X;91;0;0;0;0;0;0;0;3;3;5;8;9;5;14;16;28;17;6;2;83
630000;Begünstigung, Strafvereitelung (ohne Strafvereitelung im Amt), Hehlerei und Geldwäsche §§ 257, 258, 259-261 StGB;3152012;Göttingen;M;44;0;0;0;0;0;0;0;4;4;1;5;1;2;3;6;14;5;6;5;39
630000;Begünstigung, Strafvereitelung (ohne Strafvereitelung im Amt), Hehlerei und Geldwäsche §§ 257, 258, 259-261 StGB;3152012;Göttingen;W;16;0;0;0;0;0;0;0;0;0;1;1;1;0;1;3;5;3;2;1;15
630000;Begünstigung, Strafvereitelung (ohne Strafvereitelung im Amt), Hehlerei und Geldwäsche §§ 257, 258, 259-261 StGB;3152012;Göttingen;X;60;0;0;0;0;0;0;0;4;4;2;6;2;2;4;9;19;8;8;6;54
630000;Begünstigung, Strafvereitelung (ohne Strafvereitelung im Amt), Hehlerei und Geldwäsche §§ 257, 258, 259-261 StGB;5914000;Hagen;M;51;0;0;0;0;0;0;1;4;5;4;9;3;3;6;13;12;6;3;2;42
630000;Begünstigung, Strafvereitelung (ohne Strafvereitelung im Amt), Hehlerei und Geldwäsche §§ 257, 258, 259-261 StGB;5914000;Hagen;W;12;0;0;0;0;0;0;0;1;1;1;2;3;1;4;0;1;4;1;0;10
630000;Begünstigung, Strafvereitelung (ohne Strafvereitelung im Amt), Hehlerei und Geldwäsche §§ 257, 258, 259-261 StGB;5914000;Hagen;X;63;0;0;0;0;0;0;1;5;6;5;11;6;4;10;13;13;10;4;2;52
630000;Begünstigung, Strafvereitelung (ohne Strafvereitelung im Amt), Hehlerei und Geldwäsche §§ 257, 258, 259-261 StGB;15002000;Halle (Saale);M;56;0;0;0;0;0;0;0;3;3;2;5;2;3;5;18;18;4;3;3;51
630000;Begünstigung, Strafvereitelung (ohne Strafvereitelung im Amt), Hehlerei und Geldwäsche §§ 257, 258, 259-261 StGB;15002000;Halle (Saale);W;19;0;0;0;0;0;0;0;0;0;1;1;2;0;2;3;5;1;4;3;18
630000;Begünstigung, Strafvereitelung (ohne Strafvereitelung im Amt), Hehlerei und Geldwäsche §§ 257, 258, 259-261 StGB;15002000;Halle (Saale);X;75;0;0;0;0;0;0;0;3;3;3;6;4;3;7;21;23;5;7;6;69
630000;Begünstigung, Strafvereitelung (ohne Strafvereitelung im Amt), Hehlerei und Geldwäsche §§ 257, 258, 259-261 StGB;2000000;Hamburg;M;638;0;0;0;1;1;2;16;41;57;70;129;42;37;79;113;149;101;43;24;509
630000;Begünstigung, Strafvereitelung (ohne Strafvereitelung im Amt), Hehlerei und Geldwäsche §§ 257, 258, 259-261 StGB;2000000;Hamburg;W;104;0;0;0;0;1;1;1;6;7;13;21;7;6;13;14;24;17;12;3;83
630000;Begünstigung, Strafvereitelung (ohne Strafvereitelung im Amt), Hehlerei und Geldwäsche §§ 257, 258, 259-261 StGB;2000000;Hamburg;X;742;0;0;0;1;2;3;17;47;64;83;150;49;43;92;127;173;118;55;27;592
630000;Begünstigung, Strafvereitelung (ohne Strafvereitelung im Amt), Hehlerei und Geldwäsche §§ 257, 258, 259-261 StGB;5915000;Hamm;M;38;0;0;0;0;0;0;0;3;3;5;8;3;0;3;4;8;9;3;3;30
630000;Begünstigung, Strafvereitelung (ohne Strafvereitelung im Amt), Hehlerei und Geldwäsche §§ 257, 258, 259-261 StGB;5915000;Hamm;W;6;0;0;0;0;0;0;0;0;0;0;0;2;0;2;0;1;3;0;0;6
630000;Begünstigung, Strafvereitelung (ohne Strafvereitelung im Amt), Hehlerei und Geldwäsche §§ 257, 258, 259-261 StGB;5915000;Hamm;X;44;0;0;0;0;0;0;0;3;3;5;8;5;0;5;4;9;12;3;3;36
630000;Begünstigung, Strafvereitelung (ohne Strafvereitelung im Amt), Hehlerei und Geldwäsche §§ 257, 258, 259-261 StGB;3241001;Hannover;M;361;0;0;0;0;3;3;9;13;22;29;54;23;24;47;43;92;74;33;18;307
630000;Begünstigung, Strafvereitelung (ohne Strafvereitelung im Amt), Hehlerei und Geldwäsche §§ 257, 258, 259-261 StGB;3241001;Hannover;W;87;0;0;0;0;0;0;1;3;4;6;10;2;6;8;12;22;20;9;6;77
630000;Begünstigung, Strafvereitelung (ohne Strafvereitelung im Amt), Hehlerei und Geldwäsche §§ 257, 258, 259-261 StGB;3241001;Hannover;X;448;0;0;0;0;3;3;10;16;26;35;64;25;30;55;55;114;94;42;24;384
630000;Begünstigung, Strafvereitelung (ohne Strafvereitelung im Amt), Hehlerei und Geldwäsche §§ 257, 258, 259-261 StGB;8221000;Heidelberg;M;34;0;0;0;0;0;0;2;1;3;0;3;2;5;7;1;8;10;4;1;31
630000;Begünstigung, Strafvereitelung (ohne Strafvereitelung im Amt), Hehlerei und Geldwäsche §§ 257, 258, 259-261 StGB;8221000;Heidelberg;W;11;0;0;0;0;0;0;0;1;1;2;3;1;0;1;0;2;1;2;2;8
630000;Begünstigung, Strafvereitelung (ohne Strafvereitelung im Amt), Hehlerei und Geldwäsche §§ 257, 258, 259-261 StGB;8221000;Heidelberg;X;45;0;0;0;0;0;0;2;2;4;2;6;3;5;8;1;10;11;6;3;39
630000;Begünstigung, Strafvereitelung (ohne Strafvereitelung im Amt), Hehlerei und Geldwäsche §§ 257, 258, 259-261 StGB;8121000;Heilbronn;M;46;0;0;0;0;0;0;0;1;1;2;3;1;1;2;6;19;13;2;1;43
630000;Begünstigung, Strafvereitelung (ohne Strafvereitelung im Amt), Hehlerei und Geldwäsche §§ 257, 258, 259-261 StGB;8121000;Heilbronn;W;9;0;0;0;0;0;0;0;0;0;6;6;0;0;0;0;0;1;1;1;3
630000;Begünstigung, Strafvereitelung (ohne Strafvereitelung im Amt), Hehlerei und Geldwäsche §§ 257, 258, 259-261 StGB;8121000;Heilbronn;X;55;0;0;0;0;0;0;0;1;1;8;9;1;1;2;6;19;14;3;2;46
630000;Begünstigung, Strafvereitelung (ohne Strafvereitelung im Amt), Hehlerei und Geldwäsche §§ 257, 258, 259-261 StGB;5916000;Herne;M;46;0;0;0;0;0;0;1;1;2;4;6;8;2;10;8;10;8;1;3;40
630000;Begünstigung, Strafvereitelung (ohne Strafvereitelung im Amt), Hehlerei und Geldwäsche §§ 257, 258, 259-261 StGB;5916000;Herne;W;5;0;0;0;0;0;0;0;0;0;0;0;0;2;2;1;0;0;2;0;5
630000;Begünstigung, Strafvereitelung (ohne Strafvereitelung im Amt), Hehlerei und Geldwäsche §§ 257, 258, 259-261 StGB;5916000;Herne;X;51;0;0;0;0;0;0;1;1;2;4;6;8;4;12;9;10;8;3;3;45
630000;Begünstigung, Strafvereitelung (ohne Strafvereitelung im Amt), Hehlerei und Geldwäsche §§ 257, 258, 259-261 StGB;9161000;Ingolstadt;M;35;0;0;0;0;1;1;1;0;1;2;4;2;2;4;8;10;4;4;1;31
630000;Begünstigung, Strafvereitelung (ohne Strafvereitelung im Amt), Hehlerei und Geldwäsche §§ 257, 258, 259-261 StGB;9161000;Ingolstadt;W;17;0;0;0;0;0;0;1;2;3;2;5;1;1;2;5;1;2;1;1;12
630000;Begünstigung, Strafvereitelung (ohne Strafvereitelung im Amt), Hehlerei und Geldwäsche §§ 257, 258, 259-261 StGB;9161000;Ingolstadt;X;52;0;0;0;0;1;1;2;2;4;4;9;3;3;6;13;11;6;5;2;43
630000;Begünstigung, Strafvereitelung (ohne Strafvereitelung im Amt), Hehlerei und Geldwäsche §§ 257, 258, 259-261 StGB;16053000;Jena;M;19;0;0;0;0;1;1;0;1;1;2;4;0;1;1;3;6;2;2;1;15
630000;Begünstigung, Strafvereitelung (ohne Strafvereitelung im Amt), Hehlerei und Geldwäsche §§ 257, 258, 259-261 StGB;16053000;Jena;W;6;0;0;0;0;1;1;0;0;0;1;2;0;0;0;1;1;0;1;1;4
630000;Begünstigung, Strafvereitelung (ohne Strafvereitelung im Amt), Hehlerei und Geldwäsche §§ 257, 258, 259-261 StGB;16053000;Jena;X;25;0;0;0;0;2;2;0;1;1;3;6;0;1;1;4;7;2;3;2;19
630000;Begünstigung, Strafvereitelung (ohne Strafvereitelung im Amt), Hehlerei und Geldwäsche §§ 257, 258, 259-261 StGB;8212000;Karlsruhe;M;115;0;0;0;0;0;0;2;3;5;15;20;11;11;22;19;25;17;6;6;95
630000;Begünstigung, Strafvereitelung (ohne Strafvereitelung im Amt), Hehlerei und Geldwäsche §§ 257, 258, 259-261 StGB;8212000;Karlsruhe;W;37;0;0;0;0;0;0;5;1;6;2;8;2;3;5;8;6;5;2;3;29
630000;Begünstigung, Strafvereitelung (ohne Strafvereitelung im Amt), Hehlerei und Geldwäsche §§ 257, 258, 259-261 StGB;8212000;Karlsruhe;X;152;0;0;0;0;0;0;7;4;11;17;28;13;14;27;27;31;22;8;9;124
630000;Begünstigung, Strafvereitelung (ohne Strafvereitelung im Amt), Hehlerei und Geldwäsche §§ 257, 258, 259-261 StGB;6611000;Kassel;M;150;0;0;0;0;0;0;4;9;13;19;32;5;10;15;16;43;20;15;9;118
630000;Begünstigung, Strafvereitelung (ohne Strafvereitelung im Amt), Hehlerei und Geldwäsche §§ 257, 258, 259-261 StGB;6611000;Kassel;W;29;0;0;0;0;0;0;0;1;1;3;4;1;2;3;4;5;4;3;6;25
630000;Begünstigung, Strafvereitelung (ohne Strafvereitelung im Amt), Hehlerei und Geldwäsche §§ 257, 258, 259-261 StGB;6611000;Kassel;X;179;0;0;0;0;0;0;4;10;14;22;36;6;12;18;20;48;24;18;15;143
630000;Begünstigung, Strafvereitelung (ohne Strafvereitelung im Amt), Hehlerei und Geldwäsche §§ 257, 258, 259-261 StGB;1002000;Kiel;M;59;0;0;0;0;1;1;2;5;7;5;13;5;4;9;5;11;17;4;0;46
630000;Begünstigung, Strafvereitelung (ohne Strafvereitelung im Amt), Hehlerei und Geldwäsche §§ 257, 258, 259-261 StGB;1002000;Kiel;W;10;0;0;0;0;0;0;0;0;0;3;3;1;1;2;2;1;2;0;0;7
630000;Begünstigung, Strafvereitelung (ohne Strafvereitelung im Amt), Hehlerei und Geldwäsche §§ 257, 258, 259-261 StGB;1002000;Kiel;X;69;0;0;0;0;1;1;2;5;7;8;16;6;5;11;7;12;19;4;0;53
630000;Begünstigung, Strafvereitelung (ohne Strafvereitelung im Amt), Hehlerei und Geldwäsche §§ 257, 258, 259-261 StGB;7111000;Koblenz;M;54;0;0;0;0;0;0;0;3;3;9;12;6;2;8;8;12;10;4;0;42
630000;Begünstigung, Strafvereitelung (ohne Strafvereitelung im Amt), Hehlerei und Geldwäsche §§ 257, 258, 259-261 StGB;7111000;Koblenz;W;11;0;0;0;0;0;0;0;5;5;1;6;2;0;2;0;0;1;0;2;5
630000;Begünstigung, Strafvereitelung (ohne Strafvereitelung im Amt), Hehlerei und Geldwäsche §§ 257, 258, 259-261 StGB;7111000;Koblenz;X;65;0;0;0;0;0;0;0;8;8;10;18;8;2;10;8;12;11;4;2;47
630000;Begünstigung, Strafvereitelung (ohne Strafvereitelung im Amt), Hehlerei und Geldwäsche §§ 257, 258, 259-261 StGB;5315000;Köln;M;531;0;0;0;1;2;3;25;25;50;45;98;43;30;73;84;130;89;40;17;433
630000;Begünstigung, Strafvereitelung (ohne Strafvereitelung im Amt), Hehlerei und Geldwäsche §§ 257, 258, 259-261 StGB;5315000;Köln;W;96;0;0;0;0;0;0;3;3;6;5;11;6;5;11;19;26;11;11;7;85
630000;Begünstigung, Strafvereitelung (ohne Strafvereitelung im Amt), Hehlerei und Geldwäsche §§ 257, 258, 259-261 StGB;5315000;Köln;X;627;0;0;0;1;2;3;28;28;56;50;109;49;35;84;103;156;100;51;24;518
630000;Begünstigung, Strafvereitelung (ohne Strafvereitelung im Amt), Hehlerei und Geldwäsche §§ 257, 258, 259-261 StGB;5114000;Krefeld;M;51;0;0;0;0;0;0;1;2;3;1;4;2;6;8;6;13;15;1;4;47
630000;Begünstigung, Strafvereitelung (ohne Strafvereitelung im Amt), Hehlerei und Geldwäsche §§ 257, 258, 259-261 StGB;5114000;Krefeld;W;11;0;0;0;0;0;0;0;0;0;0;0;0;0;0;1;2;3;3;2;11
630000;Begünstigung, Strafvereitelung (ohne Strafvereitelung im Amt), Hehlerei und Geldwäsche §§ 257, 258, 259-261 StGB;5114000;Krefeld;X;62;0;0;0;0;0;0;1;2;3;1;4;2;6;8;7;15;18;4;6;58
630000;Begünstigung, Strafvereitelung (ohne Strafvereitelung im Amt), Hehlerei und Geldwäsche §§ 257, 258, 259-261 StGB;14713000;Leipzig;M;120;0;0;0;0;0;0;2;1;3;6;9;4;11;15;23;42;19;10;2;111
630000;Begünstigung, Strafvereitelung (ohne Strafvereitelung im Amt), Hehlerei und Geldwäsche §§ 257, 258, 259-261 StGB;14713000;Leipzig;W;36;0;0;0;0;0;0;0;0;0;1;1;2;6;8;12;11;2;1;1;35
630000;Begünstigung, Strafvereitelung (ohne Strafvereitelung im Amt), Hehlerei und Geldwäsche §§ 257, 258, 259-261 StGB;14713000;Leipzig;X;156;0;0;0;0;0;0;2;1;3;7;10;6;17;23;35;53;21;11;3;146
630000;Begünstigung, Strafvereitelung (ohne Strafvereitelung im Amt), Hehlerei und Geldwäsche §§ 257, 258, 259-261 StGB;5316000;Leverkusen;M;25;0;0;0;0;0;0;1;1;2;2;4;2;2;4;4;7;4;2;0;21
630000;Begünstigung, Strafvereitelung (ohne Strafvereitelung im Amt), Hehlerei und Geldwäsche §§ 257, 258, 259-261 StGB;5316000;Leverkusen;W;6;0;0;0;0;0;0;0;0;0;2;2;0;0;0;2;0;1;1;0;4
630000;Begünstigung, Strafvereitelung (ohne Strafvereitelung im Amt), Hehlerei und Geldwäsche §§ 257, 258, 259-261 StGB;5316000;Leverkusen;X;31;0;0;0;0;0;0;1;1;2;4;6;2;2;4;6;7;5;3;0;25
630000;Begünstigung, Strafvereitelung (ohne Strafvereitelung im Amt), Hehlerei und Geldwäsche §§ 257, 258, 259-261 StGB;1003000;Lübeck;M;66;0;0;0;0;1;1;2;7;9;3;13;3;4;7;11;14;14;5;2;53
630000;Begünstigung, Strafvereitelung (ohne Strafvereitelung im Amt), Hehlerei und Geldwäsche §§ 257, 258, 259-261 StGB;1003000;Lübeck;W;11;0;0;0;0;0;0;1;2;3;0;3;0;1;1;2;3;1;1;0;8
630000;Begünstigung, Strafvereitelung (ohne Strafvereitelung im Amt), Hehlerei und Geldwäsche §§ 257, 258, 259-261 StGB;1003000;Lübeck;X;77;0;0;0;0;1;1;3;9;12;3;16;3;5;8;13;17;15;6;2;61
630000;Begünstigung, Strafvereitelung (ohne Strafvereitelung im Amt), Hehlerei und Geldwäsche §§ 257, 258, 259-261 StGB;7314000;Ludwigshafen am Rhein;M;77;0;0;0;0;0;0;3;3;6;6;12;5;4;9;5;22;19;5;5;65
630000;Begünstigung, Strafvereitelung (ohne Strafvereitelung im Amt), Hehlerei und Geldwäsche §§ 257, 258, 259-261 StGB;7314000;Ludwigshafen am Rhein;W;21;0;0;0;0;0;0;0;0;0;5;5;1;1;2;4;3;2;3;2;16
630000;Begünstigung, Strafvereitelung (ohne Strafvereitelung im Amt), Hehlerei und Geldwäsche §§ 257, 258, 259-261 StGB;7314000;Ludwigshafen am Rhein;X;98;0;0;0;0;0;0;3;3;6;11;17;6;5;11;9;25;21;8;7;81
630000;Begünstigung, Strafvereitelung (ohne Strafvereitelung im Amt), Hehlerei und Geldwäsche §§ 257, 258, 259-261 StGB;15003000;Magdeburg;M;78;0;0;0;0;0;0;2;8;10;8;18;11;6;17;12;9;14;6;2;60
630000;Begünstigung, Strafvereitelung (ohne Strafvereitelung im Amt), Hehlerei und Geldwäsche §§ 257, 258, 259-261 StGB;15003000;Magdeburg;W;13;0;0;0;0;0;0;1;0;1;2;3;1;1;2;1;4;2;0;1;10
630000;Begünstigung, Strafvereitelung (ohne Strafvereitelung im Amt), Hehlerei und Geldwäsche §§ 257, 258, 259-261 StGB;15003000;Magdeburg;X;91;0;0;0;0;0;0;3;8;11;10;21;12;7;19;13;13;16;6;3;70
630000;Begünstigung, Strafvereitelung (ohne Strafvereitelung im Amt), Hehlerei und Geldwäsche §§ 257, 258, 259-261 StGB;7315000;Mainz;M;107;0;0;0;0;0;0;2;6;8;12;20;10;6;16;20;29;16;5;1;87
630000;Begünstigung, Strafvereitelung (ohne Strafvereitelung im Amt), Hehlerei und Geldwäsche §§ 257, 258, 259-261 StGB;7315000;Mainz;W;24;0;0;0;0;0;0;1;1;2;2;4;1;2;3;3;5;6;1;2;20
630000;Begünstigung, Strafvereitelung (ohne Strafvereitelung im Amt), Hehlerei und Geldwäsche §§ 257, 258, 259-261 StGB;7315000;Mainz;X;131;0;0;0;0;0;0;3;7;10;14;24;11;8;19;23;34;22;6;3;107
630000;Begünstigung, Strafvereitelung (ohne Strafvereitelung im Amt), Hehlerei und Geldwäsche §§ 257, 258, 259-261 StGB;8222000;Mannheim;M;94;0;0;0;0;1;1;5;9;14;6;21;4;8;12;11;24;17;9;0;73
630000;Begünstigung, Strafvereitelung (ohne Strafvereitelung im Amt), Hehlerei und Geldwäsche §§ 257, 258, 259-261 StGB;8222000;Mannheim;W;12;0;0;0;0;0;0;1;0;1;1;2;1;1;2;1;2;3;2;0;10
630000;Begünstigung, Strafvereitelung (ohne Strafvereitelung im Amt), Hehlerei und Geldwäsche §§ 257, 258, 259-261 StGB;8222000;Mannheim;X;106;0;0;0;0;1;1;6;9;15;7;23;5;9;14;12;26;20;11;0;83
630000;Begünstigung, Strafvereitelung (ohne Strafvereitelung im Amt), Hehlerei und Geldwäsche §§ 257, 258, 259-261 StGB;5170024;Moers;M;22;0;0;0;0;0;0;0;0;0;0;0;1;1;2;5;9;5;1;0;22
630000;Begünstigung, Strafvereitelung (ohne Strafvereitelung im Amt), Hehlerei und Geldwäsche §§ 257, 258, 259-261 StGB;5170024;Moers;W;5;0;0;0;0;0;0;0;0;0;0;0;1;0;1;0;1;2;0;1;5
630000;Begünstigung, Strafvereitelung (ohne Strafvereitelung im Amt), Hehlerei und Geldwäsche §§ 257, 258, 259-261 StGB;5170024;Moers;X;27;0;0;0;0;0;0;0;0;0;0;0;2;1;3;5;10;7;1;1;27
630000;Begünstigung, Strafvereitelung (ohne Strafvereitelung im Amt), Hehlerei und Geldwäsche §§ 257, 258, 259-261 StGB;5116000;Mönchengladbach;M;72;0;0;0;0;0;0;0;5;5;6;11;3;5;8;11;20;16;4;2;61
630000;Begünstigung, Strafvereitelung (ohne Strafvereitelung im Amt), Hehlerei und Geldwäsche §§ 257, 258, 259-261 StGB;5116000;Mönchengladbach;W;14;0;0;0;0;0;0;0;2;2;2;4;1;0;1;2;4;2;0;1;10
630000;Begünstigung, Strafvereitelung (ohne Strafvereitelung im Amt), Hehlerei und Geldwäsche §§ 257, 258, 259-261 StGB;5116000;Mönchengladbach;X;86;0;0;0;0;0;0;0;7;7;8;15;4;5;9;13;24;18;4;3;71
630000;Begünstigung, Strafvereitelung (ohne Strafvereitelung im Amt), Hehlerei und Geldwäsche §§ 257, 258, 259-261 StGB;5117000;Mülheim an der Ruhr;M;26;0;0;0;0;0;0;1;2;3;2;5;1;2;3;4;5;4;4;1;21
630000;Begünstigung, Strafvereitelung (ohne Strafvereitelung im Amt), Hehlerei und Geldwäsche §§ 257, 258, 259-261 StGB;5117000;Mülheim an der Ruhr;W;3;0;0;0;0;0;0;0;0;0;0;0;0;1;1;0;1;0;1;0;3
630000;Begünstigung, Strafvereitelung (ohne Strafvereitelung im Amt), Hehlerei und Geldwäsche §§ 257, 258, 259-261 StGB;5117000;Mülheim an der Ruhr;X;29;0;0;0;0;0;0;1;2;3;2;5;1;3;4;4;6;4;5;1;24
630000;Begünstigung, Strafvereitelung (ohne Strafvereitelung im Amt), Hehlerei und Geldwäsche §§ 257, 258, 259-261 StGB;9162000;München;M;422;0;0;0;1;2;3;12;26;38;51;92;27;22;49;59;94;72;35;21;330
630000;Begünstigung, Strafvereitelung (ohne Strafvereitelung im Amt), Hehlerei und Geldwäsche §§ 257, 258, 259-261 StGB;9162000;München;W;108;0;0;0;0;0;0;3;12;15;12;27;6;4;10;14;22;13;9;13;81
630000;Begünstigung, Strafvereitelung (ohne Strafvereitelung im Amt), Hehlerei und Geldwäsche §§ 257, 258, 259-261 StGB;9162000;München;X;530;0;0;0;1;2;3;15;38;53;63;119;33;26;59;73;116;85;44;34;411
630000;Begünstigung, Strafvereitelung (ohne Strafvereitelung im Amt), Hehlerei und Geldwäsche §§ 257, 258, 259-261 StGB;5515000;Münster;M;57;0;0;0;0;0;0;2;4;6;8;14;3;2;5;10;16;5;4;3;43
630000;Begünstigung, Strafvereitelung (ohne Strafvereitelung im Amt), Hehlerei und Geldwäsche §§ 257, 258, 259-261 StGB;5515000;Münster;W;13;0;0;0;0;1;1;0;0;0;0;1;0;2;2;2;5;2;0;1;12
630000;Begünstigung, Strafvereitelung (ohne Strafvereitelung im Amt), Hehlerei und Geldwäsche §§ 257, 258, 259-261 StGB;5515000;Münster;X;70;0;0;0;0;1;1;2;4;6;8;15;3;4;7;12;21;7;4;4;55
630000;Begünstigung, Strafvereitelung (ohne Strafvereitelung im Amt), Hehlerei und Geldwäsche §§ 257, 258, 259-261 StGB;5162024;Neuss;M;26;0;0;0;0;0;0;0;2;2;1;3;0;0;0;6;9;4;4;0;23
630000;Begünstigung, Strafvereitelung (ohne Strafvereitelung im Amt), Hehlerei und Geldwäsche §§ 257, 258, 259-261 StGB;5162024;Neuss;W;5;0;0;0;0;0;0;0;0;0;0;0;0;0;0;0;2;2;1;0;5
630000;Begünstigung, Strafvereitelung (ohne Strafvereitelung im Amt), Hehlerei und Geldwäsche §§ 257, 258, 259-261 StGB;5162024;Neuss;X;31;0;0;0;0;0;0;0;2;2;1;3;0;0;0;6;11;6;5;0;28
630000;Begünstigung, Strafvereitelung (ohne Strafvereitelung im Amt), Hehlerei und Geldwäsche §§ 257, 258, 259-261 StGB;9564000;Nürnberg;M;220;0;0;0;0;2;2;6;6;12;20;34;13;12;25;32;71;36;16;6;186
630000;Begünstigung, Strafvereitelung (ohne Strafvereitelung im Amt), Hehlerei und Geldwäsche §§ 257, 258, 259-261 StGB;9564000;Nürnberg;W;72;0;0;0;0;2;2;1;1;2;6;10;1;7;8;15;19;9;6;5;62
630000;Begünstigung, Strafvereitelung (ohne Strafvereitelung im Amt), Hehlerei und Geldwäsche §§ 257, 258, 259-261 StGB;9564000;Nürnberg;X;292;0;0;0;0;4;4;7;7;14;26;44;14;19;33;47;90;45;22;11;248
630000;Begünstigung, Strafvereitelung (ohne Strafvereitelung im Amt), Hehlerei und Geldwäsche §§ 257, 258, 259-261 StGB;5119000;Oberhausen;M;41;0;0;0;0;1;1;3;1;4;3;8;1;3;4;6;12;7;4;0;33
630000;Begünstigung, Strafvereitelung (ohne Strafvereitelung im Amt), Hehlerei und Geldwäsche §§ 257, 258, 259-261 StGB;5119000;Oberhausen;W;6;0;0;0;0;0;0;0;0;0;2;2;0;1;1;0;1;2;0;0;4
630000;Begünstigung, Strafvereitelung (ohne Strafvereitelung im Amt), Hehlerei und Geldwäsche §§ 257, 258, 259-261 StGB;5119000;Oberhausen;X;47;0;0;0;0;1;1;3;1;4;5;10;1;4;5;6;13;9;4;0;37
630000;Begünstigung, Strafvereitelung (ohne Strafvereitelung im Amt), Hehlerei und Geldwäsche §§ 257, 258, 259-261 StGB;6413000;Offenbach am Main;M;203;0;0;1;0;0;1;5;9;14;30;45;17;16;33;37;43;32;9;4;158
630000;Begünstigung, Strafvereitelung (ohne Strafvereitelung im Amt), Hehlerei und Geldwäsche §§ 257, 258, 259-261 StGB;6413000;Offenbach am Main;W;53;0;0;0;0;1;1;1;2;3;5;9;2;3;5;9;17;7;6;0;44
630000;Begünstigung, Strafvereitelung (ohne Strafvereitelung im Amt), Hehlerei und Geldwäsche §§ 257, 258, 259-261 StGB;6413000;Offenbach am Main;X;256;0;0;1;0;1;2;6;11;17;35;54;19;19;38;46;60;39;15;4;202
630000;Begünstigung, Strafvereitelung (ohne Strafvereitelung im Amt), Hehlerei und Geldwäsche §§ 257, 258, 259-261 StGB;3403000;Oldenburg (Oldenburg);M;178;0;0;0;0;0;0;7;13;20;19;39;9;15;24;25;37;23;21;9;139
630000;Begünstigung, Strafvereitelung (ohne Strafvereitelung im Amt), Hehlerei und Geldwäsche §§ 257, 258, 259-261 StGB;3403000;Oldenburg (Oldenburg);W;61;0;0;0;0;2;2;0;4;4;4;10;3;5;8;9;16;14;3;1;51
630000;Begünstigung, Strafvereitelung (ohne Strafvereitelung im Amt), Hehlerei und Geldwäsche §§ 257, 258, 259-261 StGB;3403000;Oldenburg (Oldenburg);X;239;0;0;0;0;2;2;7;17;24;23;49;12;20;32;34;53;37;24;10;190
630000;Begünstigung, Strafvereitelung (ohne Strafvereitelung im Amt), Hehlerei und Geldwäsche §§ 257, 258, 259-261 StGB;3404000;Osnabrück;M;88;0;0;0;1;2;3;1;6;7;11;21;5;4;9;11;18;21;8;0;67
630000;Begünstigung, Strafvereitelung (ohne Strafvereitelung im Amt), Hehlerei und Geldwäsche §§ 257, 258, 259-261 StGB;3404000;Osnabrück;W;17;0;0;0;0;0;0;1;0;1;3;4;2;3;5;2;3;2;0;1;13
630000;Begünstigung, Strafvereitelung (ohne Strafvereitelung im Amt), Hehlerei und Geldwäsche §§ 257, 258, 259-261 StGB;3404000;Osnabrück;X;105;0;0;0;1;2;3;2;6;8;14;25;7;7;14;13;21;23;8;1;80
630000;Begünstigung, Strafvereitelung (ohne Strafvereitelung im Amt), Hehlerei und Geldwäsche §§ 257, 258, 259-261 StGB;5774032;Paderborn;M;45;0;0;0;0;0;0;2;3;5;11;16;0;3;3;6;6;8;5;1;29
630000;Begünstigung, Strafvereitelung (ohne Strafvereitelung im Amt), Hehlerei und Geldwäsche §§ 257, 258, 259-261 StGB;5774032;Paderborn;W;11;0;0;0;0;0;0;0;0;0;0;0;1;1;2;1;2;5;1;0;11
630000;Begünstigung, Strafvereitelung (ohne Strafvereitelung im Amt), Hehlerei und Geldwäsche §§ 257, 258, 259-261 StGB;5774032;Paderborn;X;56;0;0;0;0;0;0;2;3;5;11;16;1;4;5;7;8;13;6;1;40
630000;Begünstigung, Strafvereitelung (ohne Strafvereitelung im Amt), Hehlerei und Geldwäsche §§ 257, 258, 259-261 StGB;8231000;Pforzheim;M;35;0;0;0;0;0;0;1;5;6;9;15;3;6;9;2;2;3;2;2;20
630000;Begünstigung, Strafvereitelung (ohne Strafvereitelung im Amt), Hehlerei und Geldwäsche §§ 257, 258, 259-261 StGB;8231000;Pforzheim;W;8;0;0;0;0;0;0;0;0;0;1;1;1;0;1;0;1;4;0;1;7
630000;Begünstigung, Strafvereitelung (ohne Strafvereitelung im Amt), Hehlerei und Geldwäsche §§ 257, 258, 259-261 StGB;8231000;Pforzheim;X;43;0;0;0;0;0;0;1;5;6;10;16;4;6;10;2;3;7;2;3;27
630000;Begünstigung, Strafvereitelung (ohne Strafvereitelung im Amt), Hehlerei und Geldwäsche §§ 257, 258, 259-261 StGB;12054000;Potsdam;M;46;0;0;0;0;0;0;2;0;2;6;8;3;4;7;9;8;6;4;4;38
630000;Begünstigung, Strafvereitelung (ohne Strafvereitelung im Amt), Hehlerei und Geldwäsche §§ 257, 258, 259-261 StGB;12054000;Potsdam;W;17;0;0;0;0;0;0;0;1;1;0;1;0;1;1;5;5;3;1;1;16
630000;Begünstigung, Strafvereitelung (ohne Strafvereitelung im Amt), Hehlerei und Geldwäsche §§ 257, 258, 259-261 StGB;12054000;Potsdam;X;63;0;0;0;0;0;0;2;1;3;6;9;3;5;8;14;13;9;5;5;54
630000;Begünstigung, Strafvereitelung (ohne Strafvereitelung im Amt), Hehlerei und Geldwäsche §§ 257, 258, 259-261 StGB;5562032;Recklinghausen;M;40;0;0;0;0;0;0;1;3;4;4;8;5;3;8;3;11;5;2;3;32
630000;Begünstigung, Strafvereitelung (ohne Strafvereitelung im Amt), Hehlerei und Geldwäsche §§ 257, 258, 259-261 StGB;5562032;Recklinghausen;W;7;0;0;0;0;0;0;0;1;1;0;1;0;0;0;1;4;0;0;1;6
630000;Begünstigung, Strafvereitelung (ohne Strafvereitelung im Amt), Hehlerei und Geldwäsche §§ 257, 258, 259-261 StGB;5562032;Recklinghausen;X;47;0;0;0;0;0;0;1;4;5;4;9;5;3;8;4;15;5;2;4;38
630000;Begünstigung, Strafvereitelung (ohne Strafvereitelung im Amt), Hehlerei und Geldwäsche §§ 257, 258, 259-261 StGB;9362000;Regensburg;M;62;0;0;0;2;0;2;2;3;5;2;9;5;1;6;12;12;17;3;3;53
630000;Begünstigung, Strafvereitelung (ohne Strafvereitelung im Amt), Hehlerei und Geldwäsche §§ 257, 258, 259-261 StGB;9362000;Regensburg;W;14;0;0;0;0;0;0;1;1;2;2;4;1;1;2;1;2;5;0;0;10
630000;Begünstigung, Strafvereitelung (ohne Strafvereitelung im Amt), Hehlerei und Geldwäsche §§ 257, 258, 259-261 StGB;9362000;Regensburg;X;76;0;0;0;2;0;2;3;4;7;4;13;6;2;8;13;14;22;3;3;63
630000;Begünstigung, Strafvereitelung (ohne Strafvereitelung im Amt), Hehlerei und Geldwäsche §§ 257, 258, 259-261 StGB;5120000;Remscheid;M;18;0;0;0;0;0;0;0;2;2;0;2;1;3;4;0;7;2;2;1;16
630000;Begünstigung, Strafvereitelung (ohne Strafvereitelung im Amt), Hehlerei und Geldwäsche §§ 257, 258, 259-261 StGB;5120000;Remscheid;W;3;0;0;0;0;0;0;0;0;0;0;0;0;0;0;0;0;1;0;2;3
630000;Begünstigung, Strafvereitelung (ohne Strafvereitelung im Amt), Hehlerei und Geldwäsche §§ 257, 258, 259-261 StGB;5120000;Remscheid;X;21;0;0;0;0;0;0;0;2;2;0;2;1;3;4;0;7;3;2;3;19
630000;Begünstigung, Strafvereitelung (ohne Strafvereitelung im Amt), Hehlerei und Geldwäsche §§ 257, 258, 259-261 StGB;8415061;Reutlingen;M;37;0;0;0;0;2;2;1;0;1;5;8;1;2;3;4;12;8;2;0;29
630000;Begünstigung, Strafvereitelung (ohne Strafvereitelung im Amt), Hehlerei und Geldwäsche §§ 257, 258, 259-261 StGB;8415061;Reutlingen;W;10;0;0;0;0;0;0;1;2;3;1;4;0;0;0;3;2;0;0;1;6
630000;Begünstigung, Strafvereitelung (ohne Strafvereitelung im Amt), Hehlerei und Geldwäsche §§ 257, 258, 259-261 StGB;8415061;Reutlingen;X;47;0;0;0;0;2;2;2;2;4;6;12;1;2;3;7;14;8;2;1;35
630000;Begünstigung, Strafvereitelung (ohne Strafvereitelung im Amt), Hehlerei und Geldwäsche §§ 257, 258, 259-261 StGB;13003000;Rostock;M;38;0;0;0;0;1;1;1;1;2;3;6;3;0;3;7;7;7;4;4;32
630000;Begünstigung, Strafvereitelung (ohne Strafvereitelung im Amt), Hehlerei und Geldwäsche §§ 257, 258, 259-261 StGB;13003000;Rostock;W;7;0;0;0;0;0;0;0;0;0;0;0;1;0;1;2;1;0;3;0;7
630000;Begünstigung, Strafvereitelung (ohne Strafvereitelung im Amt), Hehlerei und Geldwäsche §§ 257, 258, 259-261 StGB;13003000;Rostock;X;45;0;0;0;0;1;1;1;1;2;3;6;4;0;4;9;8;7;7;4;39
630000;Begünstigung, Strafvereitelung (ohne Strafvereitelung im Amt), Hehlerei und Geldwäsche §§ 257, 258, 259-261 StGB;10041100;Saarbrücken;M;97;0;0;0;0;0;0;3;5;8;8;16;2;5;7;8;27;14;18;7;81
630000;Begünstigung, Strafvereitelung (ohne Strafvereitelung im Amt), Hehlerei und Geldwäsche §§ 257, 258, 259-261 StGB;10041100;Saarbrücken;W;32;0;0;0;0;0;0;0;0;0;3;3;3;2;5;0;7;8;5;4;29
630000;Begünstigung, Strafvereitelung (ohne Strafvereitelung im Amt), Hehlerei und Geldwäsche §§ 257, 258, 259-261 StGB;10041100;Saarbrücken;X;129;0;0;0;0;0;0;3;5;8;11;19;5;7;12;8;34;22;23;11;110
630000;Begünstigung, Strafvereitelung (ohne Strafvereitelung im Amt), Hehlerei und Geldwäsche §§ 257, 258, 259-261 StGB;5122000;Solingen;M;37;0;0;0;0;0;0;4;3;7;1;8;1;1;2;4;11;6;4;2;29
630000;Begünstigung, Strafvereitelung (ohne Strafvereitelung im Amt), Hehlerei und Geldwäsche §§ 257, 258, 259-261 StGB;5122000;Solingen;W;7;0;0;0;0;0;0;0;0;0;0;0;1;0;1;2;3;1;0;0;7
630000;Begünstigung, Strafvereitelung (ohne Strafvereitelung im Amt), Hehlerei und Geldwäsche §§ 257, 258, 259-261 StGB;5122000;Solingen;X;44;0;0;0;0;0;0;4;3;7;1;8;2;1;3;6;14;7;4;2;36
630000;Begünstigung, Strafvereitelung (ohne Strafvereitelung im Amt), Hehlerei und Geldwäsche §§ 257, 258, 259-261 StGB;8111000;Stuttgart;M;204;0;0;0;0;1;1;9;15;24;33;58;15;16;31;34;49;20;8;4;146
630000;Begünstigung, Strafvereitelung (ohne Strafvereitelung im Amt), Hehlerei und Geldwäsche §§ 257, 258, 259-261 StGB;8111000;Stuttgart;W;50;0;0;0;0;0;0;4;5;9;1;10;4;3;7;10;7;7;5;4;40
630000;Begünstigung, Strafvereitelung (ohne Strafvereitelung im Amt), Hehlerei und Geldwäsche §§ 257, 258, 259-261 StGB;8111000;Stuttgart;X;254;0;0;0;0;1;1;13;20;33;34;68;19;19;38;44;56;27;13;8;186
630000;Begünstigung, Strafvereitelung (ohne Strafvereitelung im Amt), Hehlerei und Geldwäsche §§ 257, 258, 259-261 StGB;7211000;Trier;M;38;0;0;0;0;0;0;4;7;11;0;11;2;1;3;5;7;7;2;3;27
630000;Begünstigung, Strafvereitelung (ohne Strafvereitelung im Amt), Hehlerei und Geldwäsche §§ 257, 258, 259-261 StGB;7211000;Trier;W;9;0;0;0;0;0;0;1;2;3;1;4;0;0;0;3;0;1;0;1;5
630000;Begünstigung, Strafvereitelung (ohne Strafvereitelung im Amt), Hehlerei und Geldwäsche §§ 257, 258, 259-261 StGB;7211000;Trier;X;47;0;0;0;0;0;0;5;9;14;1;15;2;1;3;8;7;8;2;4;32
630000;Begünstigung, Strafvereitelung (ohne Strafvereitelung im Amt), Hehlerei und Geldwäsche §§ 257, 258, 259-261 StGB;8421000;Ulm;M;42;0;0;0;0;0;0;1;3;4;2;6;2;1;3;7;12;10;3;1;36
630000;Begünstigung, Strafvereitelung (ohne Strafvereitelung im Amt), Hehlerei und Geldwäsche §§ 257, 258, 259-261 StGB;8421000;Ulm;W;13;0;0;0;0;0;0;0;1;1;0;1;2;1;3;3;4;1;0;1;12
630000;Begünstigung, Strafvereitelung (ohne Strafvereitelung im Amt), Hehlerei und Geldwäsche §§ 257, 258, 259-261 StGB;8421000;Ulm;X;55;0;0;0;0;0;0;1;4;5;2;7;4;2;6;10;16;11;3;2;48
630000;Begünstigung, Strafvereitelung (ohne Strafvereitelung im Amt), Hehlerei und Geldwäsche §§ 257, 258, 259-261 StGB;6414000;Wiesbaden;M;173;0;0;0;0;0;0;3;6;9;26;35;19;16;35;29;38;23;5;8;138
630000;Begünstigung, Strafvereitelung (ohne Strafvereitelung im Amt), Hehlerei und Geldwäsche §§ 257, 258, 259-261 StGB;6414000;Wiesbaden;W;46;0;0;0;0;0;0;0;3;3;5;8;4;3;7;5;11;8;4;3;38
630000;Begünstigung, Strafvereitelung (ohne Strafvereitelung im Amt), Hehlerei und Geldwäsche §§ 257, 258, 259-261 StGB;6414000;Wiesbaden;X;219;0;0;0;0;0;0;3;9;12;31;43;23;19;42;34;49;31;9;11;176
630000;Begünstigung, Strafvereitelung (ohne Strafvereitelung im Amt), Hehlerei und Geldwäsche §§ 257, 258, 259-261 StGB;3103000;Wolfsburg;M;35;0;0;0;0;0;0;0;1;1;3;4;1;6;7;5;9;4;4;2;31
630000;Begünstigung, Strafvereitelung (ohne Strafvereitelung im Amt), Hehlerei und Geldwäsche §§ 257, 258, 259-261 StGB;3103000;Wolfsburg;W;8;0;0;0;0;0;0;0;0;0;3;3;0;2;2;0;1;1;1;0;5
630000;Begünstigung, Strafvereitelung (ohne Strafvereitelung im Amt), Hehlerei und Geldwäsche §§ 257, 258, 259-261 StGB;3103000;Wolfsburg;X;43;0;0;0;0;0;0;0;1;1;6;7;1;8;9;5;10;5;5;2;36
630000;Begünstigung, Strafvereitelung (ohne Strafvereitelung im Amt), Hehlerei und Geldwäsche §§ 257, 258, 259-261 StGB;5124000;Wuppertal;M;112;0;0;0;0;1;1;4;13;17;9;27;6;9;15;17;27;19;5;2;85
630000;Begünstigung, Strafvereitelung (ohne Strafvereitelung im Amt), Hehlerei und Geldwäsche §§ 257, 258, 259-261 StGB;5124000;Wuppertal;W;32;0;0;0;0;0;0;2;3;5;4;9;2;3;5;5;8;2;3;0;23
630000;Begünstigung, Strafvereitelung (ohne Strafvereitelung im Amt), Hehlerei und Geldwäsche §§ 257, 258, 259-261 StGB;5124000;Wuppertal;X;144;0;0;0;0;1;1;6;16;22;13;36;8;12;20;22;35;21;8;2;108
630000;Begünstigung, Strafvereitelung (ohne Strafvereitelung im Amt), Hehlerei und Geldwäsche §§ 257, 258, 259-261 StGB;9663000;Würzburg;M;34;0;0;0;0;0;0;1;4;5;3;8;5;3;8;4;4;4;3;3;26
630000;Begünstigung, Strafvereitelung (ohne Strafvereitelung im Amt), Hehlerei und Geldwäsche §§ 257, 258, 259-261 StGB;9663000;Würzburg;W;10;0;0;0;0;0;0;0;0;0;3;3;1;2;3;0;1;2;1;0;7
630000;Begünstigung, Strafvereitelung (ohne Strafvereitelung im Amt), Hehlerei und Geldwäsche §§ 257, 258, 259-261 StGB;9663000;Würzburg;X;44;0;0;0;0;0;0;1;4;5;6;11;6;5;11;4;5;6;4;3;33
640000;Brandstiftung und Herbeiführen einer Brandgefahr §§ 306-306d, 306f StGB;5334002;Aachen;M;22;0;0;0;0;1;1;2;2;4;2;7;0;1;1;1;4;3;5;1;15
640000;Brandstiftung und Herbeiführen einer Brandgefahr §§ 306-306d, 306f StGB;5334002;Aachen;W;4;0;0;0;0;0;0;1;0;1;0;1;0;0;0;1;1;0;0;1;3
640000;Brandstiftung und Herbeiführen einer Brandgefahr §§ 306-306d, 306f StGB;5334002;Aachen;X;26;0;0;0;0;1;1;3;2;5;2;8;0;1;1;2;5;3;5;2;18
640000;Brandstiftung und Herbeiführen einer Brandgefahr §§ 306-306d, 306f StGB;9761000;Augsburg;M;17;0;2;0;0;0;2;1;1;2;0;4;2;0;2;1;2;5;2;1;13
640000;Brandstiftung und Herbeiführen einer Brandgefahr §§ 306-306d, 306f StGB;9761000;Augsburg;W;8;0;0;0;0;0;0;0;0;0;0;0;0;0;0;1;3;1;2;1;8
640000;Brandstiftung und Herbeiführen einer Brandgefahr §§ 306-306d, 306f StGB;9761000;Augsburg;X;25;0;2;0;0;0;2;1;1;2;0;4;2;0;2;2;5;6;4;2;21
640000;Brandstiftung und Herbeiführen einer Brandgefahr §§ 306-306d, 306f StGB;5378004;Bergisch Gladbach;M;3;0;0;1;1;0;2;0;0;0;0;2;0;0;0;0;0;1;0;0;1
640000;Brandstiftung und Herbeiführen einer Brandgefahr §§ 306-306d, 306f StGB;5378004;Bergisch Gladbach;W;1;0;0;0;0;0;0;0;0;0;0;0;0;0;0;0;1;0;0;0;1
640000;Brandstiftung und Herbeiführen einer Brandgefahr §§ 306-306d, 306f StGB;5378004;Bergisch Gladbach;X;4;0;0;1;1;0;2;0;0;0;0;2;0;0;0;0;1;1;0;0;2
640000;Brandstiftung und Herbeiführen einer Brandgefahr §§ 306-306d, 306f StGB;11000000;Berlin;M;247;3;4;2;2;4;15;15;14;29;22;66;9;7;16;24;44;34;26;37;181
640000;Brandstiftung und Herbeiführen einer Brandgefahr §§ 306-306d, 306f StGB;11000000;Berlin;W;86;3;0;2;1;0;6;0;2;2;7;15;4;4;8;9;14;15;12;13;71
640000;Brandstiftung und Herbeiführen einer Brandgefahr §§ 306-306d, 306f StGB;11000000;Berlin;X;333;6;4;4;3;4;21;15;16;31;29;81;13;11;24;33;58;49;38;50;252
640000;Brandstiftung und Herbeiführen einer Brandgefahr §§ 306-306d, 306f StGB;5711000;Bielefeld;M;33;0;0;0;1;1;2;0;3;3;2;7;3;1;4;5;8;0;4;5;26
640000;Brandstiftung und Herbeiführen einer Brandgefahr §§ 306-306d, 306f StGB;5711000;Bielefeld;W;6;0;0;0;0;0;0;0;0;0;0;0;1;0;1;0;1;3;0;1;6
640000;Brandstiftung und Herbeiführen einer Brandgefahr §§ 306-306d, 306f StGB;5711000;Bielefeld;X;39;0;0;0;1;1;2;0;3;3;2;7;4;1;5;5;9;3;4;6;32
640000;Brandstiftung und Herbeiführen einer Brandgefahr §§ 306-306d, 306f StGB;5911000;Bochum;M;25;0;0;0;0;1;1;0;1;1;3;5;0;1;1;6;4;8;1;0;20
640000;Brandstiftung und Herbeiführen einer Brandgefahr §§ 306-306d, 306f StGB;5911000;Bochum;W;5;0;0;0;0;0;0;0;0;0;1;1;0;0;0;0;2;0;0;2;4
640000;Brandstiftung und Herbeiführen einer Brandgefahr §§ 306-306d, 306f StGB;5911000;Bochum;X;30;0;0;0;0;1;1;0;1;1;4;6;0;1;1;6;6;8;1;2;24
640000;Brandstiftung und Herbeiführen einer Brandgefahr §§ 306-306d, 306f StGB;5314000;Bonn;M;18;0;0;0;0;0;0;0;0;0;0;0;2;2;4;2;6;2;4;0;18
640000;Brandstiftung und Herbeiführen einer Brandgefahr §§ 306-306d, 306f StGB;5314000;Bonn;W;12;1;1;2;0;0;4;1;0;1;0;5;1;1;2;1;1;1;1;1;7
640000;Brandstiftung und Herbeiführen einer Brandgefahr §§ 306-306d, 306f StGB;5314000;Bonn;X;30;1;1;2;0;0;4;1;0;1;0;5;3;3;6;3;7;3;5;1;25
640000;Brandstiftung und Herbeiführen einer Brandgefahr §§ 306-306d, 306f StGB;5512000;Bottrop;M;12;0;0;0;0;0;0;0;0;0;2;2;0;0;0;1;4;2;1;2;10
640000;Brandstiftung und Herbeiführen einer Brandgefahr §§ 306-306d, 306f StGB;5512000;Bottrop;W;5;0;0;0;0;0;0;0;0;0;1;1;0;0;0;1;0;0;2;1;4
640000;Brandstiftung und Herbeiführen einer Brandgefahr §§ 306-306d, 306f StGB;5512000;Bottrop;X;17;0;0;0;0;0;0;0;0;0;3;3;0;0;0;2;4;2;3;3;14
640000;Brandstiftung und Herbeiführen einer Brandgefahr §§ 306-306d, 306f StGB;3101000;Braunschweig;M;29;0;0;0;0;2;2;0;4;4;2;8;4;1;5;2;6;4;2;2;21
640000;Brandstiftung und Herbeiführen einer Brandgefahr §§ 306-306d, 306f StGB;3101000;Braunschweig;W;6;0;0;0;0;0;0;1;0;1;1;2;0;1;1;0;1;0;0;2;4
640000;Brandstiftung und Herbeiführen einer Brandgefahr §§ 306-306d, 306f StGB;3101000;Braunschweig;X;35;0;0;0;0;2;2;1;4;5;3;10;4;2;6;2;7;4;2;4;25
640000;Brandstiftung und Herbeiführen einer Brandgefahr §§ 306-306d, 306f StGB;4011000;Bremen;M;32;0;0;0;2;0;2;1;0;1;3;6;5;3;8;3;4;4;3;4;26
640000;Brandstiftung und Herbeiführen einer Brandgefahr §§ 306-306d, 306f StGB;4011000;Bremen;W;9;0;0;0;0;0;0;1;1;2;2;4;0;0;0;0;1;1;2;1;5
640000;Brandstiftung und Herbeiführen einer Brandgefahr §§ 306-306d, 306f StGB;4011000;Bremen;X;41;0;0;0;2;0;2;2;1;3;5;10;5;3;8;3;5;5;5;5;31
640000;Brandstiftung und Herbeiführen einer Brandgefahr §§ 306-306d, 306f StGB;4012000;Bremerhaven;M;16;1;1;1;0;0;3;0;0;0;0;3;1;1;2;1;5;3;0;2;13
640000;Brandstiftung und Herbeiführen einer Brandgefahr §§ 306-306d, 306f StGB;4012000;Bremerhaven;W;2;0;0;0;0;0;0;0;0;0;0;0;0;0;0;0;0;0;1;1;2
640000;Brandstiftung und Herbeiführen einer Brandgefahr §§ 306-306d, 306f StGB;4012000;Bremerhaven;X;18;1;1;1;0;0;3;0;0;0;0;3;1;1;2;1;5;3;1;3;15
640000;Brandstiftung und Herbeiführen einer Brandgefahr §§ 306-306d, 306f StGB;14511000;Chemnitz;M;43;1;1;0;2;3;7;3;5;8;5;20;0;2;2;1;7;8;2;3;23
640000;Brandstiftung und Herbeiführen einer Brandgefahr §§ 306-306d, 306f StGB;14511000;Chemnitz;W;10;0;0;0;0;0;0;0;0;0;0;0;0;0;0;0;3;2;0;5;10
640000;Brandstiftung und Herbeiführen einer Brandgefahr §§ 306-306d, 306f StGB;14511000;Chemnitz;X;53;1;1;0;2;3;7;3;5;8;5;20;0;2;2;1;10;10;2;8;33
640000;Brandstiftung und Herbeiführen einer Brandgefahr §§ 306-306d, 306f StGB;6411000;Darmstadt;M;21;0;0;1;1;0;2;2;4;6;1;9;1;2;3;1;3;0;3;2;12
640000;Brandstiftung und Herbeiführen einer Brandgefahr §§ 306-306d, 306f StGB;6411000;Darmstadt;W;3;0;0;0;0;0;0;0;0;0;0;0;0;0;0;0;2;0;1;0;3
640000;Brandstiftung und Herbeiführen einer Brandgefahr §§ 306-306d, 306f StGB;6411000;Darmstadt;X;24;0;0;1;1;0;2;2;4;6;1;9;1;2;3;1;5;0;4;2;15
640000;Brandstiftung und Herbeiführen einer Brandgefahr §§ 306-306d, 306f StGB;5913000;Dortmund;M;67;1;0;5;6;2;14;4;2;6;10;30;2;2;4;6;7;6;7;7;37
640000;Brandstiftung und Herbeiführen einer Brandgefahr §§ 306-306d, 306f StGB;5913000;Dortmund;W;12;0;0;0;0;1;1;0;1;1;0;2;0;0;0;0;1;3;3;3;10
640000;Brandstiftung und Herbeiführen einer Brandgefahr §§ 306-306d, 306f StGB;5913000;Dortmund;X;79;1;0;5;6;3;15;4;3;7;10;32;2;2;4;6;8;9;10;10;47
640000;Brandstiftung und Herbeiführen einer Brandgefahr §§ 306-306d, 306f StGB;14612000;Dresden;M;56;1;0;0;0;3;4;1;1;2;2;8;2;6;8;5;11;9;6;9;48
640000;Brandstiftung und Herbeiführen einer Brandgefahr §§ 306-306d, 306f StGB;14612000;Dresden;W;16;0;0;0;0;0;0;1;1;2;0;2;0;2;2;1;4;1;2;4;14
640000;Brandstiftung und Herbeiführen einer Brandgefahr §§ 306-306d, 306f StGB;14612000;Dresden;X;72;1;0;0;0;3;4;2;2;4;2;10;2;8;10;6;15;10;8;13;62
640000;Brandstiftung und Herbeiführen einer Brandgefahr §§ 306-306d, 306f StGB;5112000;Duisburg;M;33;0;1;0;0;2;3;6;1;7;3;13;1;2;3;4;8;3;0;2;20
640000;Brandstiftung und Herbeiführen einer Brandgefahr §§ 306-306d, 306f StGB;5112000;Duisburg;W;10;0;0;0;0;1;1;0;0;0;0;1;1;0;1;0;3;2;1;2;9
640000;Brandstiftung und Herbeiführen einer Brandgefahr §§ 306-306d, 306f StGB;5112000;Duisburg;X;43;0;1;0;0;3;4;6;1;7;3;14;2;2;4;4;11;5;1;4;29
640000;Brandstiftung und Herbeiführen einer Brandgefahr §§ 306-306d, 306f StGB;5111000;Düsseldorf;M;40;1;0;0;0;1;2;3;3;6;1;9;3;0;3;5;9;6;4;4;31
640000;Brandstiftung und Herbeiführen einer Brandgefahr §§ 306-306d, 306f StGB;5111000;Düsseldorf;W;18;0;0;0;0;1;1;1;0;1;1;3;0;0;0;3;2;5;2;3;15
640000;Brandstiftung und Herbeiführen einer Brandgefahr §§ 306-306d, 306f StGB;5111000;Düsseldorf;X;58;1;0;0;0;2;3;4;3;7;2;12;3;0;3;8;11;11;6;7;46
640000;Brandstiftung und Herbeiführen einer Brandgefahr §§ 306-306d, 306f StGB;16051000;Erfurt;M;22;0;0;0;0;5;5;4;5;9;0;14;0;0;0;3;2;0;1;2;8
640000;Brandstiftung und Herbeiführen einer Brandgefahr §§ 306-306d, 306f StGB;16051000;Erfurt;W;3;0;0;0;0;0;0;0;0;0;0;0;0;0;0;1;2;0;0;0;3
640000;Brandstiftung und Herbeiführen einer Brandgefahr §§ 306-306d, 306f StGB;16051000;Erfurt;X;25;0;0;0;0;5;5;4;5;9;0;14;0;0;0;4;4;0;1;2;11
640000;Brandstiftung und Herbeiführen einer Brandgefahr §§ 306-306d, 306f StGB;9562000;Erlangen;M;10;0;0;0;0;1;1;1;0;1;1;3;0;2;2;1;2;1;1;0;7
640000;Brandstiftung und Herbeiführen einer Brandgefahr §§ 306-306d, 306f StGB;9562000;Erlangen;W;1;0;0;0;0;0;0;0;0;0;0;0;0;0;0;0;0;0;0;1;1
640000;Brandstiftung und Herbeiführen einer Brandgefahr §§ 306-306d, 306f StGB;9562000;Erlangen;X;11;0;0;0;0;1;1;1;0;1;1;3;0;2;2;1;2;1;1;1;8
640000;Brandstiftung und Herbeiführen einer Brandgefahr §§ 306-306d, 306f StGB;5113000;Essen;M;92;0;0;0;1;2;3;9;10;19;6;28;6;5;11;11;16;15;3;8;64
640000;Brandstiftung und Herbeiführen einer Brandgefahr §§ 306-306d, 306f StGB;5113000;Essen;W;31;0;0;0;0;0;0;1;0;1;2;3;0;1;1;2;9;4;3;9;28
640000;Brandstiftung und Herbeiführen einer Brandgefahr §§ 306-306d, 306f StGB;5113000;Essen;X;123;0;0;0;1;2;3;10;10;20;8;31;6;6;12;13;25;19;6;17;92
640000;Brandstiftung und Herbeiführen einer Brandgefahr §§ 306-306d, 306f StGB;6412000;Frankfurt am Main;M;81;0;3;1;1;2;7;3;1;4;5;16;7;4;11;7;12;15;11;9;65
640000;Brandstiftung und Herbeiführen einer Brandgefahr §§ 306-306d, 306f StGB;6412000;Frankfurt am Main;W;39;1;0;0;0;1;2;1;0;1;3;6;0;1;1;6;4;5;6;11;33
640000;Brandstiftung und Herbeiführen einer Brandgefahr §§ 306-306d, 306f StGB;6412000;Frankfurt am Main;X;120;1;3;1;1;3;9;4;1;5;8;22;7;5;12;13;16;20;17;20;98
640000;Brandstiftung und Herbeiführen einer Brandgefahr §§ 306-306d, 306f StGB;8311000;Freiburg im Breisgau;M;15;1;0;2;0;0;3;1;1;2;0;5;1;0;1;0;6;1;2;0;10
640000;Brandstiftung und Herbeiführen einer Brandgefahr §§ 306-306d, 306f StGB;8311000;Freiburg im Breisgau;W;4;1;0;0;1;0;2;0;0;0;0;2;0;0;0;1;0;0;0;1;2
640000;Brandstiftung und Herbeiführen einer Brandgefahr §§ 306-306d, 306f StGB;8311000;Freiburg im Breisgau;X;19;2;0;2;1;0;5;1;1;2;0;7;1;0;1;1;6;1;2;1;12
640000;Brandstiftung und Herbeiführen einer Brandgefahr §§ 306-306d, 306f StGB;9563000;Fürth;M;5;0;0;0;0;0;0;0;0;0;1;1;0;0;0;0;0;2;1;1;4
640000;Brandstiftung und Herbeiführen einer Brandgefahr §§ 306-306d, 306f StGB;9563000;Fürth;W;1;0;0;0;0;0;0;0;0;0;0;0;0;0;0;0;0;0;0;1;1
640000;Brandstiftung und Herbeiführen einer Brandgefahr §§ 306-306d, 306f StGB;9563000;Fürth;X;6;0;0;0;0;0;0;0;0;0;1;1;0;0;0;0;0;2;1;2;5
640000;Brandstiftung und Herbeiführen einer Brandgefahr §§ 306-306d, 306f StGB;5513000;Gelsenkirchen;M;12;2;0;0;0;0;2;0;1;1;0;3;0;1;1;2;2;2;0;2;9
640000;Brandstiftung und Herbeiführen einer Brandgefahr §§ 306-306d, 306f StGB;5513000;Gelsenkirchen;W;4;0;0;0;0;0;0;0;0;0;1;1;1;0;1;0;0;0;2;0;3
640000;Brandstiftung und Herbeiführen einer Brandgefahr §§ 306-306d, 306f StGB;5513000;Gelsenkirchen;X;16;2;0;0;0;0;2;0;1;1;1;4;1;1;2;2;2;2;2;2;12
640000;Brandstiftung und Herbeiführen einer Brandgefahr §§ 306-306d, 306f StGB;3152012;Göttingen;M;6;0;1;0;0;0;1;0;1;1;1;3;0;0;0;1;1;1;0;0;3
640000;Brandstiftung und Herbeiführen einer Brandgefahr §§ 306-306d, 306f StGB;3152012;Göttingen;W;1;0;0;0;0;0;0;0;0;0;0;0;0;0;0;0;1;0;0;0;1
640000;Brandstiftung und Herbeiführen einer Brandgefahr §§ 306-306d, 306f StGB;3152012;Göttingen;X;7;0;1;0;0;0;1;0;1;1;1;3;0;0;0;1;2;1;0;0;4
640000;Brandstiftung und Herbeiführen einer Brandgefahr §§ 306-306d, 306f StGB;5914000;Hagen;M;10;0;0;1;0;0;1;1;0;1;1;3;0;1;1;0;3;0;2;1;7
640000;Brandstiftung und Herbeiführen einer Brandgefahr §§ 306-306d, 306f StGB;5914000;Hagen;W;5;0;0;1;0;0;1;0;0;0;1;2;0;0;0;1;1;0;0;1;3
640000;Brandstiftung und Herbeiführen einer Brandgefahr §§ 306-306d, 306f StGB;5914000;Hagen;X;15;0;0;2;0;0;2;1;0;1;2;5;0;1;1;1;4;0;2;2;10
640000;Brandstiftung und Herbeiführen einer Brandgefahr §§ 306-306d, 306f StGB;15002000;Halle (Saale);M;21;0;0;0;0;0;0;1;3;4;3;7;0;3;3;2;4;2;0;3;14
640000;Brandstiftung und Herbeiführen einer Brandgefahr §§ 306-306d, 306f StGB;15002000;Halle (Saale);W;9;0;0;0;1;0;1;0;0;0;0;1;0;0;0;3;0;0;2;3;8
640000;Brandstiftung und Herbeiführen einer Brandgefahr §§ 306-306d, 306f StGB;15002000;Halle (Saale);X;30;0;0;0;1;0;1;1;3;4;3;8;0;3;3;5;4;2;2;6;22
640000;Brandstiftung und Herbeiführen einer Brandgefahr §§ 306-306d, 306f StGB;2000000;Hamburg;M;127;1;1;1;3;6;12;9;6;15;16;43;6;8;14;12;18;14;17;9;84
640000;Brandstiftung und Herbeiführen einer Brandgefahr §§ 306-306d, 306f StGB;2000000;Hamburg;W;40;0;0;0;0;1;1;2;1;3;1;5;3;2;5;2;5;4;9;10;35
640000;Brandstiftung und Herbeiführen einer Brandgefahr §§ 306-306d, 306f StGB;2000000;Hamburg;X;167;1;1;1;3;7;13;11;7;18;17;48;9;10;19;14;23;18;26;19;119
640000;Brandstiftung und Herbeiführen einer Brandgefahr §§ 306-306d, 306f StGB;5915000;Hamm;M;11;0;0;1;0;0;1;1;0;1;2;4;0;1;1;3;1;0;1;1;7
640000;Brandstiftung und Herbeiführen einer Brandgefahr §§ 306-306d, 306f StGB;5915000;Hamm;W;7;0;0;0;0;0;0;0;1;1;0;1;0;2;2;0;2;1;0;1;6
640000;Brandstiftung und Herbeiführen einer Brandgefahr §§ 306-306d, 306f StGB;5915000;Hamm;X;18;0;0;1;0;0;1;1;1;2;2;5;0;3;3;3;3;1;1;2;13
640000;Brandstiftung und Herbeiführen einer Brandgefahr §§ 306-306d, 306f StGB;3241001;Hannover;M;24;1;0;0;0;0;1;0;0;0;2;3;3;1;4;2;6;3;5;1;21
640000;Brandstiftung und Herbeiführen einer Brandgefahr §§ 306-306d, 306f StGB;3241001;Hannover;W;11;0;0;0;0;0;0;0;1;1;0;1;1;0;1;0;4;2;3;0;10
640000;Brandstiftung und Herbeiführen einer Brandgefahr §§ 306-306d, 306f StGB;3241001;Hannover;X;35;1;0;0;0;0;1;0;1;1;2;4;4;1;5;2;10;5;8;1;31
640000;Brandstiftung und Herbeiführen einer Brandgefahr §§ 306-306d, 306f StGB;8221000;Heidelberg;M;10;0;0;0;0;0;0;0;0;0;2;2;0;2;2;0;2;2;2;0;8
640000;Brandstiftung und Herbeiführen einer Brandgefahr §§ 306-306d, 306f StGB;8221000;Heidelberg;W;5;0;0;0;0;0;0;0;0;0;0;0;0;0;0;0;2;0;1;2;5
640000;Brandstiftung und Herbeiführen einer Brandgefahr §§ 306-306d, 306f StGB;8221000;Heidelberg;X;15;0;0;0;0;0;0;0;0;0;2;2;0;2;2;0;4;2;3;2;13
640000;Brandstiftung und Herbeiführen einer Brandgefahr §§ 306-306d, 306f StGB;8121000;Heilbronn;M;11;0;0;0;0;0;0;1;0;1;0;1;0;3;3;2;0;1;1;3;10
640000;Brandstiftung und Herbeiführen einer Brandgefahr §§ 306-306d, 306f StGB;8121000;Heilbronn;W;4;0;0;0;0;0;0;0;0;0;0;0;3;0;3;0;0;0;1;0;4
640000;Brandstiftung und Herbeiführen einer Brandgefahr §§ 306-306d, 306f StGB;8121000;Heilbronn;X;15;0;0;0;0;0;0;1;0;1;0;1;3;3;6;2;0;1;2;3;14
640000;Brandstiftung und Herbeiführen einer Brandgefahr §§ 306-306d, 306f StGB;5916000;Herne;M;13;0;0;0;0;1;1;4;1;5;0;6;0;0;0;0;0;4;2;1;7
640000;Brandstiftung und Herbeiführen einer Brandgefahr §§ 306-306d, 306f StGB;5916000;Herne;W;1;0;0;0;0;0;0;0;0;0;0;0;0;0;0;0;0;0;0;1;1
640000;Brandstiftung und Herbeiführen einer Brandgefahr §§ 306-306d, 306f StGB;5916000;Herne;X;14;0;0;0;0;1;1;4;1;5;0;6;0;0;0;0;0;4;2;2;8
640000;Brandstiftung und Herbeiführen einer Brandgefahr §§ 306-306d, 306f StGB;9161000;Ingolstadt;M;18;0;0;1;1;0;2;0;1;1;2;5;1;3;4;3;1;2;0;3;13
640000;Brandstiftung und Herbeiführen einer Brandgefahr §§ 306-306d, 306f StGB;9161000;Ingolstadt;W;3;0;0;1;0;0;1;0;0;0;0;1;0;0;0;1;0;0;1;0;2
640000;Brandstiftung und Herbeiführen einer Brandgefahr §§ 306-306d, 306f StGB;9161000;Ingolstadt;X;21;0;0;2;1;0;3;0;1;1;2;6;1;3;4;4;1;2;1;3;15
640000;Brandstiftung und Herbeiführen einer Brandgefahr §§ 306-306d, 306f StGB;16053000;Jena;M;12;0;0;0;0;0;0;0;2;2;5;7;0;0;0;2;2;1;0;0;5
640000;Brandstiftung und Herbeiführen einer Brandgefahr §§ 306-306d, 306f StGB;16053000;Jena;W;2;0;0;0;0;0;0;0;0;0;0;0;0;1;1;0;0;0;1;0;2
640000;Brandstiftung und Herbeiführen einer Brandgefahr §§ 306-306d, 306f StGB;16053000;Jena;X;14;0;0;0;0;0;0;0;2;2;5;7;0;1;1;2;2;1;1;0;7
640000;Brandstiftung und Herbeiführen einer Brandgefahr §§ 306-306d, 306f StGB;8212000;Karlsruhe;M;15;0;0;0;0;0;0;1;1;2;2;4;1;0;1;0;1;2;3;4;11
640000;Brandstiftung und Herbeiführen einer Brandgefahr §§ 306-306d, 306f StGB;8212000;Karlsruhe;W;4;0;0;0;0;0;0;0;0;0;0;0;0;0;0;0;1;2;1;0;4
640000;Brandstiftung und Herbeiführen einer Brandgefahr §§ 306-306d, 306f StGB;8212000;Karlsruhe;X;19;0;0;0;0;0;0;1;1;2;2;4;1;0;1;0;2;4;4;4;15
640000;Brandstiftung und Herbeiführen einer Brandgefahr §§ 306-306d, 306f StGB;6611000;Kassel;M;14;1;0;0;0;1;2;0;1;1;1;4;1;2;3;0;3;3;1;0;10
640000;Brandstiftung und Herbeiführen einer Brandgefahr §§ 306-306d, 306f StGB;6611000;Kassel;W;4;0;0;0;0;0;0;0;0;0;0;0;2;0;2;0;1;0;0;1;4
640000;Brandstiftung und Herbeiführen einer Brandgefahr §§ 306-306d, 306f StGB;6611000;Kassel;X;18;1;0;0;0;1;2;0;1;1;1;4;3;2;5;0;4;3;1;1;14
640000;Brandstiftung und Herbeiführen einer Brandgefahr §§ 306-306d, 306f StGB;1002000;Kiel;M;24;0;0;1;1;1;3;2;1;3;2;8;1;4;5;2;4;2;3;0;16
640000;Brandstiftung und Herbeiführen einer Brandgefahr §§ 306-306d, 306f StGB;1002000;Kiel;W;3;0;0;0;0;0;0;0;0;0;0;0;1;0;1;0;0;1;1;0;3
640000;Brandstiftung und Herbeiführen einer Brandgefahr §§ 306-306d, 306f StGB;1002000;Kiel;X;27;0;0;1;1;1;3;2;1;3;2;8;2;4;6;2;4;3;4;0;19
640000;Brandstiftung und Herbeiführen einer Brandgefahr §§ 306-306d, 306f StGB;7111000;Koblenz;M;9;0;0;0;0;0;0;0;1;1;2;3;1;0;1;0;1;2;0;2;6
640000;Brandstiftung und Herbeiführen einer Brandgefahr §§ 306-306d, 306f StGB;7111000;Koblenz;W;5;0;0;0;0;0;0;0;0;0;0;0;0;0;0;1;0;0;1;3;5
640000;Brandstiftung und Herbeiführen einer Brandgefahr §§ 306-306d, 306f StGB;7111000;Koblenz;X;14;0;0;0;0;0;0;0;1;1;2;3;1;0;1;1;1;2;1;5;11
640000;Brandstiftung und Herbeiführen einer Brandgefahr §§ 306-306d, 306f StGB;5315000;Köln;M;84;0;1;0;0;5;6;2;4;6;5;17;7;2;9;8;15;16;7;12;67
640000;Brandstiftung und Herbeiführen einer Brandgefahr §§ 306-306d, 306f StGB;5315000;Köln;W;28;0;0;0;0;0;0;2;2;4;0;4;1;2;3;0;5;3;2;11;24
640000;Brandstiftung und Herbeiführen einer Brandgefahr §§ 306-306d, 306f StGB;5315000;Köln;X;112;0;1;0;0;5;6;4;6;10;5;21;8;4;12;8;20;19;9;23;91
640000;Brandstiftung und Herbeiführen einer Brandgefahr §§ 306-306d, 306f StGB;5114000;Krefeld;M;27;0;1;0;0;2;3;3;3;6;0;9;0;1;1;3;3;6;2;3;18
640000;Brandstiftung und Herbeiführen einer Brandgefahr §§ 306-306d, 306f StGB;5114000;Krefeld;W;6;0;0;0;0;0;0;0;0;0;0;0;0;0;0;0;3;3;0;0;6
640000;Brandstiftung und Herbeiführen einer Brandgefahr §§ 306-306d, 306f StGB;5114000;Krefeld;X;33;0;1;0;0;2;3;3;3;6;0;9;0;1;1;3;6;9;2;3;24
640000;Brandstiftung und Herbeiführen einer Brandgefahr §§ 306-306d, 306f StGB;14713000;Leipzig;M;45;1;0;0;0;3;4;0;1;1;1;6;6;2;8;8;10;4;4;5;39
640000;Brandstiftung und Herbeiführen einer Brandgefahr §§ 306-306d, 306f StGB;14713000;Leipzig;W;19;0;0;0;0;0;0;1;2;3;0;3;1;0;1;0;4;4;3;4;16
640000;Brandstiftung und Herbeiführen einer Brandgefahr §§ 306-306d, 306f StGB;14713000;Leipzig;X;64;1;0;0;0;3;4;1;3;4;1;9;7;2;9;8;14;8;7;9;55
640000;Brandstiftung und Herbeiführen einer Brandgefahr §§ 306-306d, 306f StGB;5316000;Leverkusen;M;9;0;0;0;0;1;1;0;2;2;1;4;0;0;0;2;0;2;1;0;5
640000;Brandstiftung und Herbeiführen einer Brandgefahr §§ 306-306d, 306f StGB;5316000;Leverkusen;W;6;0;0;0;0;0;0;0;0;0;1;1;0;0;0;0;1;2;1;1;5
640000;Brandstiftung und Herbeiführen einer Brandgefahr §§ 306-306d, 306f StGB;5316000;Leverkusen;X;15;0;0;0;0;1;1;0;2;2;2;5;0;0;0;2;1;4;2;1;10
640000;Brandstiftung und Herbeiführen einer Brandgefahr §§ 306-306d, 306f StGB;1003000;Lübeck;M;17;1;0;1;0;0;2;2;1;3;1;6;0;0;0;1;3;4;3;0;11
640000;Brandstiftung und Herbeiführen einer Brandgefahr §§ 306-306d, 306f StGB;1003000;Lübeck;W;9;0;0;0;1;0;1;0;0;0;0;1;0;0;0;1;0;1;4;2;8
640000;Brandstiftung und Herbeiführen einer Brandgefahr §§ 306-306d, 306f StGB;1003000;Lübeck;X;26;1;0;1;1;0;3;2;1;3;1;7;0;0;0;2;3;5;7;2;19
640000;Brandstiftung und Herbeiführen einer Brandgefahr §§ 306-306d, 306f StGB;7314000;Ludwigshafen am Rhein;M;12;0;0;2;1;1;4;0;0;0;0;4;0;0;0;2;2;0;0;4;8
640000;Brandstiftung und Herbeiführen einer Brandgefahr §§ 306-306d, 306f StGB;7314000;Ludwigshafen am Rhein;W;3;0;0;0;0;0;0;0;0;0;0;0;0;0;0;0;2;0;0;1;3
640000;Brandstiftung und Herbeiführen einer Brandgefahr §§ 306-306d, 306f StGB;7314000;Ludwigshafen am Rhein;X;15;0;0;2;1;1;4;0;0;0;0;4;0;0;0;2;4;0;0;5;11
640000;Brandstiftung und Herbeiführen einer Brandgefahr §§ 306-306d, 306f StGB;15003000;Magdeburg;M;26;0;0;0;0;2;2;0;1;1;6;9;0;3;3;1;7;3;2;1;17
640000;Brandstiftung und Herbeiführen einer Brandgefahr §§ 306-306d, 306f StGB;15003000;Magdeburg;W;5;0;0;0;0;0;0;0;0;0;1;1;0;0;0;0;0;1;0;3;4
640000;Brandstiftung und Herbeiführen einer Brandgefahr §§ 306-306d, 306f StGB;15003000;Magdeburg;X;31;0;0;0;0;2;2;0;1;1;7;10;0;3;3;1;7;4;2;4;21
640000;Brandstiftung und Herbeiführen einer Brandgefahr §§ 306-306d, 306f StGB;7315000;Mainz;M;7;0;0;2;0;0;2;0;0;0;0;2;0;0;0;0;1;1;0;3;5
640000;Brandstiftung und Herbeiführen einer Brandgefahr §§ 306-306d, 306f StGB;7315000;Mainz;W;1;0;0;0;0;0;0;0;0;0;0;0;0;0;0;0;1;0;0;0;1
640000;Brandstiftung und Herbeiführen einer Brandgefahr §§ 306-306d, 306f StGB;7315000;Mainz;X;8;0;0;2;0;0;2;0;0;0;0;2;0;0;0;0;2;1;0;3;6
640000;Brandstiftung und Herbeiführen einer Brandgefahr §§ 306-306d, 306f StGB;8222000;Mannheim;M;19;0;0;0;0;1;1;2;1;3;0;4;1;0;1;2;2;4;2;4;15
640000;Brandstiftung und Herbeiführen einer Brandgefahr §§ 306-306d, 306f StGB;8222000;Mannheim;W;6;0;0;0;0;1;1;0;0;0;1;2;0;0;0;0;1;2;1;0;4
640000;Brandstiftung und Herbeiführen einer Brandgefahr §§ 306-306d, 306f StGB;8222000;Mannheim;X;25;0;0;0;0;2;2;2;1;3;1;6;1;0;1;2;3;6;3;4;19
640000;Brandstiftung und Herbeiführen einer Brandgefahr §§ 306-306d, 306f StGB;5170024;Moers;M;2;0;0;0;0;0;0;0;0;0;0;0;0;0;0;0;1;1;0;0;2
640000;Brandstiftung und Herbeiführen einer Brandgefahr §§ 306-306d, 306f StGB;5170024;Moers;W;0;0;0;0;0;0;0;0;0;0;0;0;0;0;0;0;0;0;0;0;0
640000;Brandstiftung und Herbeiführen einer Brandgefahr §§ 306-306d, 306f StGB;5170024;Moers;X;2;0;0;0;0;0;0;0;0;0;0;0;0;0;0;0;1;1;0;0;2
640000;Brandstiftung und Herbeiführen einer Brandgefahr §§ 306-306d, 306f StGB;5116000;Mönchengladbach;M;18;0;0;0;0;1;1;2;1;3;1;5;0;2;2;1;2;3;2;3;13
640000;Brandstiftung und Herbeiführen einer Brandgefahr §§ 306-306d, 306f StGB;5116000;Mönchengladbach;W;7;1;0;0;0;3;4;0;1;1;0;5;0;0;0;2;0;0;0;0;2
640000;Brandstiftung und Herbeiführen einer Brandgefahr §§ 306-306d, 306f StGB;5116000;Mönchengladbach;X;25;1;0;0;0;4;5;2;2;4;1;10;0;2;2;3;2;3;2;3;15
640000;Brandstiftung und Herbeiführen einer Brandgefahr §§ 306-306d, 306f StGB;5117000;Mülheim an der Ruhr;M;23;1;0;1;0;1;3;2;0;2;0;5;1;1;2;1;6;4;1;4;18
640000;Brandstiftung und Herbeiführen einer Brandgefahr §§ 306-306d, 306f StGB;5117000;Mülheim an der Ruhr;W;14;0;0;0;0;0;0;0;0;0;0;0;2;1;3;1;3;4;1;2;14
640000;Brandstiftung und Herbeiführen einer Brandgefahr §§ 306-306d, 306f StGB;5117000;Mülheim an der Ruhr;X;37;1;0;1;0;1;3;2;0;2;0;5;3;2;5;2;9;8;2;6;32
640000;Brandstiftung und Herbeiführen einer Brandgefahr §§ 306-306d, 306f StGB;9162000;München;M;50;0;2;1;0;0;3;1;0;1;3;7;1;2;3;5;15;7;6;7;43
640000;Brandstiftung und Herbeiführen einer Brandgefahr §§ 306-306d, 306f StGB;9162000;München;W;20;0;0;0;0;0;0;0;0;0;0;0;1;2;3;4;1;6;0;6;20
640000;Brandstiftung und Herbeiführen einer Brandgefahr §§ 306-306d, 306f StGB;9162000;München;X;70;0;2;1;0;0;3;1;0;1;3;7;2;4;6;9;16;13;6;13;63
640000;Brandstiftung und Herbeiführen einer Brandgefahr §§ 306-306d, 306f StGB;5515000;Münster;M;16;0;0;1;3;0;4;1;0;1;1;6;1;1;2;2;0;2;2;2;10
640000;Brandstiftung und Herbeiführen einer Brandgefahr §§ 306-306d, 306f StGB;5515000;Münster;W;1;0;0;0;0;0;0;0;0;0;0;0;0;0;0;0;1;0;0;0;1
640000;Brandstiftung und Herbeiführen einer Brandgefahr §§ 306-306d, 306f StGB;5515000;Münster;X;17;0;0;1;3;0;4;1;0;1;1;6;1;1;2;2;1;2;2;2;11
640000;Brandstiftung und Herbeiführen einer Brandgefahr §§ 306-306d, 306f StGB;5162024;Neuss;M;14;0;0;0;0;0;0;2;3;5;2;7;0;0;0;0;2;2;2;1;7
640000;Brandstiftung und Herbeiführen einer Brandgefahr §§ 306-306d, 306f StGB;5162024;Neuss;W;1;0;0;0;0;0;0;0;0;0;0;0;0;0;0;0;0;0;1;0;1
640000;Brandstiftung und Herbeiführen einer Brandgefahr §§ 306-306d, 306f StGB;5162024;Neuss;X;15;0;0;0;0;0;0;2;3;5;2;7;0;0;0;0;2;2;3;1;8
640000;Brandstiftung und Herbeiführen einer Brandgefahr §§ 306-306d, 306f StGB;9564000;Nürnberg;M;21;0;0;0;0;0;0;1;1;2;1;3;0;0;0;2;8;4;2;2;18
640000;Brandstiftung und Herbeiführen einer Brandgefahr §§ 306-306d, 306f StGB;9564000;Nürnberg;W;7;0;0;0;0;0;0;0;0;0;0;0;0;1;1;1;3;0;1;1;7
640000;Brandstiftung und Herbeiführen einer Brandgefahr §§ 306-306d, 306f StGB;9564000;Nürnberg;X;28;0;0;0;0;0;0;1;1;2;1;3;0;1;1;3;11;4;3;3;25
640000;Brandstiftung und Herbeiführen einer Brandgefahr §§ 306-306d, 306f StGB;5119000;Oberhausen;M;15;0;0;0;2;0;2;0;0;0;2;4;0;2;2;3;2;2;1;1;11
640000;Brandstiftung und Herbeiführen einer Brandgefahr §§ 306-306d, 306f StGB;5119000;Oberhausen;W;7;0;0;0;0;0;0;0;0;0;1;1;0;0;0;1;1;1;0;3;6
640000;Brandstiftung und Herbeiführen einer Brandgefahr §§ 306-306d, 306f StGB;5119000;Oberhausen;X;22;0;0;0;2;0;2;0;0;0;3;5;0;2;2;4;3;3;1;4;17
640000;Brandstiftung und Herbeiführen einer Brandgefahr §§ 306-306d, 306f StGB;6413000;Offenbach am Main;M;10;0;0;1;0;0;1;0;0;0;0;1;0;2;2;3;2;2;0;0;9
640000;Brandstiftung und Herbeiführen einer Brandgefahr §§ 306-306d, 306f StGB;6413000;Offenbach am Main;W;6;0;0;0;0;0;0;0;0;0;1;1;0;0;0;0;3;0;2;0;5
640000;Brandstiftung und Herbeiführen einer Brandgefahr §§ 306-306d, 306f StGB;6413000;Offenbach am Main;X;16;0;0;1;0;0;1;0;0;0;1;2;0;2;2;3;5;2;2;0;14
640000;Brandstiftung und Herbeiführen einer Brandgefahr §§ 306-306d, 306f StGB;3403000;Oldenburg (Oldenburg);M;16;0;1;0;0;0;1;3;0;3;2;6;1;0;1;1;4;1;1;2;10
640000;Brandstiftung und Herbeiführen einer Brandgefahr §§ 306-306d, 306f StGB;3403000;Oldenburg (Oldenburg);W;6;0;0;0;0;0;0;0;0;0;1;1;0;0;0;0;3;1;1;0;5
640000;Brandstiftung und Herbeiführen einer Brandgefahr §§ 306-306d, 306f StGB;3403000;Oldenburg (Oldenburg);X;22;0;1;0;0;0;1;3;0;3;3;7;1;0;1;1;7;2;2;2;15
640000;Brandstiftung und Herbeiführen einer Brandgefahr §§ 306-306d, 306f StGB;3404000;Osnabrück;M;18;0;0;0;0;0;0;2;0;2;0;2;1;0;1;4;3;3;4;1;16
640000;Brandstiftung und Herbeiführen einer Brandgefahr §§ 306-306d, 306f StGB;3404000;Osnabrück;W;3;0;0;0;0;0;0;0;0;0;0;0;0;0;0;2;0;0;1;0;3
640000;Brandstiftung und Herbeiführen einer Brandgefahr §§ 306-306d, 306f StGB;3404000;Osnabrück;X;21;0;0;0;0;0;0;2;0;2;0;2;1;0;1;6;3;3;5;1;19
640000;Brandstiftung und Herbeiführen einer Brandgefahr §§ 306-306d, 306f StGB;5774032;Paderborn;M;14;0;0;0;0;0;0;0;0;0;0;0;0;1;1;4;4;4;0;1;14
640000;Brandstiftung und Herbeiführen einer Brandgefahr §§ 306-306d, 306f StGB;5774032;Paderborn;W;6;0;0;0;0;0;0;0;0;0;1;1;1;0;1;2;1;0;0;1;5
640000;Brandstiftung und Herbeiführen einer Brandgefahr §§ 306-306d, 306f StGB;5774032;Paderborn;X;20;0;0;0;0;0;0;0;0;0;1;1;1;1;2;6;5;4;0;2;19
640000;Brandstiftung und Herbeiführen einer Brandgefahr §§ 306-306d, 306f StGB;8231000;Pforzheim;M;6;0;0;0;0;0;0;0;1;1;1;2;0;1;1;1;1;1;0;0;4
640000;Brandstiftung und Herbeiführen einer Brandgefahr §§ 306-306d, 306f StGB;8231000;Pforzheim;W;0;0;0;0;0;0;0;0;0;0;0;0;0;0;0;0;0;0;0;0;0
640000;Brandstiftung und Herbeiführen einer Brandgefahr §§ 306-306d, 306f StGB;8231000;Pforzheim;X;6;0;0;0;0;0;0;0;1;1;1;2;0;1;1;1;1;1;0;0;4
640000;Brandstiftung und Herbeiführen einer Brandgefahr §§ 306-306d, 306f StGB;12054000;Potsdam;M;15;0;0;0;1;1;2;1;3;4;1;7;1;1;2;1;2;1;1;1;8
640000;Brandstiftung und Herbeiführen einer Brandgefahr §§ 306-306d, 306f StGB;12054000;Potsdam;W;8;0;0;0;0;0;0;1;0;1;0;1;0;0;0;0;2;0;2;3;7
640000;Brandstiftung und Herbeiführen einer Brandgefahr §§ 306-306d, 306f StGB;12054000;Potsdam;X;23;0;0;0;1;1;2;2;3;5;1;8;1;1;2;1;4;1;3;4;15
640000;Brandstiftung und Herbeiführen einer Brandgefahr §§ 306-306d, 306f StGB;5562032;Recklinghausen;M;9;0;0;0;0;0;0;2;0;2;1;3;1;0;1;2;1;1;0;1;6
640000;Brandstiftung und Herbeiführen einer Brandgefahr §§ 306-306d, 306f StGB;5562032;Recklinghausen;W;3;0;0;0;0;0;0;1;0;1;0;1;0;0;0;0;1;1;0;0;2
640000;Brandstiftung und Herbeiführen einer Brandgefahr §§ 306-306d, 306f StGB;5562032;Recklinghausen;X;12;0;0;0;0;0;0;3;0;3;1;4;1;0;1;2;2;2;0;1;8
640000;Brandstiftung und Herbeiführen einer Brandgefahr §§ 306-306d, 306f StGB;9362000;Regensburg;M;8;0;0;0;0;0;0;0;0;0;0;0;0;0;0;3;0;1;3;1;8
640000;Brandstiftung und Herbeiführen einer Brandgefahr §§ 306-306d, 306f StGB;9362000;Regensburg;W;4;0;0;0;0;0;0;0;0;0;0;0;0;0;0;2;0;1;1;0;4
640000;Brandstiftung und Herbeiführen einer Brandgefahr §§ 306-306d, 306f StGB;9362000;Regensburg;X;12;0;0;0;0;0;0;0;0;0;0;0;0;0;0;5;0;2;4;1;12
640000;Brandstiftung und Herbeiführen einer Brandgefahr §§ 306-306d, 306f StGB;5120000;Remscheid;M;5;0;0;0;0;0;0;1;0;1;0;1;0;0;0;0;3;1;0;0;4
640000;Brandstiftung und Herbeiführen einer Brandgefahr §§ 306-306d, 306f StGB;5120000;Remscheid;W;2;0;0;0;0;0;0;0;0;0;0;0;1;0;1;0;0;0;0;1;2
640000;Brandstiftung und Herbeiführen einer Brandgefahr §§ 306-306d, 306f StGB;5120000;Remscheid;X;7;0;0;0;0;0;0;1;0;1;0;1;1;0;1;0;3;1;0;1;6
640000;Brandstiftung und Herbeiführen einer Brandgefahr §§ 306-306d, 306f StGB;8415061;Reutlingen;M;8;0;0;0;0;2;2;0;0;0;0;2;0;0;0;0;1;5;0;0;6
640000;Brandstiftung und Herbeiführen einer Brandgefahr §§ 306-306d, 306f StGB;8415061;Reutlingen;W;5;0;0;0;0;0;0;0;0;0;0;0;0;0;0;3;0;0;0;2;5
640000;Brandstiftung und Herbeiführen einer Brandgefahr §§ 306-306d, 306f StGB;8415061;Reutlingen;X;13;0;0;0;0;2;2;0;0;0;0;2;0;0;0;3;1;5;0;2;11
640000;Brandstiftung und Herbeiführen einer Brandgefahr §§ 306-306d, 306f StGB;13003000;Rostock;M;25;0;0;1;0;2;3;3;3;6;1;10;2;0;2;3;3;1;3;3;15
640000;Brandstiftung und Herbeiführen einer Brandgefahr §§ 306-306d, 306f StGB;13003000;Rostock;W;7;0;0;0;2;1;3;0;1;1;0;4;0;0;0;0;0;2;0;1;3
640000;Brandstiftung und Herbeiführen einer Brandgefahr §§ 306-306d, 306f StGB;13003000;Rostock;X;32;0;0;1;2;3;6;3;4;7;1;14;2;0;2;3;3;3;3;4;18
640000;Brandstiftung und Herbeiführen einer Brandgefahr §§ 306-306d, 306f StGB;10041100;Saarbrücken;M;19;0;0;1;0;0;1;2;0;2;2;5;0;0;0;3;4;3;4;0;14
640000;Brandstiftung und Herbeiführen einer Brandgefahr §§ 306-306d, 306f StGB;10041100;Saarbrücken;W;9;0;0;0;0;0;0;2;0;2;0;2;0;2;2;0;4;0;0;1;7
640000;Brandstiftung und Herbeiführen einer Brandgefahr §§ 306-306d, 306f StGB;10041100;Saarbrücken;X;28;0;0;1;0;0;1;4;0;4;2;7;0;2;2;3;8;3;4;1;21
640000;Brandstiftung und Herbeiführen einer Brandgefahr §§ 306-306d, 306f StGB;5122000;Solingen;M;6;0;0;0;0;0;0;0;0;0;1;1;0;0;0;0;0;0;4;1;5
640000;Brandstiftung und Herbeiführen einer Brandgefahr §§ 306-306d, 306f StGB;5122000;Solingen;W;1;0;0;0;0;0;0;0;0;0;0;0;0;1;1;0;0;0;0;0;1
640000;Brandstiftung und Herbeiführen einer Brandgefahr §§ 306-306d, 306f StGB;5122000;Solingen;X;7;0;0;0;0;0;0;0;0;0;1;1;0;1;1;0;0;0;4;1;6
640000;Brandstiftung und Herbeiführen einer Brandgefahr §§ 306-306d, 306f StGB;8111000;Stuttgart;M;59;0;1;0;6;1;8;0;2;2;3;13;1;2;3;3;16;6;11;7;46
640000;Brandstiftung und Herbeiführen einer Brandgefahr §§ 306-306d, 306f StGB;8111000;Stuttgart;W;18;1;0;0;0;0;1;0;0;0;1;2;1;3;4;1;1;2;2;6;16
640000;Brandstiftung und Herbeiführen einer Brandgefahr §§ 306-306d, 306f StGB;8111000;Stuttgart;X;77;1;1;0;6;1;9;0;2;2;4;15;2;5;7;4;17;8;13;13;62
640000;Brandstiftung und Herbeiführen einer Brandgefahr §§ 306-306d, 306f StGB;7211000;Trier;M;9;0;0;0;0;0;0;0;1;1;1;2;2;0;2;0;1;0;3;1;7
640000;Brandstiftung und Herbeiführen einer Brandgefahr §§ 306-306d, 306f StGB;7211000;Trier;W;1;0;0;0;0;0;0;0;1;1;0;1;0;0;0;0;0;0;0;0;0
640000;Brandstiftung und Herbeiführen einer Brandgefahr §§ 306-306d, 306f StGB;7211000;Trier;X;10;0;0;0;0;0;0;0;2;2;1;3;2;0;2;0;1;0;3;1;7
640000;Brandstiftung und Herbeiführen einer Brandgefahr §§ 306-306d, 306f StGB;8421000;Ulm;M;10;0;0;0;1;3;4;0;1;1;0;5;0;0;0;0;2;2;1;0;5
640000;Brandstiftung und Herbeiführen einer Brandgefahr §§ 306-306d, 306f StGB;8421000;Ulm;W;1;0;0;0;0;0;0;0;0;0;0;0;0;0;0;0;0;0;0;1;1
640000;Brandstiftung und Herbeiführen einer Brandgefahr §§ 306-306d, 306f StGB;8421000;Ulm;X;11;0;0;0;1;3;4;0;1;1;0;5;0;0;0;0;2;2;1;1;6
640000;Brandstiftung und Herbeiführen einer Brandgefahr §§ 306-306d, 306f StGB;6414000;Wiesbaden;M;20;0;0;2;0;0;2;1;0;1;1;4;2;3;5;1;2;4;3;1;16
640000;Brandstiftung und Herbeiführen einer Brandgefahr §§ 306-306d, 306f StGB;6414000;Wiesbaden;W;3;0;0;0;0;0;0;0;1;1;0;1;0;0;0;0;1;1;0;0;2
640000;Brandstiftung und Herbeiführen einer Brandgefahr §§ 306-306d, 306f StGB;6414000;Wiesbaden;X;23;0;0;2;0;0;2;1;1;2;1;5;2;3;5;1;3;5;3;1;18
640000;Brandstiftung und Herbeiführen einer Brandgefahr §§ 306-306d, 306f StGB;3103000;Wolfsburg;M;8;0;0;0;0;1;1;1;1;2;1;4;1;0;1;0;0;1;1;1;4
640000;Brandstiftung und Herbeiführen einer Brandgefahr §§ 306-306d, 306f StGB;3103000;Wolfsburg;W;2;0;0;0;0;0;0;0;0;0;0;0;0;0;0;1;0;0;0;1;2
640000;Brandstiftung und Herbeiführen einer Brandgefahr §§ 306-306d, 306f StGB;3103000;Wolfsburg;X;10;0;0;0;0;1;1;1;1;2;1;4;1;0;1;1;0;1;1;2;6
640000;Brandstiftung und Herbeiführen einer Brandgefahr §§ 306-306d, 306f StGB;5124000;Wuppertal;M;18;0;0;0;1;3;4;1;1;2;2;8;0;1;1;2;0;3;3;1;10
640000;Brandstiftung und Herbeiführen einer Brandgefahr §§ 306-306d, 306f StGB;5124000;Wuppertal;W;8;0;0;0;0;0;0;0;2;2;0;2;0;0;0;0;1;0;5;0;6
640000;Brandstiftung und Herbeiführen einer Brandgefahr §§ 306-306d, 306f StGB;5124000;Wuppertal;X;26;0;0;0;1;3;4;1;3;4;2;10;0;1;1;2;1;3;8;1;16
640000;Brandstiftung und Herbeiführen einer Brandgefahr §§ 306-306d, 306f StGB;9663000;Würzburg;M;2;0;0;0;0;0;0;0;0;0;0;0;0;0;0;0;1;0;0;1;2
640000;Brandstiftung und Herbeiführen einer Brandgefahr §§ 306-306d, 306f StGB;9663000;Würzburg;W;1;0;0;0;0;0;0;0;0;0;0;0;0;0;0;1;0;0;0;0;1
640000;Brandstiftung und Herbeiführen einer Brandgefahr §§ 306-306d, 306f StGB;9663000;Würzburg;X;3;0;0;0;0;0;0;0;0;0;0;0;0;0;0;1;1;0;0;1;3
674000;Sachbeschädigung §§ 303-305a StGB;5334002;Aachen;M;397;0;1;2;4;11;18;33;46;79;46;143;45;16;61;50;63;46;18;16;254
674000;Sachbeschädigung §§ 303-305a StGB;5334002;Aachen;W;62;0;0;0;0;1;1;5;4;9;5;15;4;3;7;9;6;12;6;7;47
674000;Sachbeschädigung §§ 303-305a StGB;5334002;Aachen;X;459;0;1;2;4;12;19;38;50;88;51;158;49;19;68;59;69;58;24;23;301
674000;Sachbeschädigung §§ 303-305a StGB;9761000;Augsburg;M;394;0;0;10;6;8;24;26;30;56;42;122;18;35;53;60;72;49;22;16;272
674000;Sachbeschädigung §§ 303-305a StGB;9761000;Augsburg;W;68;0;1;1;1;0;3;6;3;9;5;17;4;4;8;5;9;12;9;8;51
674000;Sachbeschädigung §§ 303-305a StGB;9761000;Augsburg;X;462;0;1;11;7;8;27;32;33;65;47;139;22;39;61;65;81;61;31;24;323
674000;Sachbeschädigung §§ 303-305a StGB;5378004;Bergisch Gladbach;M;134;0;1;4;2;3;10;7;16;23;25;58;8;9;17;10;14;17;12;6;76
674000;Sachbeschädigung §§ 303-305a StGB;5378004;Bergisch Gladbach;W;27;0;0;0;0;0;0;0;1;1;2;3;2;0;2;2;6;5;5;4;24
674000;Sachbeschädigung §§ 303-305a StGB;5378004;Bergisch Gladbach;X;161;0;1;4;2;3;10;7;17;24;27;61;10;9;19;12;20;22;17;10;100
674000;Sachbeschädigung §§ 303-305a StGB;11000000;Berlin;M;6701;5;42;67;113;220;447;339;484;823;677;1947;400;475;875;977;1367;795;452;288;4754
674000;Sachbeschädigung §§ 303-305a StGB;11000000;Berlin;W;1181;1;6;13;21;48;89;82;54;136;75;300;57;69;126;148;231;182;110;84;881
674000;Sachbeschädigung §§ 303-305a StGB;11000000;Berlin;X;7882;6;48;80;134;268;536;421;538;959;752;2247;457;544;1001;1125;1598;977;562;372;5635
674000;Sachbeschädigung §§ 303-305a StGB;5711000;Bielefeld;M;482;2;0;2;1;11;16;19;33;52;61;129;46;36;82;69;103;54;29;16;353
674000;Sachbeschädigung §§ 303-305a StGB;5711000;Bielefeld;W;86;0;0;0;0;2;2;13;6;19;3;24;4;2;6;9;14;21;9;3;62
674000;Sachbeschädigung §§ 303-305a StGB;5711000;Bielefeld;X;568;2;0;2;1;13;18;32;39;71;64;153;50;38;88;78;117;75;38;19;415
674000;Sachbeschädigung §§ 303-305a StGB;5911000;Bochum;M;728;1;3;9;12;29;54;27;45;72;100;226;56;58;114;95;131;87;48;27;502
674000;Sachbeschädigung §§ 303-305a StGB;5911000;Bochum;W;129;0;0;1;0;7;8;5;2;7;11;26;5;9;14;10;28;29;12;10;103
674000;Sachbeschädigung §§ 303-305a StGB;5911000;Bochum;X;857;1;3;10;12;36;62;32;47;79;111;252;61;67;128;105;159;116;60;37;605
674000;Sachbeschädigung §§ 303-305a StGB;5314000;Bonn;M;455;0;2;5;11;14;32;38;59;97;43;172;29;36;65;60;62;42;34;20;283
674000;Sachbeschädigung §§ 303-305a StGB;5314000;Bonn;W;84;0;0;0;1;1;2;5;15;20;2;24;2;1;3;8;12;10;16;11;60
674000;Sachbeschädigung §§ 303-305a StGB;5314000;Bonn;X;539;0;2;5;12;15;34;43;74;117;45;196;31;37;68;68;74;52;50;31;343
674000;Sachbeschädigung §§ 303-305a StGB;5512000;Bottrop;M;144;0;1;0;3;6;10;18;15;33;14;57;11;10;21;16;23;11;7;9;87
674000;Sachbeschädigung §§ 303-305a StGB;5512000;Bottrop;W;29;0;0;0;0;0;0;1;0;1;6;7;2;2;4;6;6;4;1;1;22
674000;Sachbeschädigung §§ 303-305a StGB;5512000;Bottrop;X;173;0;1;0;3;6;10;19;15;34;20;64;13;12;25;22;29;15;8;10;109
674000;Sachbeschädigung §§ 303-305a StGB;3101000;Braunschweig;M;488;1;0;7;6;13;27;36;48;84;73;184;42;36;78;58;81;51;22;14;304
674000;Sachbeschädigung §§ 303-305a StGB;3101000;Braunschweig;W;63;0;0;1;1;2;4;2;1;3;13;20;3;2;5;10;11;8;3;6;43
674000;Sachbeschädigung §§ 303-305a StGB;3101000;Braunschweig;X;551;1;0;8;7;15;31;38;49;87;86;204;45;38;83;68;92;59;25;20;347
674000;Sachbeschädigung §§ 303-305a StGB;4011000;Bremen;M;835;1;3;0;13;23;40;43;76;119;108;267;67;59;126;115;156;99;38;34;568
674000;Sachbeschädigung §§ 303-305a StGB;4011000;Bremen;W;130;0;1;1;1;6;9;7;6;13;13;35;8;7;15;18;24;21;10;7;95
674000;Sachbeschädigung §§ 303-305a StGB;4011000;Bremen;X;965;1;4;1;14;29;49;50;82;132;121;302;75;66;141;133;180;120;48;41;663
674000;Sachbeschädigung §§ 303-305a StGB;4012000;Bremerhaven;M;215;4;1;2;5;7;19;12;14;26;25;70;11;9;20;39;39;27;13;7;145
674000;Sachbeschädigung §§ 303-305a StGB;4012000;Bremerhaven;W;42;0;0;0;3;4;7;3;3;6;6;19;2;0;2;4;8;8;1;0;23
674000;Sachbeschädigung §§ 303-305a StGB;4012000;Bremerhaven;X;257;4;1;2;8;11;26;15;17;32;31;89;13;9;22;43;47;35;14;7;168
674000;Sachbeschädigung §§ 303-305a StGB;14511000;Chemnitz;M;422;2;0;5;4;17;28;26;29;55;36;119;28;30;58;97;78;37;20;13;303
674000;Sachbeschädigung §§ 303-305a StGB;14511000;Chemnitz;W;84;0;0;1;3;2;6;6;9;15;5;26;5;3;8;7;23;10;7;3;58
674000;Sachbeschädigung §§ 303-305a StGB;14511000;Chemnitz;X;506;2;0;6;7;19;34;32;38;70;41;145;33;33;66;104;101;47;27;16;361
674000;Sachbeschädigung §§ 303-305a StGB;6411000;Darmstadt;M;152;0;0;0;0;1;1;9;23;32;21;54;13;12;25;21;24;16;8;4;98
674000;Sachbeschädigung §§ 303-305a StGB;6411000;Darmstadt;W;29;0;0;1;0;2;3;1;2;3;2;8;2;2;4;3;3;7;3;1;21
674000;Sachbeschädigung §§ 303-305a StGB;6411000;Darmstadt;X;181;0;0;1;0;3;4;10;25;35;23;62;15;14;29;24;27;23;11;5;119
674000;Sachbeschädigung §§ 303-305a StGB;5913000;Dortmund;M;1136;1;3;11;13;33;61;52;101;153;156;370;91;75;166;165;193;143;58;41;766
674000;Sachbeschädigung §§ 303-305a StGB;5913000;Dortmund;W;201;0;0;1;2;7;10;12;14;26;19;55;14;7;21;15;45;43;9;13;146
674000;Sachbeschädigung §§ 303-305a StGB;5913000;Dortmund;X;1337;1;3;12;15;40;71;64;115;179;175;425;105;82;187;180;238;186;67;54;912
674000;Sachbeschädigung §§ 303-305a StGB;14612000;Dresden;M;888;3;1;7;7;20;38;65;72;137;80;255;68;69;137;171;174;68;48;35;633
674000;Sachbeschädigung §§ 303-305a StGB;14612000;Dresden;W;163;0;0;5;3;11;19;35;12;47;8;74;6;9;15;21;24;14;6;9;89
674000;Sachbeschädigung §§ 303-305a StGB;14612000;Dresden;X;1051;3;1;12;10;31;57;100;84;184;88;329;74;78;152;192;198;82;54;44;722
674000;Sachbeschädigung §§ 303-305a StGB;5112000;Duisburg;M;849;1;7;14;15;25;62;59;66;125;93;280;52;76;128;99;158;114;43;27;569
674000;Sachbeschädigung §§ 303-305a StGB;5112000;Duisburg;W;193;0;0;1;3;10;14;14;11;25;13;52;14;13;27;17;31;32;20;14;141
674000;Sachbeschädigung §§ 303-305a StGB;5112000;Duisburg;X;1042;1;7;15;18;35;76;73;77;150;106;332;66;89;155;116;189;146;63;41;710
674000;Sachbeschädigung §§ 303-305a StGB;5111000;Düsseldorf;M;880;1;2;8;20;36;67;56;71;127;125;319;61;57;118;109;137;110;60;27;561
674000;Sachbeschädigung §§ 303-305a StGB;5111000;Düsseldorf;W;140;0;3;2;2;3;10;9;10;19;13;42;7;5;12;15;23;22;16;10;98
674000;Sachbeschädigung §§ 303-305a StGB;5111000;Düsseldorf;X;1020;1;5;10;22;39;77;65;81;146;138;361;68;62;130;124;160;132;76;37;659
674000;Sachbeschädigung §§ 303-305a StGB;16051000;Erfurt;M;455;1;4;6;9;10;30;35;45;80;45;155;29;38;67;75;85;43;8;22;300
674000;Sachbeschädigung §§ 303-305a StGB;16051000;Erfurt;W;79;0;0;1;4;10;15;6;4;10;6;31;2;2;4;8;22;8;3;3;48
674000;Sachbeschädigung §§ 303-305a StGB;16051000;Erfurt;X;534;1;4;7;13;20;45;41;49;90;51;186;31;40;71;83;107;51;11;25;348
674000;Sachbeschädigung §§ 303-305a StGB;9562000;Erlangen;M;192;0;4;3;1;6;14;16;28;44;29;87;19;10;29;26;19;14;9;8;105
674000;Sachbeschädigung §§ 303-305a StGB;9562000;Erlangen;W;25;0;0;0;0;0;0;4;2;6;1;7;2;1;3;2;4;4;0;5;18
674000;Sachbeschädigung §§ 303-305a StGB;9562000;Erlangen;X;217;0;4;3;1;6;14;20;30;50;30;94;21;11;32;28;23;18;9;13;123
674000;Sachbeschädigung §§ 303-305a StGB;5113000;Essen;M;686;0;0;2;11;23;36;50;67;117;88;241;53;45;98;85;103;88;38;33;445
674000;Sachbeschädigung §§ 303-305a StGB;5113000;Essen;W;115;2;0;0;0;4;6;8;3;11;8;25;7;5;12;13;20;20;8;17;90
674000;Sachbeschädigung §§ 303-305a StGB;5113000;Essen;X;801;2;0;2;11;27;42;58;70;128;96;266;60;50;110;98;123;108;46;50;535
674000;Sachbeschädigung §§ 303-305a StGB;6412000;Frankfurt am Main;M;934;2;3;4;10;35;54;44;53;97;115;266;68;60;128;120;188;120;65;47;668
674000;Sachbeschädigung §§ 303-305a StGB;6412000;Frankfurt am Main;W;126;0;0;1;0;6;7;3;6;9;12;28;5;5;10;16;30;20;8;14;98
674000;Sachbeschädigung §§ 303-305a StGB;6412000;Frankfurt am Main;X;1060;2;3;5;10;41;61;47;59;106;127;294;73;65;138;136;218;140;73;61;766
674000;Sachbeschädigung §§ 303-305a StGB;8311000;Freiburg im Breisgau;M;357;0;2;6;3;9;20;32;59;91;55;166;29;26;55;40;37;30;12;17;191
674000;Sachbeschädigung §§ 303-305a StGB;8311000;Freiburg im Breisgau;W;56;0;0;0;1;0;1;3;4;7;3;11;2;9;11;6;7;9;7;5;45
674000;Sachbeschädigung §§ 303-305a StGB;8311000;Freiburg im Breisgau;X;413;0;2;6;4;9;21;35;63;98;58;177;31;35;66;46;44;39;19;22;236
674000;Sachbeschädigung §§ 303-305a StGB;9563000;Fürth;M;155;0;0;5;3;11;19;11;11;22;26;67;12;6;18;16;21;14;13;6;88
674000;Sachbeschädigung §§ 303-305a StGB;9563000;Fürth;W;33;0;0;0;1;2;3;1;1;2;4;9;2;2;4;4;4;5;5;2;24
674000;Sachbeschädigung §§ 303-305a StGB;9563000;Fürth;X;188;0;0;5;4;13;22;12;12;24;30;76;14;8;22;20;25;19;18;8;112
674000;Sachbeschädigung §§ 303-305a StGB;5513000;Gelsenkirchen;M;378;0;1;6;5;17;29;29;26;55;60;144;20;33;53;52;56;33;25;15;234
674000;Sachbeschädigung §§ 303-305a StGB;5513000;Gelsenkirchen;W;69;0;0;0;1;6;7;3;6;9;13;29;3;4;7;8;8;7;6;4;40
674000;Sachbeschädigung §§ 303-305a StGB;5513000;Gelsenkirchen;X;447;0;1;6;6;23;36;32;32;64;73;173;23;37;60;60;64;40;31;19;274
674000;Sachbeschädigung §§ 303-305a StGB;3152012;Göttingen;M;165;0;1;1;3;5;10;6;6;12;17;39;15;12;27;22;29;19;16;13;126
674000;Sachbeschädigung §§ 303-305a StGB;3152012;Göttingen;W;41;0;0;0;0;0;0;4;0;4;4;8;2;2;4;3;4;8;10;4;33
674000;Sachbeschädigung §§ 303-305a StGB;3152012;Göttingen;X;206;0;1;1;3;5;10;10;6;16;21;47;17;14;31;25;33;27;26;17;159
674000;Sachbeschädigung §§ 303-305a StGB;5914000;Hagen;M;297;0;5;6;3;12;26;7;25;32;42;100;32;17;49;27;52;38;19;12;197
674000;Sachbeschädigung §§ 303-305a StGB;5914000;Hagen;W;51;1;0;0;3;1;5;4;2;6;5;16;6;4;10;1;6;9;3;6;35
674000;Sachbeschädigung §§ 303-305a StGB;5914000;Hagen;X;348;1;5;6;6;13;31;11;27;38;47;116;38;21;59;28;58;47;22;18;232
674000;Sachbeschädigung §§ 303-305a StGB;15002000;Halle (Saale);M;544;1;2;7;11;24;45;27;41;68;54;167;42;37;79;96;108;59;21;14;377
674000;Sachbeschädigung §§ 303-305a StGB;15002000;Halle (Saale);W;68;1;2;0;0;6;9;5;2;7;6;22;8;5;13;11;11;7;1;3;46
674000;Sachbeschädigung §§ 303-305a StGB;15002000;Halle (Saale);X;612;2;4;7;11;30;54;32;43;75;60;189;50;42;92;107;119;66;22;17;423
674000;Sachbeschädigung §§ 303-305a StGB;2000000;Hamburg;M;3148;3;11;32;47;123;216;201;267;468;373;1057;235;177;412;413;585;405;175;101;2091
674000;Sachbeschädigung §§ 303-305a StGB;2000000;Hamburg;W;505;1;4;7;11;25;48;34;25;59;34;141;17;33;50;58;96;85;38;37;364
674000;Sachbeschädigung §§ 303-305a StGB;2000000;Hamburg;X;3653;4;15;39;58;148;264;235;292;527;407;1198;252;210;462;471;681;490;213;138;2455
674000;Sachbeschädigung §§ 303-305a StGB;5915000;Hamm;M;239;0;3;1;2;3;9;10;11;21;32;62;26;19;45;33;48;31;12;8;177
674000;Sachbeschädigung §§ 303-305a StGB;5915000;Hamm;W;41;0;0;0;0;1;1;4;3;7;6;14;3;2;5;1;5;13;3;0;27
674000;Sachbeschädigung §§ 303-305a StGB;5915000;Hamm;X;280;0;3;1;2;4;10;14;14;28;38;76;29;21;50;34;53;44;15;8;204
674000;Sachbeschädigung §§ 303-305a StGB;3241001;Hannover;M;1326;1;7;10;17;34;69;69;93;162;197;428;105;88;193;174;245;150;91;45;898
674000;Sachbeschädigung §§ 303-305a StGB;3241001;Hannover;W;219;0;0;0;2;5;7;11;16;27;18;52;9;14;23;22;47;39;22;14;167
674000;Sachbeschädigung §§ 303-305a StGB;3241001;Hannover;X;1545;1;7;10;19;39;76;80;109;189;215;480;114;102;216;196;292;189;113;59;1065
674000;Sachbeschädigung §§ 303-305a StGB;8221000;Heidelberg;M;200;0;2;0;8;7;17;11;27;38;31;86;15;9;24;16;38;15;9;12;114
674000;Sachbeschädigung §§ 303-305a StGB;8221000;Heidelberg;W;29;0;0;0;0;0;0;1;4;5;1;6;4;1;5;2;5;4;1;6;23
674000;Sachbeschädigung §§ 303-305a StGB;8221000;Heidelberg;X;229;0;2;0;8;7;17;12;31;43;32;92;19;10;29;18;43;19;10;18;137
674000;Sachbeschädigung §§ 303-305a StGB;8121000;Heilbronn;M;147;0;2;0;5;8;15;11;12;23;20;58;11;10;21;23;19;16;6;4;89
674000;Sachbeschädigung §§ 303-305a StGB;8121000;Heilbronn;W;23;1;2;0;0;1;4;4;0;4;1;9;3;0;3;1;3;3;2;2;14
674000;Sachbeschädigung §§ 303-305a StGB;8121000;Heilbronn;X;170;1;4;0;5;9;19;15;12;27;21;67;14;10;24;24;22;19;8;6;103
674000;Sachbeschädigung §§ 303-305a StGB;5916000;Herne;M;307;0;1;1;2;9;13;28;34;62;32;107;19;13;32;43;61;37;19;8;200
674000;Sachbeschädigung §§ 303-305a StGB;5916000;Herne;W;61;0;0;0;3;2;5;1;5;6;5;16;5;2;7;9;5;20;3;1;45
674000;Sachbeschädigung §§ 303-305a StGB;5916000;Herne;X;368;0;1;1;5;11;18;29;39;68;37;123;24;15;39;52;66;57;22;9;245
674000;Sachbeschädigung §§ 303-305a StGB;9161000;Ingolstadt;M;195;0;1;0;2;3;6;14;23;37;23;66;16;10;26;24;26;36;7;10;129
674000;Sachbeschädigung §§ 303-305a StGB;9161000;Ingolstadt;W;31;0;0;0;0;0;0;1;1;2;0;2;2;1;3;4;9;9;3;1;29
674000;Sachbeschädigung §§ 303-305a StGB;9161000;Ingolstadt;X;226;0;1;0;2;3;6;15;24;39;23;68;18;11;29;28;35;45;10;11;158
674000;Sachbeschädigung §§ 303-305a StGB;16053000;Jena;M;175;0;1;0;2;5;8;3;18;21;23;52;16;22;38;29;29;11;10;6;123
674000;Sachbeschädigung §§ 303-305a StGB;16053000;Jena;W;20;0;0;0;0;0;0;1;2;3;2;5;1;2;3;4;5;1;1;1;15
674000;Sachbeschädigung §§ 303-305a StGB;16053000;Jena;X;195;0;1;0;2;5;8;4;20;24;25;57;17;24;41;33;34;12;11;7;138
674000;Sachbeschädigung §§ 303-305a StGB;8212000;Karlsruhe;M;358;0;0;5;7;11;23;20;32;52;69;144;24;19;43;49;60;32;17;13;214
674000;Sachbeschädigung §§ 303-305a StGB;8212000;Karlsruhe;W;35;0;0;2;0;0;2;1;2;3;2;7;0;3;3;2;8;4;4;7;28
674000;Sachbeschädigung §§ 303-305a StGB;8212000;Karlsruhe;X;393;0;0;7;7;11;25;21;34;55;71;151;24;22;46;51;68;36;21;20;242
674000;Sachbeschädigung §§ 303-305a StGB;6611000;Kassel;M;248;0;2;1;4;7;14;16;22;38;24;76;26;24;50;32;41;27;15;7;172
674000;Sachbeschädigung §§ 303-305a StGB;6611000;Kassel;W;37;0;1;0;0;1;2;1;3;4;5;11;4;3;7;8;2;5;3;1;26
674000;Sachbeschädigung §§ 303-305a StGB;6611000;Kassel;X;285;0;3;1;4;8;16;17;25;42;29;87;30;27;57;40;43;32;18;8;198
674000;Sachbeschädigung §§ 303-305a StGB;1002000;Kiel;M;435;0;2;6;13;7;28;19;43;62;54;144;52;28;80;54;57;65;25;10;291
674000;Sachbeschädigung §§ 303-305a StGB;1002000;Kiel;W;68;0;0;0;1;1;2;6;5;11;5;18;5;7;12;10;12;9;4;3;50
674000;Sachbeschädigung §§ 303-305a StGB;1002000;Kiel;X;503;0;2;6;14;8;30;25;48;73;59;162;57;35;92;64;69;74;29;13;341
674000;Sachbeschädigung §§ 303-305a StGB;7111000;Koblenz;M;235;0;1;3;2;5;11;15;18;33;34;78;28;14;42;31;29;25;17;13;157
674000;Sachbeschädigung §§ 303-305a StGB;7111000;Koblenz;W;33;0;0;1;4;1;6;0;0;0;2;8;2;0;2;0;9;9;2;3;25
674000;Sachbeschädigung §§ 303-305a StGB;7111000;Koblenz;X;268;0;1;4;6;6;17;15;18;33;36;86;30;14;44;31;38;34;19;16;182
674000;Sachbeschädigung §§ 303-305a StGB;5315000;Köln;M;1810;0;4;7;12;32;55;107;175;282;217;554;155;98;253;278;325;212;117;71;1256
674000;Sachbeschädigung §§ 303-305a StGB;5315000;Köln;W;332;0;0;0;2;5;7;13;21;34;28;69;13;15;28;50;63;63;32;27;263
674000;Sachbeschädigung §§ 303-305a StGB;5315000;Köln;X;2142;0;4;7;14;37;62;120;196;316;245;623;168;113;281;328;388;275;149;98;1519
674000;Sachbeschädigung §§ 303-305a StGB;5114000;Krefeld;M;452;1;3;4;11;21;40;34;39;73;43;156;29;38;67;54;78;50;32;15;296
674000;Sachbeschädigung §§ 303-305a StGB;5114000;Krefeld;W;96;1;1;1;0;4;7;6;5;11;8;26;5;5;10;14;19;12;10;5;70
674000;Sachbeschädigung §§ 303-305a StGB;5114000;Krefeld;X;548;2;4;5;11;25;47;40;44;84;51;182;34;43;77;68;97;62;42;20;366
674000;Sachbeschädigung §§ 303-305a StGB;14713000;Leipzig;M;1238;0;5;10;21;47;83;64;119;183;143;409;98;98;196;215;241;83;62;32;829
674000;Sachbeschädigung §§ 303-305a StGB;14713000;Leipzig;W;186;0;0;2;1;16;19;20;17;37;8;64;6;10;16;26;35;24;12;9;122
674000;Sachbeschädigung §§ 303-305a StGB;14713000;Leipzig;X;1424;0;5;12;22;63;102;84;136;220;151;473;104;108;212;241;276;107;74;41;951
674000;Sachbeschädigung §§ 303-305a StGB;5316000;Leverkusen;M;244;0;2;4;5;13;24;15;24;39;27;90;20;6;26;21;51;31;15;10;154
674000;Sachbeschädigung §§ 303-305a StGB;5316000;Leverkusen;W;47;0;0;0;0;0;0;4;4;8;8;16;1;2;3;4;9;7;7;1;31
674000;Sachbeschädigung §§ 303-305a StGB;5316000;Leverkusen;X;291;0;2;4;5;13;24;19;28;47;35;106;21;8;29;25;60;38;22;11;185
674000;Sachbeschädigung §§ 303-305a StGB;1003000;Lübeck;M;441;0;3;1;3;18;25;32;29;61;54;140;22;31;53;66;90;42;25;25;301
674000;Sachbeschädigung §§ 303-305a StGB;1003000;Lübeck;W;79;1;0;0;5;7;13;6;0;6;8;27;2;5;7;8;18;7;7;5;52
674000;Sachbeschädigung §§ 303-305a StGB;1003000;Lübeck;X;520;1;3;1;8;25;38;38;29;67;62;167;24;36;60;74;108;49;32;30;353
674000;Sachbeschädigung §§ 303-305a StGB;7314000;Ludwigshafen am Rhein;M;326;0;2;9;6;8;25;9;19;28;35;88;21;22;43;49;71;45;17;13;238
674000;Sachbeschädigung §§ 303-305a StGB;7314000;Ludwigshafen am Rhein;W;66;0;0;1;2;1;4;2;6;8;7;19;8;4;12;9;7;11;4;4;47
674000;Sachbeschädigung §§ 303-305a StGB;7314000;Ludwigshafen am Rhein;X;392;0;2;10;8;9;29;11;25;36;42;107;29;26;55;58;78;56;21;17;285
674000;Sachbeschädigung §§ 303-305a StGB;15003000;Magdeburg;M;604;1;2;10;6;23;42;43;50;93;86;221;48;37;85;93;97;49;33;26;383
674000;Sachbeschädigung §§ 303-305a StGB;15003000;Magdeburg;W;109;0;1;1;1;7;10;14;10;24;11;45;9;8;17;13;12;11;5;6;64
674000;Sachbeschädigung §§ 303-305a StGB;15003000;Magdeburg;X;713;1;3;11;7;30;52;57;60;117;97;266;57;45;102;106;109;60;38;32;447
674000;Sachbeschädigung §§ 303-305a StGB;7315000;Mainz;M;341;0;0;4;1;5;10;18;35;53;43;106;40;36;76;52;51;24;21;11;235
674000;Sachbeschädigung §§ 303-305a StGB;7315000;Mainz;W;59;0;0;0;5;4;9;3;2;5;4;18;2;4;6;5;11;9;7;3;41
674000;Sachbeschädigung §§ 303-305a StGB;7315000;Mainz;X;400;0;0;4;6;9;19;21;37;58;47;124;42;40;82;57;62;33;28;14;276
674000;Sachbeschädigung §§ 303-305a StGB;8222000;Mannheim;M;422;0;4;1;8;14;27;28;28;56;37;120;38;25;63;65;65;64;31;14;302
674000;Sachbeschädigung §§ 303-305a StGB;8222000;Mannheim;W;66;0;0;1;2;3;6;3;6;9;4;19;4;6;10;10;6;12;6;3;47
674000;Sachbeschädigung §§ 303-305a StGB;8222000;Mannheim;X;488;0;4;2;10;17;33;31;34;65;41;139;42;31;73;75;71;76;37;17;349
674000;Sachbeschädigung §§ 303-305a StGB;5170024;Moers;M;153;0;1;1;5;9;16;7;8;15;16;47;11;6;17;27;18;21;17;6;106
674000;Sachbeschädigung §§ 303-305a StGB;5170024;Moers;W;30;0;0;0;0;1;1;0;1;1;3;5;1;1;2;3;5;7;4;4;25
674000;Sachbeschädigung §§ 303-305a StGB;5170024;Moers;X;183;0;1;1;5;10;17;7;9;16;19;52;12;7;19;30;23;28;21;10;131
674000;Sachbeschädigung §§ 303-305a StGB;5116000;Mönchengladbach;M;450;1;3;4;5;16;29;26;33;59;53;141;35;30;65;64;86;47;33;14;309
674000;Sachbeschädigung §§ 303-305a StGB;5116000;Mönchengladbach;W;72;0;0;0;1;2;3;4;3;7;8;18;3;3;6;11;16;13;5;3;54
674000;Sachbeschädigung §§ 303-305a StGB;5116000;Mönchengladbach;X;522;1;3;4;6;18;32;30;36;66;61;159;38;33;71;75;102;60;38;17;363
674000;Sachbeschädigung §§ 303-305a StGB;5117000;Mülheim an der Ruhr;M;166;0;1;1;4;13;19;8;19;27;9;55;15;17;32;16;25;18;11;9;111
674000;Sachbeschädigung §§ 303-305a StGB;5117000;Mülheim an der Ruhr;W;26;0;0;1;0;3;4;1;3;4;3;11;0;0;0;2;5;4;4;0;15
674000;Sachbeschädigung §§ 303-305a StGB;5117000;Mülheim an der Ruhr;X;192;0;1;2;4;16;23;9;22;31;12;66;15;17;32;18;30;22;15;9;126
674000;Sachbeschädigung §§ 303-305a StGB;9162000;München;M;1533;1;10;4;15;58;88;96;152;248;190;526;121;103;224;181;251;177;89;85;1007
674000;Sachbeschädigung §§ 303-305a StGB;9162000;München;W;223;0;0;3;1;13;17;19;10;29;20;66;13;3;16;24;38;34;23;22;157
674000;Sachbeschädigung §§ 303-305a StGB;9162000;München;X;1756;1;10;7;16;71;105;115;162;277;210;592;134;106;240;205;289;211;112;107;1164
674000;Sachbeschädigung §§ 303-305a StGB;5515000;Münster;M;407;1;1;4;6;17;29;29;36;65;49;143;34;35;69;46;51;58;24;16;264
674000;Sachbeschädigung §§ 303-305a StGB;5515000;Münster;W;51;0;0;1;0;2;3;8;5;13;5;21;1;4;5;3;4;8;8;2;30
674000;Sachbeschädigung §§ 303-305a StGB;5515000;Münster;X;458;1;1;5;6;19;32;37;41;78;54;164;35;39;74;49;55;66;32;18;294
674000;Sachbeschädigung §§ 303-305a StGB;5162024;Neuss;M;209;0;0;2;5;8;15;14;25;39;27;81;18;8;26;32;25;24;13;8;128
674000;Sachbeschädigung §§ 303-305a StGB;5162024;Neuss;W;32;0;0;0;0;3;3;0;6;6;1;10;0;0;0;3;7;8;2;2;22
674000;Sachbeschädigung §§ 303-305a StGB;5162024;Neuss;X;241;0;0;2;5;11;18;14;31;45;28;91;18;8;26;35;32;32;15;10;150
674000;Sachbeschädigung §§ 303-305a StGB;9564000;Nürnberg;M;812;0;3;3;8;21;35;32;67;99;104;238;61;60;121;110;158;109;37;39;574
674000;Sachbeschädigung §§ 303-305a StGB;9564000;Nürnberg;W;142;0;0;2;1;0;3;9;8;17;18;38;8;4;12;18;24;32;9;9;104
674000;Sachbeschädigung §§ 303-305a StGB;9564000;Nürnberg;X;954;0;3;5;9;21;38;41;75;116;122;276;69;64;133;128;182;141;46;48;678
674000;Sachbeschädigung §§ 303-305a StGB;5119000;Oberhausen;M;385;0;1;5;7;16;29;33;30;63;41;133;25;29;54;52;72;43;19;12;252
674000;Sachbeschädigung §§ 303-305a StGB;5119000;Oberhausen;W;72;0;0;0;0;3;3;5;3;8;5;16;1;0;1;9;22;14;5;5;56
674000;Sachbeschädigung §§ 303-305a StGB;5119000;Oberhausen;X;457;0;1;5;7;19;32;38;33;71;46;149;26;29;55;61;94;57;24;17;308
674000;Sachbeschädigung §§ 303-305a StGB;6413000;Offenbach am Main;M;159;2;2;1;0;3;8;17;23;40;20;68;7;5;12;12;24;25;11;7;91
674000;Sachbeschädigung §§ 303-305a StGB;6413000;Offenbach am Main;W;21;0;0;1;0;0;1;1;1;2;5;8;0;3;3;2;5;2;1;0;13
674000;Sachbeschädigung §§ 303-305a StGB;6413000;Offenbach am Main;X;180;2;2;2;0;3;9;18;24;42;25;76;7;8;15;14;29;27;12;7;104
674000;Sachbeschädigung §§ 303-305a StGB;3403000;Oldenburg (Oldenburg);M;284;0;1;0;0;5;6;23;22;45;46;97;26;22;48;42;36;30;16;15;187
674000;Sachbeschädigung §§ 303-305a StGB;3403000;Oldenburg (Oldenburg);W;54;0;0;0;0;3;3;2;4;6;7;16;6;4;10;7;4;5;7;5;38
674000;Sachbeschädigung §§ 303-305a StGB;3403000;Oldenburg (Oldenburg);X;338;0;1;0;0;8;9;25;26;51;53;113;32;26;58;49;40;35;23;20;225
674000;Sachbeschädigung §§ 303-305a StGB;3404000;Osnabrück;M;322;0;0;0;2;7;9;13;19;32;52;93;20;25;45;62;54;37;21;10;229
674000;Sachbeschädigung §§ 303-305a StGB;3404000;Osnabrück;W;51;0;0;0;0;1;1;4;3;7;4;12;4;1;5;10;6;8;6;4;39
674000;Sachbeschädigung §§ 303-305a StGB;3404000;Osnabrück;X;373;0;0;0;2;8;10;17;22;39;56;105;24;26;50;72;60;45;27;14;268
674000;Sachbeschädigung §§ 303-305a StGB;5774032;Paderborn;M;202;0;0;0;1;5;6;7;28;35;29;70;18;11;29;34;39;22;8;0;132
674000;Sachbeschädigung §§ 303-305a StGB;5774032;Paderborn;W;33;0;0;0;1;1;2;2;1;3;2;7;2;2;4;8;6;5;2;1;26
674000;Sachbeschädigung §§ 303-305a StGB;5774032;Paderborn;X;235;0;0;0;2;6;8;9;29;38;31;77;20;13;33;42;45;27;10;1;158
674000;Sachbeschädigung §§ 303-305a StGB;8231000;Pforzheim;M;151;0;3;2;5;5;15;10;12;22;21;58;11;11;22;25;18;16;6;6;93
674000;Sachbeschädigung §§ 303-305a StGB;8231000;Pforzheim;W;24;0;0;0;0;6;6;2;1;3;1;10;0;4;4;2;1;4;1;2;14
674000;Sachbeschädigung §§ 303-305a StGB;8231000;Pforzheim;X;175;0;3;2;5;11;21;12;13;25;22;68;11;15;26;27;19;20;7;8;107
674000;Sachbeschädigung §§ 303-305a StGB;12054000;Potsdam;M;329;0;2;1;9;14;26;23;41;64;28;118;14;26;40;44;57;26;30;14;211
674000;Sachbeschädigung §§ 303-305a StGB;12054000;Potsdam;W;44;0;0;0;1;0;1;4;0;4;2;7;2;4;6;14;7;3;5;2;37
674000;Sachbeschädigung §§ 303-305a StGB;12054000;Potsdam;X;373;0;2;1;10;14;27;27;41;68;30;125;16;30;46;58;64;29;35;16;248
674000;Sachbeschädigung §§ 303-305a StGB;5562032;Recklinghausen;M;200;0;0;2;7;15;24;24;19;43;31;98;10;4;14;20;28;22;12;6;102
674000;Sachbeschädigung §§ 303-305a StGB;5562032;Recklinghausen;W;30;0;0;0;0;0;0;3;6;9;3;12;1;1;2;1;7;5;2;1;18
674000;Sachbeschädigung §§ 303-305a StGB;5562032;Recklinghausen;X;230;0;0;2;7;15;24;27;25;52;34;110;11;5;16;21;35;27;14;7;120
674000;Sachbeschädigung §§ 303-305a StGB;9362000;Regensburg;M;232;0;0;3;5;5;13;8;25;33;38;84;25;14;39;28;41;17;9;14;148
674000;Sachbeschädigung §§ 303-305a StGB;9362000;Regensburg;W;35;0;0;0;0;2;2;7;4;11;4;17;2;0;2;8;6;0;0;2;18
674000;Sachbeschädigung §§ 303-305a StGB;9362000;Regensburg;X;267;0;0;3;5;7;15;15;29;44;42;101;27;14;41;36;47;17;9;16;166
674000;Sachbeschädigung §§ 303-305a StGB;5120000;Remscheid;M;191;0;4;0;5;2;11;13;13;26;29;66;17;8;25;16;37;18;23;6;125
674000;Sachbeschädigung §§ 303-305a StGB;5120000;Remscheid;W;35;0;0;0;1;2;3;4;3;7;3;13;1;2;3;2;4;8;3;2;22
674000;Sachbeschädigung §§ 303-305a StGB;5120000;Remscheid;X;226;0;4;0;6;4;14;17;16;33;32;79;18;10;28;18;41;26;26;8;147
674000;Sachbeschädigung §§ 303-305a StGB;8415061;Reutlingen;M;119;0;2;2;4;5;13;13;14;27;22;62;12;7;19;8;9;13;6;2;57
674000;Sachbeschädigung §§ 303-305a StGB;8415061;Reutlingen;W;24;0;0;0;3;1;4;0;0;0;5;9;2;1;3;3;4;1;3;1;15
674000;Sachbeschädigung §§ 303-305a StGB;8415061;Reutlingen;X;143;0;2;2;7;6;17;13;14;27;27;71;14;8;22;11;13;14;9;3;72
674000;Sachbeschädigung §§ 303-305a StGB;13003000;Rostock;M;478;0;3;5;4;18;30;49;30;79;48;157;38;46;84;91;70;38;16;22;321
674000;Sachbeschädigung §§ 303-305a StGB;13003000;Rostock;W;86;0;2;2;3;8;15;14;4;18;7;40;5;3;8;8;10;8;5;7;46
674000;Sachbeschädigung §§ 303-305a StGB;13003000;Rostock;X;564;0;5;7;7;26;45;63;34;97;55;197;43;49;92;99;80;46;21;29;367
674000;Sachbeschädigung §§ 303-305a StGB;10041100;Saarbrücken;M;477;0;2;9;5;22;38;46;45;91;49;178;40;37;77;50;82;57;23;10;299
674000;Sachbeschädigung §§ 303-305a StGB;10041100;Saarbrücken;W;94;0;1;3;0;6;10;4;5;9;11;30;5;5;10;13;13;11;9;8;64
674000;Sachbeschädigung §§ 303-305a StGB;10041100;Saarbrücken;X;571;0;3;12;5;28;48;50;50;100;60;208;45;42;87;63;95;68;32;18;363
674000;Sachbeschädigung §§ 303-305a StGB;5122000;Solingen;M;208;0;1;6;4;6;17;10;20;30;21;68;12;21;33;24;38;18;12;15;140
674000;Sachbeschädigung §§ 303-305a StGB;5122000;Solingen;W;40;0;0;0;0;3;3;1;1;2;4;9;3;1;4;4;7;8;5;3;31
674000;Sachbeschädigung §§ 303-305a StGB;5122000;Solingen;X;248;0;1;6;4;9;20;11;21;32;25;77;15;22;37;28;45;26;17;18;171
674000;Sachbeschädigung §§ 303-305a StGB;8111000;Stuttgart;M;801;1;4;6;7;30;48;34;52;86;95;229;80;56;136;100;162;78;56;40;572
674000;Sachbeschädigung §§ 303-305a StGB;8111000;Stuttgart;W;143;2;0;2;2;6;12;14;10;24;11;47;4;8;12;21;21;12;16;14;96
674000;Sachbeschädigung §§ 303-305a StGB;8111000;Stuttgart;X;944;3;4;8;9;36;60;48;62;110;106;276;84;64;148;121;183;90;72;54;668
674000;Sachbeschädigung §§ 303-305a StGB;7211000;Trier;M;225;0;1;2;5;6;14;11;18;29;25;68;10;21;31;36;43;21;14;12;157
674000;Sachbeschädigung §§ 303-305a StGB;7211000;Trier;W;36;0;0;0;0;2;2;0;2;2;5;9;0;5;5;4;4;6;5;3;27
674000;Sachbeschädigung §§ 303-305a StGB;7211000;Trier;X;261;0;1;2;5;8;16;11;20;31;30;77;10;26;36;40;47;27;19;15;184
674000;Sachbeschädigung §§ 303-305a StGB;8421000;Ulm;M;122;0;1;5;1;3;10;6;8;14;14;38;15;10;25;18;15;14;7;5;84
674000;Sachbeschädigung §§ 303-305a StGB;8421000;Ulm;W;22;0;0;0;0;0;0;2;1;3;5;8;1;2;3;0;4;0;6;1;14
674000;Sachbeschädigung §§ 303-305a StGB;8421000;Ulm;X;144;0;1;5;1;3;10;8;9;17;19;46;16;12;28;18;19;14;13;6;98
674000;Sachbeschädigung §§ 303-305a StGB;6414000;Wiesbaden;M;487;0;1;6;3;19;29;46;40;86;84;199;40;23;63;49;70;52;32;22;288
674000;Sachbeschädigung §§ 303-305a StGB;6414000;Wiesbaden;W;80;0;0;1;1;3;5;8;7;15;4;24;3;8;11;6;17;7;7;8;56
674000;Sachbeschädigung §§ 303-305a StGB;6414000;Wiesbaden;X;567;0;1;7;4;22;34;54;47;101;88;223;43;31;74;55;87;59;39;30;344
674000;Sachbeschädigung §§ 303-305a StGB;3103000;Wolfsburg;M;176;1;2;2;1;9;15;7;32;39;23;77;14;3;17;25;25;16;9;7;99
674000;Sachbeschädigung §§ 303-305a StGB;3103000;Wolfsburg;W;28;0;0;0;0;1;1;3;4;7;5;13;2;1;3;5;3;1;1;2;15
674000;Sachbeschädigung §§ 303-305a StGB;3103000;Wolfsburg;X;204;1;2;2;1;10;16;10;36;46;28;90;16;4;20;30;28;17;10;9;114
674000;Sachbeschädigung §§ 303-305a StGB;5124000;Wuppertal;M;674;0;5;12;9;17;43;47;63;110;112;265;38;44;82;80;103;73;40;31;409
674000;Sachbeschädigung §§ 303-305a StGB;5124000;Wuppertal;W;131;0;0;0;4;4;8;20;9;29;11;48;6;13;19;11;20;16;14;3;83
674000;Sachbeschädigung §§ 303-305a StGB;5124000;Wuppertal;X;805;0;5;12;13;21;51;67;72;139;123;313;44;57;101;91;123;89;54;34;492
674000;Sachbeschädigung §§ 303-305a StGB;9663000;Würzburg;M;183;0;0;4;1;4;9;12;12;24;21;54;21;14;35;29;34;17;7;7;129
674000;Sachbeschädigung §§ 303-305a StGB;9663000;Würzburg;W;27;0;0;0;1;0;1;0;2;2;4;7;1;1;2;4;7;1;2;4;20
674000;Sachbeschädigung §§ 303-305a StGB;9663000;Würzburg;X;210;0;0;4;2;4;10;12;14;26;25;61;22;15;37;33;41;18;9;11;149
725000;Straftaten gegen das Aufenthalts-, das Asylverfahrens- und das Freizügigkeitsgesetz/EU;5334002;Aachen;M;2584;0;0;0;0;3;3;161;321;482;344;829;199;258;457;570;512;179;29;8;1755
725000;Straftaten gegen das Aufenthalts-, das Asylverfahrens- und das Freizügigkeitsgesetz/EU;5334002;Aachen;W;381;0;0;0;0;0;0;15;25;40;47;87;41;33;74;71;82;44;17;6;294
725000;Straftaten gegen das Aufenthalts-, das Asylverfahrens- und das Freizügigkeitsgesetz/EU;5334002;Aachen;X;2965;0;0;0;0;3;3;176;346;522;391;916;240;291;531;641;594;223;46;14;2049
725000;Straftaten gegen das Aufenthalts-, das Asylverfahrens- und das Freizügigkeitsgesetz/EU;9761000;Augsburg;M;412;0;0;0;0;0;0;16;55;71;35;106;34;46;80;85;93;37;7;4;306
725000;Straftaten gegen das Aufenthalts-, das Asylverfahrens- und das Freizügigkeitsgesetz/EU;9761000;Augsburg;W;72;0;0;0;0;0;0;0;6;6;12;18;6;7;13;13;12;7;7;2;54
725000;Straftaten gegen das Aufenthalts-, das Asylverfahrens- und das Freizügigkeitsgesetz/EU;9761000;Augsburg;X;484;0;0;0;0;0;0;16;61;77;47;124;40;53;93;98;105;44;14;6;360
725000;Straftaten gegen das Aufenthalts-, das Asylverfahrens- und das Freizügigkeitsgesetz/EU;5378004;Bergisch Gladbach;M;16;0;0;0;0;0;0;0;2;2;2;4;0;1;1;2;4;2;1;2;12
725000;Straftaten gegen das Aufenthalts-, das Asylverfahrens- und das Freizügigkeitsgesetz/EU;5378004;Bergisch Gladbach;W;4;0;0;0;0;0;0;1;1;2;0;2;0;0;0;0;1;1;0;0;2
725000;Straftaten gegen das Aufenthalts-, das Asylverfahrens- und das Freizügigkeitsgesetz/EU;5378004;Bergisch Gladbach;X;20;0;0;0;0;0;0;1;3;4;2;6;0;1;1;2;5;3;1;2;14
725000;Straftaten gegen das Aufenthalts-, das Asylverfahrens- und das Freizügigkeitsgesetz/EU;11000000;Berlin;M;4173;41;9;11;7;10;78;150;275;425;458;961;313;364;677;856;998;456;166;59;3212
725000;Straftaten gegen das Aufenthalts-, das Asylverfahrens- und das Freizügigkeitsgesetz/EU;11000000;Berlin;W;1329;45;11;8;11;8;83;52;52;104;99;286;70;80;150;225;341;161;96;70;1043
725000;Straftaten gegen das Aufenthalts-, das Asylverfahrens- und das Freizügigkeitsgesetz/EU;11000000;Berlin;X;5502;86;20;19;18;18;161;202;327;529;557;1247;383;444;827;1081;1339;617;262;129;4255
725000;Straftaten gegen das Aufenthalts-, das Asylverfahrens- und das Freizügigkeitsgesetz/EU;5711000;Bielefeld;M;395;4;0;0;0;1;5;11;96;107;32;144;22;24;46;63;95;32;10;5;251
725000;Straftaten gegen das Aufenthalts-, das Asylverfahrens- und das Freizügigkeitsgesetz/EU;5711000;Bielefeld;W;95;4;3;2;0;0;9;1;9;10;3;22;1;8;9;15;27;10;9;3;73
725000;Straftaten gegen das Aufenthalts-, das Asylverfahrens- und das Freizügigkeitsgesetz/EU;5711000;Bielefeld;X;490;8;3;2;0;1;14;12;105;117;35;166;23;32;55;78;122;42;19;8;324
725000;Straftaten gegen das Aufenthalts-, das Asylverfahrens- und das Freizügigkeitsgesetz/EU;5911000;Bochum;M;95;0;0;0;0;0;0;0;12;12;8;20;6;9;15;24;23;11;1;1;75
725000;Straftaten gegen das Aufenthalts-, das Asylverfahrens- und das Freizügigkeitsgesetz/EU;5911000;Bochum;W;15;0;1;0;0;0;1;0;2;2;2;5;2;2;4;2;2;1;1;0;10
725000;Straftaten gegen das Aufenthalts-, das Asylverfahrens- und das Freizügigkeitsgesetz/EU;5911000;Bochum;X;110;0;1;0;0;0;1;0;14;14;10;25;8;11;19;26;25;12;2;1;85
725000;Straftaten gegen das Aufenthalts-, das Asylverfahrens- und das Freizügigkeitsgesetz/EU;5314000;Bonn;M;202;0;0;0;0;0;0;3;10;13;19;32;19;24;43;44;55;18;7;3;170
725000;Straftaten gegen das Aufenthalts-, das Asylverfahrens- und das Freizügigkeitsgesetz/EU;5314000;Bonn;W;65;0;0;0;0;0;0;1;2;3;4;7;6;2;8;11;25;8;3;3;58
725000;Straftaten gegen das Aufenthalts-, das Asylverfahrens- und das Freizügigkeitsgesetz/EU;5314000;Bonn;X;267;0;0;0;0;0;0;4;12;16;23;39;25;26;51;55;80;26;10;6;228
725000;Straftaten gegen das Aufenthalts-, das Asylverfahrens- und das Freizügigkeitsgesetz/EU;5512000;Bottrop;M;10;0;0;0;0;0;0;0;0;0;0;0;0;1;1;2;4;3;0;0;10
725000;Straftaten gegen das Aufenthalts-, das Asylverfahrens- und das Freizügigkeitsgesetz/EU;5512000;Bottrop;W;1;0;0;0;0;0;0;0;0;0;0;0;0;0;0;1;0;0;0;0;1
725000;Straftaten gegen das Aufenthalts-, das Asylverfahrens- und das Freizügigkeitsgesetz/EU;5512000;Bottrop;X;11;0;0;0;0;0;0;0;0;0;0;0;0;1;1;3;4;3;0;0;11
725000;Straftaten gegen das Aufenthalts-, das Asylverfahrens- und das Freizügigkeitsgesetz/EU;3101000;Braunschweig;M;351;9;1;1;1;0;12;1;7;8;76;96;26;34;60;90;71;27;6;1;255
725000;Straftaten gegen das Aufenthalts-, das Asylverfahrens- und das Freizügigkeitsgesetz/EU;3101000;Braunschweig;W;87;7;1;1;1;1;11;3;0;3;14;28;8;4;12;12;21;8;4;2;59
725000;Straftaten gegen das Aufenthalts-, das Asylverfahrens- und das Freizügigkeitsgesetz/EU;3101000;Braunschweig;X;438;16;2;2;2;1;23;4;7;11;90;124;34;38;72;102;92;35;10;3;314
725000;Straftaten gegen das Aufenthalts-, das Asylverfahrens- und das Freizügigkeitsgesetz/EU;4011000;Bremen;M;774;3;1;1;1;2;8;72;215;287;58;353;42;39;81;99;147;71;15;8;421
725000;Straftaten gegen das Aufenthalts-, das Asylverfahrens- und das Freizügigkeitsgesetz/EU;4011000;Bremen;W;257;2;2;1;1;2;8;9;24;33;16;57;10;13;23;45;72;38;9;13;200
725000;Straftaten gegen das Aufenthalts-, das Asylverfahrens- und das Freizügigkeitsgesetz/EU;4011000;Bremen;X;1031;5;3;2;2;4;16;81;239;320;74;410;52;52;104;144;219;109;24;21;621
725000;Straftaten gegen das Aufenthalts-, das Asylverfahrens- und das Freizügigkeitsgesetz/EU;4012000;Bremerhaven;M;36;0;1;0;1;0;2;2;4;6;4;12;1;2;3;7;9;3;2;0;24
725000;Straftaten gegen das Aufenthalts-, das Asylverfahrens- und das Freizügigkeitsgesetz/EU;4012000;Bremerhaven;W;6;0;0;0;0;0;0;1;0;1;1;2;1;0;1;0;0;2;1;0;4
725000;Straftaten gegen das Aufenthalts-, das Asylverfahrens- und das Freizügigkeitsgesetz/EU;4012000;Bremerhaven;X;42;0;1;0;1;0;2;3;4;7;5;14;2;2;4;7;9;5;3;0;28
725000;Straftaten gegen das Aufenthalts-, das Asylverfahrens- und das Freizügigkeitsgesetz/EU;14511000;Chemnitz;M;1648;68;29;36;24;37;194;43;56;99;145;438;122;148;270;287;396;170;69;18;1210
725000;Straftaten gegen das Aufenthalts-, das Asylverfahrens- und das Freizügigkeitsgesetz/EU;14511000;Chemnitz;W;826;81;18;19;18;21;157;18;28;46;54;257;43;50;93;115;204;94;50;13;569
725000;Straftaten gegen das Aufenthalts-, das Asylverfahrens- und das Freizügigkeitsgesetz/EU;14511000;Chemnitz;X;2474;149;47;55;42;58;351;61;84;145;199;695;165;198;363;402;600;264;119;31;1779
725000;Straftaten gegen das Aufenthalts-, das Asylverfahrens- und das Freizügigkeitsgesetz/EU;6411000;Darmstadt;M;96;0;0;0;0;0;0;4;7;11;10;21;9;7;16;27;17;7;7;1;75
725000;Straftaten gegen das Aufenthalts-, das Asylverfahrens- und das Freizügigkeitsgesetz/EU;6411000;Darmstadt;W;24;0;0;0;0;0;0;0;1;1;4;5;1;3;4;6;3;2;2;2;19
725000;Straftaten gegen das Aufenthalts-, das Asylverfahrens- und das Freizügigkeitsgesetz/EU;6411000;Darmstadt;X;120;0;0;0;0;0;0;4;8;12;14;26;10;10;20;33;20;9;9;3;94
725000;Straftaten gegen das Aufenthalts-, das Asylverfahrens- und das Freizügigkeitsgesetz/EU;5913000;Dortmund;M;1294;8;2;4;3;6;23;89;250;339;154;516;99;110;209;228;243;66;22;10;778
725000;Straftaten gegen das Aufenthalts-, das Asylverfahrens- und das Freizügigkeitsgesetz/EU;5913000;Dortmund;W;247;8;1;4;1;2;16;12;16;28;28;72;12;20;32;46;42;29;16;10;175
725000;Straftaten gegen das Aufenthalts-, das Asylverfahrens- und das Freizügigkeitsgesetz/EU;5913000;Dortmund;X;1541;16;3;8;4;8;39;101;266;367;182;588;111;130;241;274;285;95;38;20;953
725000;Straftaten gegen das Aufenthalts-, das Asylverfahrens- und das Freizügigkeitsgesetz/EU;14612000;Dresden;M;387;0;0;0;1;1;2;1;13;14;50;66;28;39;67;102;96;34;17;5;321
725000;Straftaten gegen das Aufenthalts-, das Asylverfahrens- und das Freizügigkeitsgesetz/EU;14612000;Dresden;W;69;1;0;1;1;0;3;0;3;3;0;6;2;3;5;17;21;12;7;1;63
725000;Straftaten gegen das Aufenthalts-, das Asylverfahrens- und das Freizügigkeitsgesetz/EU;14612000;Dresden;X;456;1;0;1;2;1;5;1;16;17;50;72;30;42;72;119;117;46;24;6;384
725000;Straftaten gegen das Aufenthalts-, das Asylverfahrens- und das Freizügigkeitsgesetz/EU;5112000;Duisburg;M;221;1;0;0;0;2;3;5;11;16;24;43;17;25;42;50;59;18;7;2;178
725000;Straftaten gegen das Aufenthalts-, das Asylverfahrens- und das Freizügigkeitsgesetz/EU;5112000;Duisburg;W;42;0;0;0;0;0;0;0;0;0;5;5;4;3;7;8;14;6;1;1;37
725000;Straftaten gegen das Aufenthalts-, das Asylverfahrens- und das Freizügigkeitsgesetz/EU;5112000;Duisburg;X;263;1;0;0;0;2;3;5;11;16;29;48;21;28;49;58;73;24;8;3;215
725000;Straftaten gegen das Aufenthalts-, das Asylverfahrens- und das Freizügigkeitsgesetz/EU;5111000;Düsseldorf;M;1871;8;0;0;1;4;13;34;110;144;164;321;109;149;258;338;493;262;108;91;1550
725000;Straftaten gegen das Aufenthalts-, das Asylverfahrens- und das Freizügigkeitsgesetz/EU;5111000;Düsseldorf;W;854;3;2;0;3;3;11;8;26;34;62;107;43;47;90;99;156;101;138;163;747
725000;Straftaten gegen das Aufenthalts-, das Asylverfahrens- und das Freizügigkeitsgesetz/EU;5111000;Düsseldorf;X;2725;11;2;0;4;7;24;42;136;178;226;428;152;196;348;437;649;363;246;254;2297
725000;Straftaten gegen das Aufenthalts-, das Asylverfahrens- und das Freizügigkeitsgesetz/EU;16051000;Erfurt;M;104;2;0;0;2;0;4;2;3;5;17;26;4;8;12;26;22;14;4;0;78
725000;Straftaten gegen das Aufenthalts-, das Asylverfahrens- und das Freizügigkeitsgesetz/EU;16051000;Erfurt;W;27;3;0;0;0;2;5;2;1;3;3;11;1;0;1;4;5;4;2;0;16
725000;Straftaten gegen das Aufenthalts-, das Asylverfahrens- und das Freizügigkeitsgesetz/EU;16051000;Erfurt;X;131;5;0;0;2;2;9;4;4;8;20;37;5;8;13;30;27;18;6;0;94
725000;Straftaten gegen das Aufenthalts-, das Asylverfahrens- und das Freizügigkeitsgesetz/EU;9562000;Erlangen;M;101;1;0;0;1;0;2;1;3;4;7;13;3;8;11;26;27;17;5;2;88
725000;Straftaten gegen das Aufenthalts-, das Asylverfahrens- und das Freizügigkeitsgesetz/EU;9562000;Erlangen;W;19;1;1;0;1;1;4;1;0;1;1;6;2;1;3;3;1;2;0;4;13
725000;Straftaten gegen das Aufenthalts-, das Asylverfahrens- und das Freizügigkeitsgesetz/EU;9562000;Erlangen;X;120;2;1;0;2;1;6;2;3;5;8;19;5;9;14;29;28;19;5;6;101
725000;Straftaten gegen das Aufenthalts-, das Asylverfahrens- und das Freizügigkeitsgesetz/EU;5113000;Essen;M;150;0;0;0;0;0;0;9;12;21;16;37;10;13;23;35;37;11;7;0;113
725000;Straftaten gegen das Aufenthalts-, das Asylverfahrens- und das Freizügigkeitsgesetz/EU;5113000;Essen;W;32;0;0;0;0;0;0;3;2;5;3;8;2;3;5;6;7;4;2;0;24
725000;Straftaten gegen das Aufenthalts-, das Asylverfahrens- und das Freizügigkeitsgesetz/EU;5113000;Essen;X;182;0;0;0;0;0;0;12;14;26;19;45;12;16;28;41;44;15;9;0;137
725000;Straftaten gegen das Aufenthalts-, das Asylverfahrens- und das Freizügigkeitsgesetz/EU;6412000;Frankfurt am Main;M;9928;87;25;31;22;25;190;245;711;956;782;1928;604;728;1332;1824;2392;1324;658;470;8000
725000;Straftaten gegen das Aufenthalts-, das Asylverfahrens- und das Freizügigkeitsgesetz/EU;6412000;Frankfurt am Main;W;5697;76;28;28;21;17;170;58;145;203;284;657;282;323;605;881;1223;786;756;789;5040
725000;Straftaten gegen das Aufenthalts-, das Asylverfahrens- und das Freizügigkeitsgesetz/EU;6412000;Frankfurt am Main;X;15625;163;53;59;43;42;360;303;856;1159;1066;2585;886;1051;1937;2705;3615;2110;1414;1259;13040
725000;Straftaten gegen das Aufenthalts-, das Asylverfahrens- und das Freizügigkeitsgesetz/EU;8311000;Freiburg im Breisgau;M;486;1;1;1;1;2;6;19;64;83;59;148;46;52;98;95;99;40;6;0;338
725000;Straftaten gegen das Aufenthalts-, das Asylverfahrens- und das Freizügigkeitsgesetz/EU;8311000;Freiburg im Breisgau;W;83;1;0;0;0;2;3;4;4;8;5;16;6;5;11;23;19;10;1;3;67
725000;Straftaten gegen das Aufenthalts-, das Asylverfahrens- und das Freizügigkeitsgesetz/EU;8311000;Freiburg im Breisgau;X;569;2;1;1;1;4;9;23;68;91;64;164;52;57;109;118;118;50;7;3;405
725000;Straftaten gegen das Aufenthalts-, das Asylverfahrens- und das Freizügigkeitsgesetz/EU;9563000;Fürth;M;43;0;0;0;0;0;0;1;1;2;4;6;5;5;10;12;9;5;1;0;37
725000;Straftaten gegen das Aufenthalts-, das Asylverfahrens- und das Freizügigkeitsgesetz/EU;9563000;Fürth;W;6;0;0;0;0;0;0;0;1;1;0;1;0;0;0;1;1;3;0;0;5
725000;Straftaten gegen das Aufenthalts-, das Asylverfahrens- und das Freizügigkeitsgesetz/EU;9563000;Fürth;X;49;0;0;0;0;0;0;1;2;3;4;7;5;5;10;13;10;8;1;0;42
725000;Straftaten gegen das Aufenthalts-, das Asylverfahrens- und das Freizügigkeitsgesetz/EU;5513000;Gelsenkirchen;M;26;0;0;0;0;0;0;1;1;2;2;4;2;1;3;3;9;6;1;0;22
725000;Straftaten gegen das Aufenthalts-, das Asylverfahrens- und das Freizügigkeitsgesetz/EU;5513000;Gelsenkirchen;W;5;0;0;0;0;0;0;0;1;1;2;3;0;0;0;1;1;0;0;0;2
725000;Straftaten gegen das Aufenthalts-, das Asylverfahrens- und das Freizügigkeitsgesetz/EU;5513000;Gelsenkirchen;X;31;0;0;0;0;0;0;1;2;3;4;7;2;1;3;4;10;6;1;0;24
725000;Straftaten gegen das Aufenthalts-, das Asylverfahrens- und das Freizügigkeitsgesetz/EU;3152012;Göttingen;M;83;0;0;0;0;2;2;5;11;16;8;26;4;9;13;23;14;3;3;1;57
725000;Straftaten gegen das Aufenthalts-, das Asylverfahrens- und das Freizügigkeitsgesetz/EU;3152012;Göttingen;W;18;0;0;0;0;0;0;0;3;3;1;4;0;1;1;4;5;1;0;3;14
725000;Straftaten gegen das Aufenthalts-, das Asylverfahrens- und das Freizügigkeitsgesetz/EU;3152012;Göttingen;X;101;0;0;0;0;2;2;5;14;19;9;30;4;10;14;27;19;4;3;4;71
725000;Straftaten gegen das Aufenthalts-, das Asylverfahrens- und das Freizügigkeitsgesetz/EU;5914000;Hagen;M;66;0;0;0;0;0;0;2;7;9;7;16;6;3;9;18;18;4;1;0;50
725000;Straftaten gegen das Aufenthalts-, das Asylverfahrens- und das Freizügigkeitsgesetz/EU;5914000;Hagen;W;9;0;0;0;0;0;0;0;1;1;1;2;0;0;0;1;3;3;0;0;7
725000;Straftaten gegen das Aufenthalts-, das Asylverfahrens- und das Freizügigkeitsgesetz/EU;5914000;Hagen;X;75;0;0;0;0;0;0;2;8;10;8;18;6;3;9;19;21;7;1;0;57
725000;Straftaten gegen das Aufenthalts-, das Asylverfahrens- und das Freizügigkeitsgesetz/EU;15002000;Halle (Saale);M;53;0;0;0;0;0;0;0;4;4;8;12;5;3;8;10;17;5;1;0;41
725000;Straftaten gegen das Aufenthalts-, das Asylverfahrens- und das Freizügigkeitsgesetz/EU;15002000;Halle (Saale);W;11;0;0;0;0;0;0;0;0;0;1;1;1;2;3;3;2;2;0;0;10
725000;Straftaten gegen das Aufenthalts-, das Asylverfahrens- und das Freizügigkeitsgesetz/EU;15002000;Halle (Saale);X;64;0;0;0;0;0;0;0;4;4;9;13;6;5;11;13;19;7;1;0;51
725000;Straftaten gegen das Aufenthalts-, das Asylverfahrens- und das Freizügigkeitsgesetz/EU;2000000;Hamburg;M;3206;5;1;2;2;7;17;162;376;538;390;945;228;272;500;630;710;259;115;47;2261
725000;Straftaten gegen das Aufenthalts-, das Asylverfahrens- und das Freizügigkeitsgesetz/EU;2000000;Hamburg;W;615;6;2;3;2;1;14;10;29;39;40;93;37;55;92;112;140;75;58;45;522
725000;Straftaten gegen das Aufenthalts-, das Asylverfahrens- und das Freizügigkeitsgesetz/EU;2000000;Hamburg;X;3821;11;3;5;4;8;31;172;405;577;430;1038;265;327;592;742;850;334;173;92;2783
725000;Straftaten gegen das Aufenthalts-, das Asylverfahrens- und das Freizügigkeitsgesetz/EU;5915000;Hamm;M;235;0;0;0;0;1;1;10;17;27;31;59;21;24;45;52;58;17;3;1;176
725000;Straftaten gegen das Aufenthalts-, das Asylverfahrens- und das Freizügigkeitsgesetz/EU;5915000;Hamm;W;28;0;0;0;0;1;1;2;1;3;5;9;3;3;6;4;5;2;1;1;19
725000;Straftaten gegen das Aufenthalts-, das Asylverfahrens- und das Freizügigkeitsgesetz/EU;5915000;Hamm;X;263;0;0;0;0;2;2;12;18;30;36;68;24;27;51;56;63;19;4;2;195
725000;Straftaten gegen das Aufenthalts-, das Asylverfahrens- und das Freizügigkeitsgesetz/EU;3241001;Hannover;M;1167;17;1;5;3;6;32;46;94;140;110;282;80;102;182;225;259;132;62;25;885
725000;Straftaten gegen das Aufenthalts-, das Asylverfahrens- und das Freizügigkeitsgesetz/EU;3241001;Hannover;W;551;16;4;1;3;3;27;18;21;39;26;92;19;29;48;110;151;61;48;41;459
725000;Straftaten gegen das Aufenthalts-, das Asylverfahrens- und das Freizügigkeitsgesetz/EU;3241001;Hannover;X;1718;33;5;6;6;9;59;64;115;179;136;374;99;131;230;335;410;193;110;66;1344
725000;Straftaten gegen das Aufenthalts-, das Asylverfahrens- und das Freizügigkeitsgesetz/EU;8221000;Heidelberg;M;58;0;0;0;0;0;0;0;0;0;5;5;6;8;14;13;14;8;3;1;53
725000;Straftaten gegen das Aufenthalts-, das Asylverfahrens- und das Freizügigkeitsgesetz/EU;8221000;Heidelberg;W;20;0;0;0;0;0;0;0;0;0;2;2;1;2;3;4;7;4;0;0;18
725000;Straftaten gegen das Aufenthalts-, das Asylverfahrens- und das Freizügigkeitsgesetz/EU;8221000;Heidelberg;X;78;0;0;0;0;0;0;0;0;0;7;7;7;10;17;17;21;12;3;1;71
725000;Straftaten gegen das Aufenthalts-, das Asylverfahrens- und das Freizügigkeitsgesetz/EU;8121000;Heilbronn;M;40;0;0;0;0;0;0;0;0;0;8;8;5;1;6;6;10;8;1;1;32
725000;Straftaten gegen das Aufenthalts-, das Asylverfahrens- und das Freizügigkeitsgesetz/EU;8121000;Heilbronn;W;8;0;0;0;0;0;0;0;1;1;1;2;0;0;0;3;2;1;0;0;6
725000;Straftaten gegen das Aufenthalts-, das Asylverfahrens- und das Freizügigkeitsgesetz/EU;8121000;Heilbronn;X;48;0;0;0;0;0;0;0;1;1;9;10;5;1;6;9;12;9;1;1;38
725000;Straftaten gegen das Aufenthalts-, das Asylverfahrens- und das Freizügigkeitsgesetz/EU;5916000;Herne;M;19;0;0;0;0;0;0;0;0;0;0;0;2;3;5;4;7;3;0;0;19
725000;Straftaten gegen das Aufenthalts-, das Asylverfahrens- und das Freizügigkeitsgesetz/EU;5916000;Herne;W;2;0;0;0;0;0;0;0;0;0;0;0;1;0;1;0;1;0;0;0;2
725000;Straftaten gegen das Aufenthalts-, das Asylverfahrens- und das Freizügigkeitsgesetz/EU;5916000;Herne;X;21;0;0;0;0;0;0;0;0;0;0;0;3;3;6;4;8;3;0;0;21
725000;Straftaten gegen das Aufenthalts-, das Asylverfahrens- und das Freizügigkeitsgesetz/EU;9161000;Ingolstadt;M;105;0;0;0;0;0;0;2;17;19;8;27;5;10;15;25;24;13;1;0;78
725000;Straftaten gegen das Aufenthalts-, das Asylverfahrens- und das Freizügigkeitsgesetz/EU;9161000;Ingolstadt;W;16;0;0;0;0;0;0;0;0;0;3;3;1;2;3;6;3;1;0;0;13
725000;Straftaten gegen das Aufenthalts-, das Asylverfahrens- und das Freizügigkeitsgesetz/EU;9161000;Ingolstadt;X;121;0;0;0;0;0;0;2;17;19;11;30;6;12;18;31;27;14;1;0;91
725000;Straftaten gegen das Aufenthalts-, das Asylverfahrens- und das Freizügigkeitsgesetz/EU;16053000;Jena;M;31;0;0;0;1;0;1;1;2;3;5;9;2;6;8;5;6;2;1;0;22
725000;Straftaten gegen das Aufenthalts-, das Asylverfahrens- und das Freizügigkeitsgesetz/EU;16053000;Jena;W;5;0;0;0;0;0;0;0;0;0;1;1;0;0;0;0;2;2;0;0;4
725000;Straftaten gegen das Aufenthalts-, das Asylverfahrens- und das Freizügigkeitsgesetz/EU;16053000;Jena;X;36;0;0;0;1;0;1;1;2;3;6;10;2;6;8;5;8;4;1;0;26
725000;Straftaten gegen das Aufenthalts-, das Asylverfahrens- und das Freizügigkeitsgesetz/EU;8212000;Karlsruhe;M;494;7;4;1;0;3;15;11;30;41;54;110;45;53;98;101;129;34;15;7;384
725000;Straftaten gegen das Aufenthalts-, das Asylverfahrens- und das Freizügigkeitsgesetz/EU;8212000;Karlsruhe;W;115;14;2;1;2;0;19;1;7;8;9;36;11;6;17;13;28;13;8;0;79
725000;Straftaten gegen das Aufenthalts-, das Asylverfahrens- und das Freizügigkeitsgesetz/EU;8212000;Karlsruhe;X;609;21;6;2;2;3;34;12;37;49;63;146;56;59;115;114;157;47;23;7;463
725000;Straftaten gegen das Aufenthalts-, das Asylverfahrens- und das Freizügigkeitsgesetz/EU;6611000;Kassel;M;396;6;4;0;1;2;13;16;35;51;40;104;35;48;83;87;84;27;10;1;292
725000;Straftaten gegen das Aufenthalts-, das Asylverfahrens- und das Freizügigkeitsgesetz/EU;6611000;Kassel;W;54;2;2;1;2;1;8;1;4;5;9;22;5;1;6;6;15;0;5;0;32
725000;Straftaten gegen das Aufenthalts-, das Asylverfahrens- und das Freizügigkeitsgesetz/EU;6611000;Kassel;X;450;8;6;1;3;3;21;17;39;56;49;126;40;49;89;93;99;27;15;1;324
725000;Straftaten gegen das Aufenthalts-, das Asylverfahrens- und das Freizügigkeitsgesetz/EU;1002000;Kiel;M;128;4;1;0;1;0;6;4;19;23;11;40;5;12;17;29;32;7;3;0;88
725000;Straftaten gegen das Aufenthalts-, das Asylverfahrens- und das Freizügigkeitsgesetz/EU;1002000;Kiel;W;27;2;0;0;0;0;2;0;3;3;4;9;2;3;5;3;9;0;1;0;18
725000;Straftaten gegen das Aufenthalts-, das Asylverfahrens- und das Freizügigkeitsgesetz/EU;1002000;Kiel;X;155;6;1;0;1;0;8;4;22;26;15;49;7;15;22;32;41;7;4;0;106
725000;Straftaten gegen das Aufenthalts-, das Asylverfahrens- und das Freizügigkeitsgesetz/EU;7111000;Koblenz;M;113;0;0;0;0;0;0;5;7;12;14;26;8;12;20;30;26;8;3;0;87
725000;Straftaten gegen das Aufenthalts-, das Asylverfahrens- und das Freizügigkeitsgesetz/EU;7111000;Koblenz;W;23;0;0;1;1;0;2;0;0;0;1;3;1;0;1;4;9;4;1;1;20
725000;Straftaten gegen das Aufenthalts-, das Asylverfahrens- und das Freizügigkeitsgesetz/EU;7111000;Koblenz;X;136;0;0;1;1;0;2;5;7;12;15;29;9;12;21;34;35;12;4;1;107
725000;Straftaten gegen das Aufenthalts-, das Asylverfahrens- und das Freizügigkeitsgesetz/EU;5315000;Köln;M;2790;6;3;3;1;6;19;140;280;420;404;843;208;255;463;564;566;204;104;46;1947
725000;Straftaten gegen das Aufenthalts-, das Asylverfahrens- und das Freizügigkeitsgesetz/EU;5315000;Köln;W;1039;6;3;2;1;5;17;44;57;101;116;234;60;71;131;170;233;118;88;65;805
725000;Straftaten gegen das Aufenthalts-, das Asylverfahrens- und das Freizügigkeitsgesetz/EU;5315000;Köln;X;3829;12;6;5;2;11;36;184;337;521;520;1077;268;326;594;734;799;322;192;111;2752
725000;Straftaten gegen das Aufenthalts-, das Asylverfahrens- und das Freizügigkeitsgesetz/EU;5114000;Krefeld;M;24;0;0;1;0;0;1;1;0;1;0;2;2;1;3;5;5;7;2;0;22
725000;Straftaten gegen das Aufenthalts-, das Asylverfahrens- und das Freizügigkeitsgesetz/EU;5114000;Krefeld;W;9;0;1;0;0;0;1;0;0;0;1;2;0;0;0;2;3;2;0;0;7
725000;Straftaten gegen das Aufenthalts-, das Asylverfahrens- und das Freizügigkeitsgesetz/EU;5114000;Krefeld;X;33;0;1;1;0;0;2;1;0;1;1;4;2;1;3;7;8;9;2;0;29
725000;Straftaten gegen das Aufenthalts-, das Asylverfahrens- und das Freizügigkeitsgesetz/EU;14713000;Leipzig;M;359;7;3;4;1;1;16;4;13;17;42;75;31;37;68;82;106;22;4;2;284
725000;Straftaten gegen das Aufenthalts-, das Asylverfahrens- und das Freizügigkeitsgesetz/EU;14713000;Leipzig;W;62;3;2;1;0;2;8;0;0;0;3;11;3;5;8;11;16;13;2;1;51
725000;Straftaten gegen das Aufenthalts-, das Asylverfahrens- und das Freizügigkeitsgesetz/EU;14713000;Leipzig;X;421;10;5;5;1;3;24;4;13;17;45;86;34;42;76;93;122;35;6;3;335
725000;Straftaten gegen das Aufenthalts-, das Asylverfahrens- und das Freizügigkeitsgesetz/EU;5316000;Leverkusen;M;37;0;0;0;0;0;0;1;5;6;2;8;3;1;4;7;7;10;1;0;29
725000;Straftaten gegen das Aufenthalts-, das Asylverfahrens- und das Freizügigkeitsgesetz/EU;5316000;Leverkusen;W;22;0;0;0;0;0;0;2;3;5;1;6;2;2;4;3;5;2;2;0;16
725000;Straftaten gegen das Aufenthalts-, das Asylverfahrens- und das Freizügigkeitsgesetz/EU;5316000;Leverkusen;X;59;0;0;0;0;0;0;3;8;11;3;14;5;3;8;10;12;12;3;0;45
725000;Straftaten gegen das Aufenthalts-, das Asylverfahrens- und das Freizügigkeitsgesetz/EU;1003000;Lübeck;M;249;2;0;2;1;1;6;20;40;60;28;94;27;25;52;47;39;12;3;2;155
725000;Straftaten gegen das Aufenthalts-, das Asylverfahrens- und das Freizügigkeitsgesetz/EU;1003000;Lübeck;W;62;2;1;2;0;0;5;1;0;1;12;18;4;7;11;11;12;7;2;1;44
725000;Straftaten gegen das Aufenthalts-, das Asylverfahrens- und das Freizügigkeitsgesetz/EU;1003000;Lübeck;X;311;4;1;4;1;1;11;21;40;61;40;112;31;32;63;58;51;19;5;3;199
725000;Straftaten gegen das Aufenthalts-, das Asylverfahrens- und das Freizügigkeitsgesetz/EU;7314000;Ludwigshafen am Rhein;M;69;0;0;0;0;0;0;2;5;7;5;12;5;1;6;11;19;16;4;1;57
725000;Straftaten gegen das Aufenthalts-, das Asylverfahrens- und das Freizügigkeitsgesetz/EU;7314000;Ludwigshafen am Rhein;W;37;0;0;0;0;0;0;0;0;0;4;4;1;3;4;8;9;10;2;0;33
725000;Straftaten gegen das Aufenthalts-, das Asylverfahrens- und das Freizügigkeitsgesetz/EU;7314000;Ludwigshafen am Rhein;X;106;0;0;0;0;0;0;2;5;7;9;16;6;4;10;19;28;26;6;1;90
725000;Straftaten gegen das Aufenthalts-, das Asylverfahrens- und das Freizügigkeitsgesetz/EU;15003000;Magdeburg;M;77;0;0;0;0;0;0;0;4;4;12;16;4;6;10;20;19;7;5;0;61
725000;Straftaten gegen das Aufenthalts-, das Asylverfahrens- und das Freizügigkeitsgesetz/EU;15003000;Magdeburg;W;31;0;0;0;0;0;0;0;1;1;2;3;2;1;3;3;12;7;2;1;28
725000;Straftaten gegen das Aufenthalts-, das Asylverfahrens- und das Freizügigkeitsgesetz/EU;15003000;Magdeburg;X;108;0;0;0;0;0;0;0;5;5;14;19;6;7;13;23;31;14;7;1;89
725000;Straftaten gegen das Aufenthalts-, das Asylverfahrens- und das Freizügigkeitsgesetz/EU;7315000;Mainz;M;121;0;0;0;0;0;0;3;12;15;13;28;5;15;20;23;25;18;7;0;93
725000;Straftaten gegen das Aufenthalts-, das Asylverfahrens- und das Freizügigkeitsgesetz/EU;7315000;Mainz;W;32;0;0;0;0;0;0;2;2;4;6;10;3;3;6;4;8;3;1;0;22
725000;Straftaten gegen das Aufenthalts-, das Asylverfahrens- und das Freizügigkeitsgesetz/EU;7315000;Mainz;X;153;0;0;0;0;0;0;5;14;19;19;38;8;18;26;27;33;21;8;0;115
725000;Straftaten gegen das Aufenthalts-, das Asylverfahrens- und das Freizügigkeitsgesetz/EU;8222000;Mannheim;M;329;0;0;0;0;1;1;6;42;48;34;83;26;31;57;83;74;20;9;3;246
725000;Straftaten gegen das Aufenthalts-, das Asylverfahrens- und das Freizügigkeitsgesetz/EU;8222000;Mannheim;W;69;0;0;0;0;0;0;0;14;14;7;21;7;3;10;12;12;7;4;3;48
725000;Straftaten gegen das Aufenthalts-, das Asylverfahrens- und das Freizügigkeitsgesetz/EU;8222000;Mannheim;X;398;0;0;0;0;1;1;6;56;62;41;104;33;34;67;95;86;27;13;6;294
725000;Straftaten gegen das Aufenthalts-, das Asylverfahrens- und das Freizügigkeitsgesetz/EU;5170024;Moers;M;11;0;0;0;0;0;0;0;0;0;0;0;0;2;2;3;5;1;0;0;11
725000;Straftaten gegen das Aufenthalts-, das Asylverfahrens- und das Freizügigkeitsgesetz/EU;5170024;Moers;W;1;0;0;0;0;0;0;0;0;0;0;0;0;0;0;0;1;0;0;0;1
725000;Straftaten gegen das Aufenthalts-, das Asylverfahrens- und das Freizügigkeitsgesetz/EU;5170024;Moers;X;12;0;0;0;0;0;0;0;0;0;0;0;0;2;2;3;6;1;0;0;12
725000;Straftaten gegen das Aufenthalts-, das Asylverfahrens- und das Freizügigkeitsgesetz/EU;5116000;Mönchengladbach;M;74;2;0;0;0;0;2;2;11;13;13;28;4;5;9;13;20;4;0;0;46
725000;Straftaten gegen das Aufenthalts-, das Asylverfahrens- und das Freizügigkeitsgesetz/EU;5116000;Mönchengladbach;W;23;1;2;1;1;1;6;1;2;3;2;11;1;1;2;2;5;2;1;0;12
725000;Straftaten gegen das Aufenthalts-, das Asylverfahrens- und das Freizügigkeitsgesetz/EU;5116000;Mönchengladbach;X;97;3;2;1;1;1;8;3;13;16;15;39;5;6;11;15;25;6;1;0;58
725000;Straftaten gegen das Aufenthalts-, das Asylverfahrens- und das Freizügigkeitsgesetz/EU;5117000;Mülheim an der Ruhr;M;13;0;0;0;0;0;0;0;1;1;0;1;2;0;2;8;2;0;0;0;12
725000;Straftaten gegen das Aufenthalts-, das Asylverfahrens- und das Freizügigkeitsgesetz/EU;5117000;Mülheim an der Ruhr;W;4;0;0;0;0;0;0;0;0;0;0;0;2;0;2;2;0;0;0;0;4
725000;Straftaten gegen das Aufenthalts-, das Asylverfahrens- und das Freizügigkeitsgesetz/EU;5117000;Mülheim an der Ruhr;X;17;0;0;0;0;0;0;0;1;1;0;1;4;0;4;10;2;0;0;0;16
725000;Straftaten gegen das Aufenthalts-, das Asylverfahrens- und das Freizügigkeitsgesetz/EU;9162000;München;M;10966;4;0;0;1;5;10;146;937;1083;2101;3194;1102;1214;2316;2343;2134;708;207;64;7772
725000;Straftaten gegen das Aufenthalts-, das Asylverfahrens- und das Freizügigkeitsgesetz/EU;9162000;München;W;2635;6;1;1;0;0;8;9;122;131;394;533;224;264;488;585;669;216;96;48;2102
725000;Straftaten gegen das Aufenthalts-, das Asylverfahrens- und das Freizügigkeitsgesetz/EU;9162000;München;X;13601;10;1;1;1;5;18;155;1059;1214;2495;3727;1326;1478;2804;2928;2803;924;303;112;9874
725000;Straftaten gegen das Aufenthalts-, das Asylverfahrens- und das Freizügigkeitsgesetz/EU;5515000;Münster;M;343;0;0;0;0;2;2;24;59;83;42;127;22;29;51;72;70;19;3;1;216
725000;Straftaten gegen das Aufenthalts-, das Asylverfahrens- und das Freizügigkeitsgesetz/EU;5515000;Münster;W;47;0;0;0;0;1;1;0;3;3;4;8;4;4;8;8;16;4;2;1;39
725000;Straftaten gegen das Aufenthalts-, das Asylverfahrens- und das Freizügigkeitsgesetz/EU;5515000;Münster;X;390;0;0;0;0;3;3;24;62;86;46;135;26;33;59;80;86;23;5;2;255
725000;Straftaten gegen das Aufenthalts-, das Asylverfahrens- und das Freizügigkeitsgesetz/EU;5162024;Neuss;M;32;0;0;0;0;0;0;0;4;4;6;10;1;4;5;7;8;2;0;0;22
725000;Straftaten gegen das Aufenthalts-, das Asylverfahrens- und das Freizügigkeitsgesetz/EU;5162024;Neuss;W;7;0;0;0;0;0;0;0;0;0;0;0;1;1;2;0;2;3;0;0;7
725000;Straftaten gegen das Aufenthalts-, das Asylverfahrens- und das Freizügigkeitsgesetz/EU;5162024;Neuss;X;39;0;0;0;0;0;0;0;4;4;6;10;2;5;7;7;10;5;0;0;29
725000;Straftaten gegen das Aufenthalts-, das Asylverfahrens- und das Freizügigkeitsgesetz/EU;9564000;Nürnberg;M;786;4;1;2;1;8;16;22;41;63;86;165;56;79;135;148;230;72;22;14;621
725000;Straftaten gegen das Aufenthalts-, das Asylverfahrens- und das Freizügigkeitsgesetz/EU;9564000;Nürnberg;W;223;0;0;0;2;4;6;6;11;17;18;41;16;14;30;33;54;31;21;13;182
725000;Straftaten gegen das Aufenthalts-, das Asylverfahrens- und das Freizügigkeitsgesetz/EU;9564000;Nürnberg;X;1009;4;1;2;3;12;22;28;52;80;104;206;72;93;165;181;284;103;43;27;803
725000;Straftaten gegen das Aufenthalts-, das Asylverfahrens- und das Freizügigkeitsgesetz/EU;5119000;Oberhausen;M;60;0;0;0;0;0;0;1;3;4;4;8;5;5;10;9;25;8;0;0;52
725000;Straftaten gegen das Aufenthalts-, das Asylverfahrens- und das Freizügigkeitsgesetz/EU;5119000;Oberhausen;W;24;0;0;0;0;0;0;0;0;0;2;2;3;2;5;7;6;4;0;0;22
725000;Straftaten gegen das Aufenthalts-, das Asylverfahrens- und das Freizügigkeitsgesetz/EU;5119000;Oberhausen;X;84;0;0;0;0;0;0;1;3;4;6;10;8;7;15;16;31;12;0;0;74
725000;Straftaten gegen das Aufenthalts-, das Asylverfahrens- und das Freizügigkeitsgesetz/EU;6413000;Offenbach am Main;M;175;0;0;0;0;0;0;1;6;7;13;20;8;18;26;45;51;25;5;3;155
725000;Straftaten gegen das Aufenthalts-, das Asylverfahrens- und das Freizügigkeitsgesetz/EU;6413000;Offenbach am Main;W;69;0;0;0;0;1;1;0;0;0;1;2;6;11;17;10;19;14;5;2;67
725000;Straftaten gegen das Aufenthalts-, das Asylverfahrens- und das Freizügigkeitsgesetz/EU;6413000;Offenbach am Main;X;244;0;0;0;0;1;1;1;6;7;14;22;14;29;43;55;70;39;10;5;222
725000;Straftaten gegen das Aufenthalts-, das Asylverfahrens- und das Freizügigkeitsgesetz/EU;3403000;Oldenburg (Oldenburg);M;61;1;0;0;0;0;1;1;2;3;12;16;3;2;5;15;17;6;1;1;45
725000;Straftaten gegen das Aufenthalts-, das Asylverfahrens- und das Freizügigkeitsgesetz/EU;3403000;Oldenburg (Oldenburg);W;22;0;0;0;0;0;0;1;1;2;3;5;2;2;4;2;4;5;2;0;17
725000;Straftaten gegen das Aufenthalts-, das Asylverfahrens- und das Freizügigkeitsgesetz/EU;3403000;Oldenburg (Oldenburg);X;83;1;0;0;0;0;1;2;3;5;15;21;5;4;9;17;21;11;3;1;62
725000;Straftaten gegen das Aufenthalts-, das Asylverfahrens- und das Freizügigkeitsgesetz/EU;3404000;Osnabrück;M;138;0;0;0;0;0;0;8;14;22;22;44;8;11;19;27;37;5;3;3;94
725000;Straftaten gegen das Aufenthalts-, das Asylverfahrens- und das Freizügigkeitsgesetz/EU;3404000;Osnabrück;W;16;0;0;0;0;0;0;0;0;0;1;1;0;2;2;4;5;1;3;0;15
725000;Straftaten gegen das Aufenthalts-, das Asylverfahrens- und das Freizügigkeitsgesetz/EU;3404000;Osnabrück;X;154;0;0;0;0;0;0;8;14;22;23;45;8;13;21;31;42;6;6;3;109
725000;Straftaten gegen das Aufenthalts-, das Asylverfahrens- und das Freizügigkeitsgesetz/EU;5774032;Paderborn;M;67;0;0;0;0;0;0;1;5;6;10;16;3;7;10;16;16;6;3;0;51
725000;Straftaten gegen das Aufenthalts-, das Asylverfahrens- und das Freizügigkeitsgesetz/EU;5774032;Paderborn;W;6;0;0;0;0;0;0;0;0;0;0;0;0;1;1;0;4;1;0;0;6
725000;Straftaten gegen das Aufenthalts-, das Asylverfahrens- und das Freizügigkeitsgesetz/EU;5774032;Paderborn;X;73;0;0;0;0;0;0;1;5;6;10;16;3;8;11;16;20;7;3;0;57
725000;Straftaten gegen das Aufenthalts-, das Asylverfahrens- und das Freizügigkeitsgesetz/EU;8231000;Pforzheim;M;20;0;0;0;0;0;0;0;1;1;0;1;4;3;7;4;3;5;0;0;19
725000;Straftaten gegen das Aufenthalts-, das Asylverfahrens- und das Freizügigkeitsgesetz/EU;8231000;Pforzheim;W;3;0;0;0;0;0;0;0;0;0;0;0;0;0;0;1;1;1;0;0;3
725000;Straftaten gegen das Aufenthalts-, das Asylverfahrens- und das Freizügigkeitsgesetz/EU;8231000;Pforzheim;X;23;0;0;0;0;0;0;0;1;1;0;1;4;3;7;5;4;6;0;0;22
725000;Straftaten gegen das Aufenthalts-, das Asylverfahrens- und das Freizügigkeitsgesetz/EU;12054000;Potsdam;M;27;0;0;0;0;0;0;1;1;2;1;3;3;1;4;4;11;2;2;1;24
725000;Straftaten gegen das Aufenthalts-, das Asylverfahrens- und das Freizügigkeitsgesetz/EU;12054000;Potsdam;W;6;0;1;0;0;0;1;0;0;0;0;1;0;0;0;0;3;1;1;0;5
725000;Straftaten gegen das Aufenthalts-, das Asylverfahrens- und das Freizügigkeitsgesetz/EU;12054000;Potsdam;X;33;0;1;0;0;0;1;1;1;2;1;4;3;1;4;4;14;3;3;1;29
725000;Straftaten gegen das Aufenthalts-, das Asylverfahrens- und das Freizügigkeitsgesetz/EU;5562032;Recklinghausen;M;15;0;0;0;0;0;0;0;1;1;0;1;4;3;7;2;3;1;1;0;14
725000;Straftaten gegen das Aufenthalts-, das Asylverfahrens- und das Freizügigkeitsgesetz/EU;5562032;Recklinghausen;W;2;0;0;0;0;0;0;0;0;0;1;1;0;0;0;1;0;0;0;0;1
725000;Straftaten gegen das Aufenthalts-, das Asylverfahrens- und das Freizügigkeitsgesetz/EU;5562032;Recklinghausen;X;17;0;0;0;0;0;0;0;1;1;1;2;4;3;7;3;3;1;1;0;15
725000;Straftaten gegen das Aufenthalts-, das Asylverfahrens- und das Freizügigkeitsgesetz/EU;9362000;Regensburg;M;227;2;3;0;1;1;7;10;22;32;20;59;18;17;35;48;56;17;9;3;168
725000;Straftaten gegen das Aufenthalts-, das Asylverfahrens- und das Freizügigkeitsgesetz/EU;9362000;Regensburg;W;59;3;0;1;1;1;6;3;2;5;3;14;1;3;4;13;14;9;2;3;45
725000;Straftaten gegen das Aufenthalts-, das Asylverfahrens- und das Freizügigkeitsgesetz/EU;9362000;Regensburg;X;286;5;3;1;2;2;13;13;24;37;23;73;19;20;39;61;70;26;11;6;213
725000;Straftaten gegen das Aufenthalts-, das Asylverfahrens- und das Freizügigkeitsgesetz/EU;5120000;Remscheid;M;4;0;0;0;0;0;0;0;0;0;1;1;0;0;0;1;1;0;0;1;3
725000;Straftaten gegen das Aufenthalts-, das Asylverfahrens- und das Freizügigkeitsgesetz/EU;5120000;Remscheid;W;0;0;0;0;0;0;0;0;0;0;0;0;0;0;0;0;0;0;0;0;0
725000;Straftaten gegen das Aufenthalts-, das Asylverfahrens- und das Freizügigkeitsgesetz/EU;5120000;Remscheid;X;4;0;0;0;0;0;0;0;0;0;1;1;0;0;0;1;1;0;0;1;3
725000;Straftaten gegen das Aufenthalts-, das Asylverfahrens- und das Freizügigkeitsgesetz/EU;8415061;Reutlingen;M;20;0;0;0;0;0;0;3;1;4;2;6;2;3;5;2;6;1;0;0;14
725000;Straftaten gegen das Aufenthalts-, das Asylverfahrens- und das Freizügigkeitsgesetz/EU;8415061;Reutlingen;W;11;0;0;0;0;1;1;1;1;2;0;3;0;0;0;1;4;3;0;0;8
725000;Straftaten gegen das Aufenthalts-, das Asylverfahrens- und das Freizügigkeitsgesetz/EU;8415061;Reutlingen;X;31;0;0;0;0;1;1;4;2;6;2;9;2;3;5;3;10;4;0;0;22
725000;Straftaten gegen das Aufenthalts-, das Asylverfahrens- und das Freizügigkeitsgesetz/EU;13003000;Rostock;M;471;14;3;3;2;4;26;9;20;29;29;84;35;28;63;101;142;52;23;6;387
725000;Straftaten gegen das Aufenthalts-, das Asylverfahrens- und das Freizügigkeitsgesetz/EU;13003000;Rostock;W;144;20;2;5;4;4;35;4;4;8;6;49;6;8;14;17;31;14;13;6;95
725000;Straftaten gegen das Aufenthalts-, das Asylverfahrens- und das Freizügigkeitsgesetz/EU;13003000;Rostock;X;615;34;5;8;6;8;61;13;24;37;35;133;41;36;77;118;173;66;36;12;482
725000;Straftaten gegen das Aufenthalts-, das Asylverfahrens- und das Freizügigkeitsgesetz/EU;10041100;Saarbrücken;M;1931;11;7;10;14;14;56;87;283;370;318;744;195;226;421;407;284;64;10;1;1187
725000;Straftaten gegen das Aufenthalts-, das Asylverfahrens- und das Freizügigkeitsgesetz/EU;10041100;Saarbrücken;W;363;2;7;8;5;6;28;12;29;41;63;132;31;50;81;65;54;21;8;2;231
725000;Straftaten gegen das Aufenthalts-, das Asylverfahrens- und das Freizügigkeitsgesetz/EU;10041100;Saarbrücken;X;2294;13;14;18;19;20;84;99;312;411;381;876;226;276;502;472;338;85;18;3;1418
725000;Straftaten gegen das Aufenthalts-, das Asylverfahrens- und das Freizügigkeitsgesetz/EU;5122000;Solingen;M;7;0;0;0;0;0;0;0;0;0;0;0;0;1;1;4;1;1;0;0;7
725000;Straftaten gegen das Aufenthalts-, das Asylverfahrens- und das Freizügigkeitsgesetz/EU;5122000;Solingen;W;3;0;0;0;0;0;0;0;0;0;0;0;0;0;0;1;1;1;0;0;3
725000;Straftaten gegen das Aufenthalts-, das Asylverfahrens- und das Freizügigkeitsgesetz/EU;5122000;Solingen;X;10;0;0;0;0;0;0;0;0;0;0;0;0;1;1;5;2;2;0;0;10
725000;Straftaten gegen das Aufenthalts-, das Asylverfahrens- und das Freizügigkeitsgesetz/EU;8111000;Stuttgart;M;1572;7;5;3;4;7;26;64;167;231;206;463;133;140;273;312;337;131;46;10;1109
725000;Straftaten gegen das Aufenthalts-, das Asylverfahrens- und das Freizügigkeitsgesetz/EU;8111000;Stuttgart;W;333;5;4;1;1;1;12;11;20;31;30;73;21;28;49;68;79;41;16;7;260
725000;Straftaten gegen das Aufenthalts-, das Asylverfahrens- und das Freizügigkeitsgesetz/EU;8111000;Stuttgart;X;1905;12;9;4;5;8;38;75;187;262;236;536;154;168;322;380;416;172;62;17;1369
725000;Straftaten gegen das Aufenthalts-, das Asylverfahrens- und das Freizügigkeitsgesetz/EU;7211000;Trier;M;4267;0;0;0;0;0;0;72;140;212;520;732;337;384;721;899;1171;489;200;55;3535
725000;Straftaten gegen das Aufenthalts-, das Asylverfahrens- und das Freizügigkeitsgesetz/EU;7211000;Trier;W;2164;0;0;0;0;0;0;55;70;125;201;326;141;146;287;424;627;279;146;75;1838
725000;Straftaten gegen das Aufenthalts-, das Asylverfahrens- und das Freizügigkeitsgesetz/EU;7211000;Trier;X;6431;0;0;0;0;0;0;127;210;337;721;1058;478;530;1008;1323;1798;768;346;130;5373
725000;Straftaten gegen das Aufenthalts-, das Asylverfahrens- und das Freizügigkeitsgesetz/EU;8421000;Ulm;M;370;0;0;0;1;2;3;13;52;65;64;132;31;38;69;70;76;17;5;1;238
725000;Straftaten gegen das Aufenthalts-, das Asylverfahrens- und das Freizügigkeitsgesetz/EU;8421000;Ulm;W;94;2;2;0;1;1;6;2;5;7;17;30;12;3;15;23;16;8;2;0;64
725000;Straftaten gegen das Aufenthalts-, das Asylverfahrens- und das Freizügigkeitsgesetz/EU;8421000;Ulm;X;464;2;2;0;2;3;9;15;57;72;81;162;43;41;84;93;92;25;7;1;302
725000;Straftaten gegen das Aufenthalts-, das Asylverfahrens- und das Freizügigkeitsgesetz/EU;6414000;Wiesbaden;M;153;0;1;0;0;0;1;8;36;44;7;52;4;9;13;34;30;16;6;2;101
725000;Straftaten gegen das Aufenthalts-, das Asylverfahrens- und das Freizügigkeitsgesetz/EU;6414000;Wiesbaden;W;58;0;0;0;0;1;1;2;5;7;2;10;3;3;6;5;18;15;3;1;48
725000;Straftaten gegen das Aufenthalts-, das Asylverfahrens- und das Freizügigkeitsgesetz/EU;6414000;Wiesbaden;X;211;0;1;0;0;1;2;10;41;51;9;62;7;12;19;39;48;31;9;3;149
725000;Straftaten gegen das Aufenthalts-, das Asylverfahrens- und das Freizügigkeitsgesetz/EU;3103000;Wolfsburg;M;33;0;0;0;0;0;0;0;1;1;2;3;2;3;5;5;16;4;0;0;30
725000;Straftaten gegen das Aufenthalts-, das Asylverfahrens- und das Freizügigkeitsgesetz/EU;3103000;Wolfsburg;W;8;0;0;0;0;0;0;0;0;0;0;0;1;0;1;2;4;1;0;0;8
725000;Straftaten gegen das Aufenthalts-, das Asylverfahrens- und das Freizügigkeitsgesetz/EU;3103000;Wolfsburg;X;41;0;0;0;0;0;0;0;1;1;2;3;3;3;6;7;20;5;0;0;38
725000;Straftaten gegen das Aufenthalts-, das Asylverfahrens- und das Freizügigkeitsgesetz/EU;5124000;Wuppertal;M;108;0;0;0;0;0;0;3;16;19;14;33;4;8;12;23;23;10;6;1;75
725000;Straftaten gegen das Aufenthalts-, das Asylverfahrens- und das Freizügigkeitsgesetz/EU;5124000;Wuppertal;W;14;0;0;0;0;0;0;1;0;1;2;3;1;3;4;2;2;2;1;0;11
725000;Straftaten gegen das Aufenthalts-, das Asylverfahrens- und das Freizügigkeitsgesetz/EU;5124000;Wuppertal;X;122;0;0;0;0;0;0;4;16;20;16;36;5;11;16;25;25;12;7;1;86
725000;Straftaten gegen das Aufenthalts-, das Asylverfahrens- und das Freizügigkeitsgesetz/EU;9663000;Würzburg;M;1091;5;0;1;0;3;9;40;99;139;147;295;104;111;215;235;252;74;15;5;796
725000;Straftaten gegen das Aufenthalts-, das Asylverfahrens- und das Freizügigkeitsgesetz/EU;9663000;Würzburg;W;195;0;0;0;0;0;0;11;11;22;28;50;15;34;49;45;27;17;2;5;145
725000;Straftaten gegen das Aufenthalts-, das Asylverfahrens- und das Freizügigkeitsgesetz/EU;9663000;Würzburg;X;1286;5;0;1;0;3;9;51;110;161;175;345;119;145;264;280;279;91;17;10;941
730000;Rauschgiftdelikte (soweit nicht bereits mit anderer Schlüsselzahl erfasst);5334002;Aachen;M;1255;2;0;0;0;2;4;21;73;94;228;326;142;115;257;227;273;128;39;5;929
730000;Rauschgiftdelikte (soweit nicht bereits mit anderer Schlüsselzahl erfasst);5334002;Aachen;W;143;0;0;0;0;0;0;7;14;21;14;35;11;10;21;18;32;30;6;1;108
730000;Rauschgiftdelikte (soweit nicht bereits mit anderer Schlüsselzahl erfasst);5334002;Aachen;X;1398;2;0;0;0;2;4;28;87;115;242;361;153;125;278;245;305;158;45;6;1037
730000;Rauschgiftdelikte (soweit nicht bereits mit anderer Schlüsselzahl erfasst);9761000;Augsburg;M;1130;0;0;0;0;4;4;45;101;146;184;334;121;99;220;207;267;79;22;1;796
730000;Rauschgiftdelikte (soweit nicht bereits mit anderer Schlüsselzahl erfasst);9761000;Augsburg;W;189;0;0;0;0;2;2;8;16;24;30;56;12;23;35;43;41;11;3;0;133
730000;Rauschgiftdelikte (soweit nicht bereits mit anderer Schlüsselzahl erfasst);9761000;Augsburg;X;1319;0;0;0;0;6;6;53;117;170;214;390;133;122;255;250;308;90;25;1;929
730000;Rauschgiftdelikte (soweit nicht bereits mit anderer Schlüsselzahl erfasst);5378004;Bergisch Gladbach;M;167;0;0;0;0;1;1;8;19;27;36;64;19;9;28;33;26;13;3;0;103
730000;Rauschgiftdelikte (soweit nicht bereits mit anderer Schlüsselzahl erfasst);5378004;Bergisch Gladbach;W;10;0;0;0;0;0;0;0;2;2;0;2;0;0;0;2;2;4;0;0;8
730000;Rauschgiftdelikte (soweit nicht bereits mit anderer Schlüsselzahl erfasst);5378004;Bergisch Gladbach;X;177;0;0;0;0;1;1;8;21;29;36;66;19;9;28;35;28;17;3;0;111
730000;Rauschgiftdelikte (soweit nicht bereits mit anderer Schlüsselzahl erfasst);11000000;Berlin;M;9338;0;0;0;0;25;25;195;593;788;1196;2009;822;841;1663;1828;2451;1003;330;54;7329
730000;Rauschgiftdelikte (soweit nicht bereits mit anderer Schlüsselzahl erfasst);11000000;Berlin;W;1090;0;0;0;0;9;9;52;65;117;110;236;77;89;166;224;256;152;44;12;854
730000;Rauschgiftdelikte (soweit nicht bereits mit anderer Schlüsselzahl erfasst);11000000;Berlin;X;10428;0;0;0;0;34;34;247;658;905;1306;2245;899;930;1829;2052;2707;1155;374;66;8183
730000;Rauschgiftdelikte (soweit nicht bereits mit anderer Schlüsselzahl erfasst);5711000;Bielefeld;M;709;0;0;0;0;0;0;24;42;66;86;152;74;65;139;131;183;82;19;3;557
730000;Rauschgiftdelikte (soweit nicht bereits mit anderer Schlüsselzahl erfasst);5711000;Bielefeld;W;70;0;0;0;0;1;1;10;4;14;7;22;4;5;9;9;18;8;4;0;48
730000;Rauschgiftdelikte (soweit nicht bereits mit anderer Schlüsselzahl erfasst);5711000;Bielefeld;X;779;0;0;0;0;1;1;34;46;80;93;174;78;70;148;140;201;90;23;3;605
730000;Rauschgiftdelikte (soweit nicht bereits mit anderer Schlüsselzahl erfasst);5911000;Bochum;M;925;0;0;0;0;0;0;18;82;100;181;281;95;88;183;180;183;73;22;3;644
730000;Rauschgiftdelikte (soweit nicht bereits mit anderer Schlüsselzahl erfasst);5911000;Bochum;W;104;0;0;0;0;1;1;10;6;16;14;31;9;8;17;16;23;11;6;0;73
730000;Rauschgiftdelikte (soweit nicht bereits mit anderer Schlüsselzahl erfasst);5911000;Bochum;X;1029;0;0;0;0;1;1;28;88;116;195;312;104;96;200;196;206;84;28;3;717
730000;Rauschgiftdelikte (soweit nicht bereits mit anderer Schlüsselzahl erfasst);5314000;Bonn;M;975;0;0;0;1;5;6;29;80;109;147;262;103;68;171;153;226;126;33;4;713
730000;Rauschgiftdelikte (soweit nicht bereits mit anderer Schlüsselzahl erfasst);5314000;Bonn;W;131;0;0;0;0;0;0;9;16;25;14;39;6;4;10;19;39;16;6;2;92
730000;Rauschgiftdelikte (soweit nicht bereits mit anderer Schlüsselzahl erfasst);5314000;Bonn;X;1106;0;0;0;1;5;6;38;96;134;161;301;109;72;181;172;265;142;39;6;805
730000;Rauschgiftdelikte (soweit nicht bereits mit anderer Schlüsselzahl erfasst);5512000;Bottrop;M;258;0;0;0;0;1;1;4;15;19;19;39;23;22;45;54;67;44;6;3;219
730000;Rauschgiftdelikte (soweit nicht bereits mit anderer Schlüsselzahl erfasst);5512000;Bottrop;W;23;0;0;0;0;0;0;0;2;2;1;3;2;3;5;2;10;3;0;0;20
730000;Rauschgiftdelikte (soweit nicht bereits mit anderer Schlüsselzahl erfasst);5512000;Bottrop;X;281;0;0;0;0;1;1;4;17;21;20;42;25;25;50;56;77;47;6;3;239
730000;Rauschgiftdelikte (soweit nicht bereits mit anderer Schlüsselzahl erfasst);3101000;Braunschweig;M;1067;0;0;0;0;2;2;32;135;167;163;332;113;81;194;196;218;97;26;4;735
730000;Rauschgiftdelikte (soweit nicht bereits mit anderer Schlüsselzahl erfasst);3101000;Braunschweig;W;153;0;0;0;0;1;1;17;19;36;23;60;15;13;28;23;26;13;2;1;93
730000;Rauschgiftdelikte (soweit nicht bereits mit anderer Schlüsselzahl erfasst);3101000;Braunschweig;X;1220;0;0;0;0;3;3;49;154;203;186;392;128;94;222;219;244;110;28;5;828
730000;Rauschgiftdelikte (soweit nicht bereits mit anderer Schlüsselzahl erfasst);4011000;Bremen;M;2324;0;0;0;0;2;2;41;217;258;375;635;240;209;449;446;494;206;78;16;1689
730000;Rauschgiftdelikte (soweit nicht bereits mit anderer Schlüsselzahl erfasst);4011000;Bremen;W;203;0;0;0;0;0;0;7;22;29;25;54;14;19;33;38;35;28;14;1;149
730000;Rauschgiftdelikte (soweit nicht bereits mit anderer Schlüsselzahl erfasst);4011000;Bremen;X;2527;0;0;0;0;2;2;48;239;287;400;689;254;228;482;484;529;234;92;17;1838
730000;Rauschgiftdelikte (soweit nicht bereits mit anderer Schlüsselzahl erfasst);4012000;Bremerhaven;M;410;0;0;0;1;0;1;7;34;41;78;120;52;36;88;71;77;41;11;2;290
730000;Rauschgiftdelikte (soweit nicht bereits mit anderer Schlüsselzahl erfasst);4012000;Bremerhaven;W;49;0;0;0;0;0;0;3;3;6;3;9;7;4;11;4;8;10;7;0;40
730000;Rauschgiftdelikte (soweit nicht bereits mit anderer Schlüsselzahl erfasst);4012000;Bremerhaven;X;459;0;0;0;1;0;1;10;37;47;81;129;59;40;99;75;85;51;18;2;330
730000;Rauschgiftdelikte (soweit nicht bereits mit anderer Schlüsselzahl erfasst);14511000;Chemnitz;M;572;0;0;0;0;2;2;23;47;70;60;132;46;49;95;145;155;37;7;1;440
730000;Rauschgiftdelikte (soweit nicht bereits mit anderer Schlüsselzahl erfasst);14511000;Chemnitz;W;158;0;0;0;0;0;0;10;10;20;15;35;8;18;26;37;53;4;3;0;123
730000;Rauschgiftdelikte (soweit nicht bereits mit anderer Schlüsselzahl erfasst);14511000;Chemnitz;X;730;0;0;0;0;2;2;33;57;90;75;167;54;67;121;182;208;41;10;1;563
730000;Rauschgiftdelikte (soweit nicht bereits mit anderer Schlüsselzahl erfasst);6411000;Darmstadt;M;488;0;0;0;0;1;1;14;39;53;75;129;50;38;88;87;108;46;26;4;359
730000;Rauschgiftdelikte (soweit nicht bereits mit anderer Schlüsselzahl erfasst);6411000;Darmstadt;W;65;0;0;0;0;0;0;4;4;8;4;12;4;4;8;6;15;19;3;2;53
730000;Rauschgiftdelikte (soweit nicht bereits mit anderer Schlüsselzahl erfasst);6411000;Darmstadt;X;553;0;0;0;0;1;1;18;43;61;79;141;54;42;96;93;123;65;29;6;412
730000;Rauschgiftdelikte (soweit nicht bereits mit anderer Schlüsselzahl erfasst);5913000;Dortmund;M;2414;0;0;0;2;8;10;62;187;249;420;679;250;236;486;466;533;188;52;10;1735
730000;Rauschgiftdelikte (soweit nicht bereits mit anderer Schlüsselzahl erfasst);5913000;Dortmund;W;214;0;0;0;1;1;2;10;23;33;23;58;15;24;39;45;42;21;9;0;156
730000;Rauschgiftdelikte (soweit nicht bereits mit anderer Schlüsselzahl erfasst);5913000;Dortmund;X;2628;0;0;0;3;9;12;72;210;282;443;737;265;260;525;511;575;209;61;10;1891
730000;Rauschgiftdelikte (soweit nicht bereits mit anderer Schlüsselzahl erfasst);14612000;Dresden;M;1280;0;0;0;2;0;2;19;68;87;119;208;88;103;191;360;428;79;13;1;1072
730000;Rauschgiftdelikte (soweit nicht bereits mit anderer Schlüsselzahl erfasst);14612000;Dresden;W;202;0;0;0;0;0;0;17;16;33;20;53;11;25;36;50;53;9;1;0;149
730000;Rauschgiftdelikte (soweit nicht bereits mit anderer Schlüsselzahl erfasst);14612000;Dresden;X;1482;0;0;0;2;0;2;36;84;120;139;261;99;128;227;410;481;88;14;1;1221
730000;Rauschgiftdelikte (soweit nicht bereits mit anderer Schlüsselzahl erfasst);5112000;Duisburg;M;1471;0;0;0;0;4;4;40;67;107;173;284;148;152;300;298;404;147;34;4;1187
730000;Rauschgiftdelikte (soweit nicht bereits mit anderer Schlüsselzahl erfasst);5112000;Duisburg;W;148;0;0;0;0;0;0;8;11;19;18;37;15;12;27;23;32;21;6;2;111
730000;Rauschgiftdelikte (soweit nicht bereits mit anderer Schlüsselzahl erfasst);5112000;Duisburg;X;1619;0;0;0;0;4;4;48;78;126;191;321;163;164;327;321;436;168;40;6;1298
730000;Rauschgiftdelikte (soweit nicht bereits mit anderer Schlüsselzahl erfasst);5111000;Düsseldorf;M;2336;0;0;0;0;5;5;57;142;199;297;501;206;197;403;473;594;267;84;14;1835
730000;Rauschgiftdelikte (soweit nicht bereits mit anderer Schlüsselzahl erfasst);5111000;Düsseldorf;W;281;0;0;0;0;2;2;10;19;29;32;63;27;13;40;46;67;43;19;3;218
730000;Rauschgiftdelikte (soweit nicht bereits mit anderer Schlüsselzahl erfasst);5111000;Düsseldorf;X;2617;0;0;0;0;7;7;67;161;228;329;564;233;210;443;519;661;310;103;17;2053
730000;Rauschgiftdelikte (soweit nicht bereits mit anderer Schlüsselzahl erfasst);16051000;Erfurt;M;764;0;0;0;0;1;1;6;39;45;72;118;50;79;129;217;262;35;3;0;646
730000;Rauschgiftdelikte (soweit nicht bereits mit anderer Schlüsselzahl erfasst);16051000;Erfurt;W;149;0;0;0;0;0;0;5;10;15;14;29;17;16;33;47;35;4;0;1;120
730000;Rauschgiftdelikte (soweit nicht bereits mit anderer Schlüsselzahl erfasst);16051000;Erfurt;X;913;0;0;0;0;1;1;11;49;60;86;147;67;95;162;264;297;39;3;1;766
730000;Rauschgiftdelikte (soweit nicht bereits mit anderer Schlüsselzahl erfasst);9562000;Erlangen;M;279;0;0;0;0;1;1;13;28;41;72;114;32;17;49;47;47;17;4;1;165
730000;Rauschgiftdelikte (soweit nicht bereits mit anderer Schlüsselzahl erfasst);9562000;Erlangen;W;25;0;0;0;0;0;0;0;3;3;2;5;3;1;4;8;7;1;0;0;20
730000;Rauschgiftdelikte (soweit nicht bereits mit anderer Schlüsselzahl erfasst);9562000;Erlangen;X;304;0;0;0;0;1;1;13;31;44;74;119;35;18;53;55;54;18;4;1;185
730000;Rauschgiftdelikte (soweit nicht bereits mit anderer Schlüsselzahl erfasst);5113000;Essen;M;1119;0;0;0;0;3;3;32;75;107;160;270;115;107;222;227;247;119;32;2;849
730000;Rauschgiftdelikte (soweit nicht bereits mit anderer Schlüsselzahl erfasst);5113000;Essen;W;139;0;0;0;0;2;2;9;13;22;15;39;13;8;21;25;27;17;10;0;100
730000;Rauschgiftdelikte (soweit nicht bereits mit anderer Schlüsselzahl erfasst);5113000;Essen;X;1258;0;0;0;0;5;5;41;88;129;175;309;128;115;243;252;274;136;42;2;949
730000;Rauschgiftdelikte (soweit nicht bereits mit anderer Schlüsselzahl erfasst);6412000;Frankfurt am Main;M;3620;0;0;0;0;2;2;42;138;180;428;610;305;308;613;664;1020;525;157;31;3010
730000;Rauschgiftdelikte (soweit nicht bereits mit anderer Schlüsselzahl erfasst);6412000;Frankfurt am Main;W;486;0;0;0;0;0;0;4;21;25;44;69;35;23;58;73;156;95;32;3;417
730000;Rauschgiftdelikte (soweit nicht bereits mit anderer Schlüsselzahl erfasst);6412000;Frankfurt am Main;X;4106;0;0;0;0;2;2;46;159;205;472;679;340;331;671;737;1176;620;189;34;3427
730000;Rauschgiftdelikte (soweit nicht bereits mit anderer Schlüsselzahl erfasst);8311000;Freiburg im Breisgau;M;1172;0;0;0;0;0;0;46;137;183;189;372;106;104;210;200;227;120;35;8;800
730000;Rauschgiftdelikte (soweit nicht bereits mit anderer Schlüsselzahl erfasst);8311000;Freiburg im Breisgau;W;156;0;0;0;0;0;0;12;22;34;27;61;8;14;22;19;29;17;7;1;95
730000;Rauschgiftdelikte (soweit nicht bereits mit anderer Schlüsselzahl erfasst);8311000;Freiburg im Breisgau;X;1328;0;0;0;0;0;0;58;159;217;216;433;114;118;232;219;256;137;42;9;895
730000;Rauschgiftdelikte (soweit nicht bereits mit anderer Schlüsselzahl erfasst);9563000;Fürth;M;318;0;0;0;0;2;2;10;20;30;58;90;33;33;66;65;58;31;6;2;228
730000;Rauschgiftdelikte (soweit nicht bereits mit anderer Schlüsselzahl erfasst);9563000;Fürth;W;44;0;0;0;0;0;0;2;3;5;7;12;2;3;5;7;9;8;2;1;32
730000;Rauschgiftdelikte (soweit nicht bereits mit anderer Schlüsselzahl erfasst);9563000;Fürth;X;362;0;0;0;0;2;2;12;23;35;65;102;35;36;71;72;67;39;8;3;260
730000;Rauschgiftdelikte (soweit nicht bereits mit anderer Schlüsselzahl erfasst);5513000;Gelsenkirchen;M;498;0;0;0;0;2;2;5;27;32;75;109;61;42;103;99;109;56;20;2;389
730000;Rauschgiftdelikte (soweit nicht bereits mit anderer Schlüsselzahl erfasst);5513000;Gelsenkirchen;W;74;0;0;0;0;3;3;6;3;9;1;13;7;7;14;12;14;15;5;1;61
730000;Rauschgiftdelikte (soweit nicht bereits mit anderer Schlüsselzahl erfasst);5513000;Gelsenkirchen;X;572;0;0;0;0;5;5;11;30;41;76;122;68;49;117;111;123;71;25;3;450
730000;Rauschgiftdelikte (soweit nicht bereits mit anderer Schlüsselzahl erfasst);3152012;Göttingen;M;480;0;0;0;0;0;0;25;37;62;72;134;37;47;84;83;112;47;16;4;346
730000;Rauschgiftdelikte (soweit nicht bereits mit anderer Schlüsselzahl erfasst);3152012;Göttingen;W;80;0;0;0;0;0;0;5;7;12;16;28;2;6;8;17;16;7;4;0;52
730000;Rauschgiftdelikte (soweit nicht bereits mit anderer Schlüsselzahl erfasst);3152012;Göttingen;X;560;0;0;0;0;0;0;30;44;74;88;162;39;53;92;100;128;54;20;4;398
730000;Rauschgiftdelikte (soweit nicht bereits mit anderer Schlüsselzahl erfasst);5914000;Hagen;M;714;0;0;0;0;0;0;16;51;67;132;199;67;77;144;141;158;52;18;2;515
730000;Rauschgiftdelikte (soweit nicht bereits mit anderer Schlüsselzahl erfasst);5914000;Hagen;W;72;0;0;0;0;0;0;13;9;22;12;34;7;3;10;9;8;8;3;0;38
730000;Rauschgiftdelikte (soweit nicht bereits mit anderer Schlüsselzahl erfasst);5914000;Hagen;X;786;0;0;0;0;0;0;29;60;89;144;233;74;80;154;150;166;60;21;2;553
730000;Rauschgiftdelikte (soweit nicht bereits mit anderer Schlüsselzahl erfasst);15002000;Halle (Saale);M;584;0;0;0;1;4;5;25;28;53;46;104;32;54;86;148;205;36;5;0;480
730000;Rauschgiftdelikte (soweit nicht bereits mit anderer Schlüsselzahl erfasst);15002000;Halle (Saale);W;126;0;0;0;0;2;2;12;10;22;6;30;8;12;20;36;32;7;1;0;96
730000;Rauschgiftdelikte (soweit nicht bereits mit anderer Schlüsselzahl erfasst);15002000;Halle (Saale);X;710;0;0;0;1;6;7;37;38;75;52;134;40;66;106;184;237;43;6;0;576
730000;Rauschgiftdelikte (soweit nicht bereits mit anderer Schlüsselzahl erfasst);2000000;Hamburg;M;6014;0;0;0;1;17;18;182;513;695;917;1630;473;455;928;1053;1410;744;207;42;4384
730000;Rauschgiftdelikte (soweit nicht bereits mit anderer Schlüsselzahl erfasst);2000000;Hamburg;W;692;0;0;0;0;6;6;34;72;106;67;179;38;41;79;113;183;100;34;4;513
730000;Rauschgiftdelikte (soweit nicht bereits mit anderer Schlüsselzahl erfasst);2000000;Hamburg;X;6706;0;0;0;1;23;24;216;585;801;984;1809;511;496;1007;1166;1593;844;241;46;4897
730000;Rauschgiftdelikte (soweit nicht bereits mit anderer Schlüsselzahl erfasst);5915000;Hamm;M;517;0;0;0;0;0;0;6;28;34;64;98;57;56;113;113;134;47;11;1;419
730000;Rauschgiftdelikte (soweit nicht bereits mit anderer Schlüsselzahl erfasst);5915000;Hamm;W;59;0;0;0;0;0;0;2;4;6;8;14;7;5;12;9;17;5;1;1;45
730000;Rauschgiftdelikte (soweit nicht bereits mit anderer Schlüsselzahl erfasst);5915000;Hamm;X;576;0;0;0;0;0;0;8;32;40;72;112;64;61;125;122;151;52;12;2;464
730000;Rauschgiftdelikte (soweit nicht bereits mit anderer Schlüsselzahl erfasst);3241001;Hannover;M;3538;0;0;0;0;7;7;71;215;286;550;843;395;323;718;672;870;323;89;23;2695
730000;Rauschgiftdelikte (soweit nicht bereits mit anderer Schlüsselzahl erfasst);3241001;Hannover;W;455;0;0;0;0;1;1;25;62;87;75;163;44;30;74;68;89;39;18;4;292
730000;Rauschgiftdelikte (soweit nicht bereits mit anderer Schlüsselzahl erfasst);3241001;Hannover;X;3993;0;0;0;0;8;8;96;277;373;625;1006;439;353;792;740;959;362;107;27;2987
730000;Rauschgiftdelikte (soweit nicht bereits mit anderer Schlüsselzahl erfasst);8221000;Heidelberg;M;722;0;0;0;0;7;7;38;86;124;178;309;103;73;176;110;90;26;8;3;413
730000;Rauschgiftdelikte (soweit nicht bereits mit anderer Schlüsselzahl erfasst);8221000;Heidelberg;W;91;0;0;0;0;0;0;6;14;20;23;43;9;8;17;15;10;5;1;0;48
730000;Rauschgiftdelikte (soweit nicht bereits mit anderer Schlüsselzahl erfasst);8221000;Heidelberg;X;813;0;0;0;0;7;7;44;100;144;201;352;112;81;193;125;100;31;9;3;461
730000;Rauschgiftdelikte (soweit nicht bereits mit anderer Schlüsselzahl erfasst);8121000;Heilbronn;M;585;0;0;0;0;0;0;12;59;71;127;198;62;48;110;115;116;37;8;1;387
730000;Rauschgiftdelikte (soweit nicht bereits mit anderer Schlüsselzahl erfasst);8121000;Heilbronn;W;84;0;0;0;0;0;0;4;14;18;16;34;12;8;20;12;7;7;4;0;50
730000;Rauschgiftdelikte (soweit nicht bereits mit anderer Schlüsselzahl erfasst);8121000;Heilbronn;X;669;0;0;0;0;0;0;16;73;89;143;232;74;56;130;127;123;44;12;1;437
730000;Rauschgiftdelikte (soweit nicht bereits mit anderer Schlüsselzahl erfasst);5916000;Herne;M;360;0;0;0;0;2;2;15;38;53;58;113;29;27;56;75;83;31;2;0;247
730000;Rauschgiftdelikte (soweit nicht bereits mit anderer Schlüsselzahl erfasst);5916000;Herne;W;29;0;0;0;0;0;0;3;2;5;2;7;3;5;8;3;9;2;0;0;22
730000;Rauschgiftdelikte (soweit nicht bereits mit anderer Schlüsselzahl erfasst);5916000;Herne;X;389;0;0;0;0;2;2;18;40;58;60;120;32;32;64;78;92;33;2;0;269
730000;Rauschgiftdelikte (soweit nicht bereits mit anderer Schlüsselzahl erfasst);9161000;Ingolstadt;M;462;0;0;0;0;1;1;15;48;63;80;144;61;39;100;99;95;21;2;1;318
730000;Rauschgiftdelikte (soweit nicht bereits mit anderer Schlüsselzahl erfasst);9161000;Ingolstadt;W;74;0;0;0;0;1;1;5;6;11;12;24;9;7;16;14;16;4;0;0;50
730000;Rauschgiftdelikte (soweit nicht bereits mit anderer Schlüsselzahl erfasst);9161000;Ingolstadt;X;536;0;0;0;0;2;2;20;54;74;92;168;70;46;116;113;111;25;2;1;368
730000;Rauschgiftdelikte (soweit nicht bereits mit anderer Schlüsselzahl erfasst);16053000;Jena;M;258;0;0;0;0;0;0;5;9;14;28;42;20;31;51;76;70;19;0;0;216
730000;Rauschgiftdelikte (soweit nicht bereits mit anderer Schlüsselzahl erfasst);16053000;Jena;W;39;0;0;0;0;0;0;2;0;2;4;6;5;3;8;13;10;2;0;0;33
730000;Rauschgiftdelikte (soweit nicht bereits mit anderer Schlüsselzahl erfasst);16053000;Jena;X;297;0;0;0;0;0;0;7;9;16;32;48;25;34;59;89;80;21;0;0;249
730000;Rauschgiftdelikte (soweit nicht bereits mit anderer Schlüsselzahl erfasst);8212000;Karlsruhe;M;1148;0;0;0;0;4;4;31;84;115;224;343;122;115;237;208;229;94;32;5;805
730000;Rauschgiftdelikte (soweit nicht bereits mit anderer Schlüsselzahl erfasst);8212000;Karlsruhe;W;130;0;0;0;0;0;0;5;11;16;25;41;7;10;17;14;39;14;5;0;89
730000;Rauschgiftdelikte (soweit nicht bereits mit anderer Schlüsselzahl erfasst);8212000;Karlsruhe;X;1278;0;0;0;0;4;4;36;95;131;249;384;129;125;254;222;268;108;37;5;894
730000;Rauschgiftdelikte (soweit nicht bereits mit anderer Schlüsselzahl erfasst);6611000;Kassel;M;826;0;0;0;0;3;3;16;40;56;106;165;72;72;144;163;207;110;34;3;661
730000;Rauschgiftdelikte (soweit nicht bereits mit anderer Schlüsselzahl erfasst);6611000;Kassel;W;114;0;0;0;0;0;0;6;8;14;12;26;8;11;19;22;24;18;4;1;88
730000;Rauschgiftdelikte (soweit nicht bereits mit anderer Schlüsselzahl erfasst);6611000;Kassel;X;940;0;0;0;0;3;3;22;48;70;118;191;80;83;163;185;231;128;38;4;749
730000;Rauschgiftdelikte (soweit nicht bereits mit anderer Schlüsselzahl erfasst);1002000;Kiel;M;633;0;0;0;0;3;3;21;52;73;116;192;73;62;135;99;128;59;16;4;441
730000;Rauschgiftdelikte (soweit nicht bereits mit anderer Schlüsselzahl erfasst);1002000;Kiel;W;92;0;0;0;0;1;1;10;5;15;14;30;6;8;14;20;15;10;2;1;62
730000;Rauschgiftdelikte (soweit nicht bereits mit anderer Schlüsselzahl erfasst);1002000;Kiel;X;725;0;0;0;0;4;4;31;57;88;130;222;79;70;149;119;143;69;18;5;503
730000;Rauschgiftdelikte (soweit nicht bereits mit anderer Schlüsselzahl erfasst);7111000;Koblenz;M;547;0;0;0;0;2;2;10;25;35;97;134;59;56;115;131;124;33;10;0;413
730000;Rauschgiftdelikte (soweit nicht bereits mit anderer Schlüsselzahl erfasst);7111000;Koblenz;W;88;0;0;0;0;0;0;3;8;11;16;27;15;6;21;17;17;5;1;0;61
730000;Rauschgiftdelikte (soweit nicht bereits mit anderer Schlüsselzahl erfasst);7111000;Koblenz;X;635;0;0;0;0;2;2;13;33;46;113;161;74;62;136;148;141;38;11;0;474
730000;Rauschgiftdelikte (soweit nicht bereits mit anderer Schlüsselzahl erfasst);5315000;Köln;M;4433;0;0;0;2;12;14;103;304;407;685;1106;479;406;885;861;1002;441;120;18;3327
730000;Rauschgiftdelikte (soweit nicht bereits mit anderer Schlüsselzahl erfasst);5315000;Köln;W;537;0;0;0;0;5;5;32;44;76;73;154;38;43;81;102;125;52;19;4;383
730000;Rauschgiftdelikte (soweit nicht bereits mit anderer Schlüsselzahl erfasst);5315000;Köln;X;4970;0;0;0;2;17;19;135;348;483;758;1260;517;449;966;963;1127;493;139;22;3710
730000;Rauschgiftdelikte (soweit nicht bereits mit anderer Schlüsselzahl erfasst);5114000;Krefeld;M;1348;0;0;0;0;5;5;27;55;82;181;268;127;131;258;287;371;121;38;5;1080
730000;Rauschgiftdelikte (soweit nicht bereits mit anderer Schlüsselzahl erfasst);5114000;Krefeld;W;254;0;0;0;0;0;0;5;3;8;25;33;23;28;51;62;77;26;5;0;221
730000;Rauschgiftdelikte (soweit nicht bereits mit anderer Schlüsselzahl erfasst);5114000;Krefeld;X;1602;0;0;0;0;5;5;32;58;90;206;301;150;159;309;349;448;147;43;5;1301
730000;Rauschgiftdelikte (soweit nicht bereits mit anderer Schlüsselzahl erfasst);14713000;Leipzig;M;1366;0;0;0;0;9;9;34;67;101;138;248;91;135;226;365;416;92;17;2;1118
730000;Rauschgiftdelikte (soweit nicht bereits mit anderer Schlüsselzahl erfasst);14713000;Leipzig;W;232;0;0;0;0;1;1;17;9;26;25;52;19;21;40;70;58;8;3;1;180
730000;Rauschgiftdelikte (soweit nicht bereits mit anderer Schlüsselzahl erfasst);14713000;Leipzig;X;1598;0;0;0;0;10;10;51;76;127;163;300;110;156;266;435;474;100;20;3;1298
730000;Rauschgiftdelikte (soweit nicht bereits mit anderer Schlüsselzahl erfasst);5316000;Leverkusen;M;319;0;0;0;0;1;1;10;45;55;65;121;49;19;68;43;67;16;2;2;198
730000;Rauschgiftdelikte (soweit nicht bereits mit anderer Schlüsselzahl erfasst);5316000;Leverkusen;W;41;0;0;0;0;1;1;4;10;14;6;21;4;2;6;5;6;2;1;0;20
730000;Rauschgiftdelikte (soweit nicht bereits mit anderer Schlüsselzahl erfasst);5316000;Leverkusen;X;360;0;0;0;0;2;2;14;55;69;71;142;53;21;74;48;73;18;3;2;218
730000;Rauschgiftdelikte (soweit nicht bereits mit anderer Schlüsselzahl erfasst);1003000;Lübeck;M;630;0;0;0;0;3;3;30;66;96;89;188;57;48;105;106;138;73;17;3;442
730000;Rauschgiftdelikte (soweit nicht bereits mit anderer Schlüsselzahl erfasst);1003000;Lübeck;W;117;0;0;0;0;0;0;14;20;34;15;49;15;5;20;17;19;8;4;0;68
730000;Rauschgiftdelikte (soweit nicht bereits mit anderer Schlüsselzahl erfasst);1003000;Lübeck;X;747;0;0;0;0;3;3;44;86;130;104;237;72;53;125;123;157;81;21;3;510
730000;Rauschgiftdelikte (soweit nicht bereits mit anderer Schlüsselzahl erfasst);7314000;Ludwigshafen am Rhein;M;593;0;0;0;0;0;0;7;33;40;100;140;57;65;122;119;133;58;20;1;453
730000;Rauschgiftdelikte (soweit nicht bereits mit anderer Schlüsselzahl erfasst);7314000;Ludwigshafen am Rhein;W;104;0;0;0;0;0;0;3;3;6;9;15;8;8;16;25;26;16;6;0;89
730000;Rauschgiftdelikte (soweit nicht bereits mit anderer Schlüsselzahl erfasst);7314000;Ludwigshafen am Rhein;X;697;0;0;0;0;0;0;10;36;46;109;155;65;73;138;144;159;74;26;1;542
730000;Rauschgiftdelikte (soweit nicht bereits mit anderer Schlüsselzahl erfasst);15003000;Magdeburg;M;591;0;0;0;0;6;6;19;51;70;73;149;55;56;111;143;148;31;7;2;442
730000;Rauschgiftdelikte (soweit nicht bereits mit anderer Schlüsselzahl erfasst);15003000;Magdeburg;W;89;0;0;0;0;2;2;8;3;11;12;25;11;11;22;23;15;4;0;0;64
730000;Rauschgiftdelikte (soweit nicht bereits mit anderer Schlüsselzahl erfasst);15003000;Magdeburg;X;680;0;0;0;0;8;8;27;54;81;85;174;66;67;133;166;163;35;7;2;506
730000;Rauschgiftdelikte (soweit nicht bereits mit anderer Schlüsselzahl erfasst);7315000;Mainz;M;875;0;0;0;0;0;0;20;46;66;131;197;96;73;169;170;236;87;13;3;678
730000;Rauschgiftdelikte (soweit nicht bereits mit anderer Schlüsselzahl erfasst);7315000;Mainz;W;123;0;0;0;0;0;0;4;5;9;19;28;13;12;25;19;32;15;3;1;95
730000;Rauschgiftdelikte (soweit nicht bereits mit anderer Schlüsselzahl erfasst);7315000;Mainz;X;998;0;0;0;0;0;0;24;51;75;150;225;109;85;194;189;268;102;16;4;773
730000;Rauschgiftdelikte (soweit nicht bereits mit anderer Schlüsselzahl erfasst);8222000;Mannheim;M;1405;0;0;0;0;1;1;19;94;113;248;362;169;157;326;289;291;109;26;2;1043
730000;Rauschgiftdelikte (soweit nicht bereits mit anderer Schlüsselzahl erfasst);8222000;Mannheim;W;152;0;0;0;0;2;2;5;13;18;29;49;18;12;30;34;25;11;3;0;103
730000;Rauschgiftdelikte (soweit nicht bereits mit anderer Schlüsselzahl erfasst);8222000;Mannheim;X;1557;0;0;0;0;3;3;24;107;131;277;411;187;169;356;323;316;120;29;2;1146
730000;Rauschgiftdelikte (soweit nicht bereits mit anderer Schlüsselzahl erfasst);5170024;Moers;M;185;0;0;0;0;0;0;2;17;19;37;56;13;15;28;34;47;16;4;0;129
730000;Rauschgiftdelikte (soweit nicht bereits mit anderer Schlüsselzahl erfasst);5170024;Moers;W;23;0;0;0;0;0;0;3;0;3;2;5;3;5;8;3;5;2;0;0;18
730000;Rauschgiftdelikte (soweit nicht bereits mit anderer Schlüsselzahl erfasst);5170024;Moers;X;208;0;0;0;0;0;0;5;17;22;39;61;16;20;36;37;52;18;4;0;147
730000;Rauschgiftdelikte (soweit nicht bereits mit anderer Schlüsselzahl erfasst);5116000;Mönchengladbach;M;610;0;0;0;0;1;1;9;36;45;90;136;47;55;102;134;150;65;19;4;474
730000;Rauschgiftdelikte (soweit nicht bereits mit anderer Schlüsselzahl erfasst);5116000;Mönchengladbach;W;97;0;0;0;0;3;3;7;7;14;12;29;6;9;15;21;21;8;3;0;68
730000;Rauschgiftdelikte (soweit nicht bereits mit anderer Schlüsselzahl erfasst);5116000;Mönchengladbach;X;707;0;0;0;0;4;4;16;43;59;102;165;53;64;117;155;171;73;22;4;542
730000;Rauschgiftdelikte (soweit nicht bereits mit anderer Schlüsselzahl erfasst);5117000;Mülheim an der Ruhr;M;311;0;0;0;0;4;4;12;28;40;49;93;31;48;79;51;61;14;12;1;218
730000;Rauschgiftdelikte (soweit nicht bereits mit anderer Schlüsselzahl erfasst);5117000;Mülheim an der Ruhr;W;60;0;0;0;0;1;1;4;9;13;6;20;1;11;12;10;7;6;5;0;40
730000;Rauschgiftdelikte (soweit nicht bereits mit anderer Schlüsselzahl erfasst);5117000;Mülheim an der Ruhr;X;371;0;0;0;0;5;5;16;37;53;55;113;32;59;91;61;68;20;17;1;258
730000;Rauschgiftdelikte (soweit nicht bereits mit anderer Schlüsselzahl erfasst);9162000;München;M;5694;0;0;0;0;12;12;124;488;612;1184;1808;691;550;1241;1064;1037;391;120;33;3886
730000;Rauschgiftdelikte (soweit nicht bereits mit anderer Schlüsselzahl erfasst);9162000;München;W;821;0;0;0;0;5;5;44;79;123;163;291;97;75;172;136;129;67;19;7;530
730000;Rauschgiftdelikte (soweit nicht bereits mit anderer Schlüsselzahl erfasst);9162000;München;X;6515;0;0;0;0;17;17;168;567;735;1347;2099;788;625;1413;1200;1166;458;139;40;4416
730000;Rauschgiftdelikte (soweit nicht bereits mit anderer Schlüsselzahl erfasst);5515000;Münster;M;753;0;0;0;0;5;5;25;50;75;127;207;86;80;166;135;160;65;20;0;546
730000;Rauschgiftdelikte (soweit nicht bereits mit anderer Schlüsselzahl erfasst);5515000;Münster;W;86;0;0;0;0;2;2;6;2;8;23;33;4;11;15;10;18;9;1;0;53
730000;Rauschgiftdelikte (soweit nicht bereits mit anderer Schlüsselzahl erfasst);5515000;Münster;X;839;0;0;0;0;7;7;31;52;83;150;240;90;91;181;145;178;74;21;0;599
730000;Rauschgiftdelikte (soweit nicht bereits mit anderer Schlüsselzahl erfasst);5162024;Neuss;M;520;0;0;0;0;2;2;18;59;77;91;170;36;50;86;91;122;41;9;1;350
730000;Rauschgiftdelikte (soweit nicht bereits mit anderer Schlüsselzahl erfasst);5162024;Neuss;W;72;0;0;0;0;0;0;11;16;27;5;32;2;8;10;12;10;6;0;2;40
730000;Rauschgiftdelikte (soweit nicht bereits mit anderer Schlüsselzahl erfasst);5162024;Neuss;X;592;0;0;0;0;2;2;29;75;104;96;202;38;58;96;103;132;47;9;3;390
730000;Rauschgiftdelikte (soweit nicht bereits mit anderer Schlüsselzahl erfasst);9564000;Nürnberg;M;2014;0;0;0;0;3;3;38;159;197;387;587;210;181;391;363;447;172;46;8;1427
730000;Rauschgiftdelikte (soweit nicht bereits mit anderer Schlüsselzahl erfasst);9564000;Nürnberg;W;306;0;0;0;0;5;5;13;11;24;41;70;39;36;75;48;73;26;12;2;236
730000;Rauschgiftdelikte (soweit nicht bereits mit anderer Schlüsselzahl erfasst);9564000;Nürnberg;X;2320;0;0;0;0;8;8;51;170;221;428;657;249;217;466;411;520;198;58;10;1663
730000;Rauschgiftdelikte (soweit nicht bereits mit anderer Schlüsselzahl erfasst);5119000;Oberhausen;M;1070;0;0;0;0;2;2;5;67;72;233;307;150;129;279;201;183;71;26;3;763
730000;Rauschgiftdelikte (soweit nicht bereits mit anderer Schlüsselzahl erfasst);5119000;Oberhausen;W;300;0;0;0;0;2;2;15;31;46;70;118;46;27;73;57;41;10;1;0;182
730000;Rauschgiftdelikte (soweit nicht bereits mit anderer Schlüsselzahl erfasst);5119000;Oberhausen;X;1370;0;0;0;0;4;4;20;98;118;303;425;196;156;352;258;224;81;27;3;945
730000;Rauschgiftdelikte (soweit nicht bereits mit anderer Schlüsselzahl erfasst);6413000;Offenbach am Main;M;1034;0;0;0;0;1;1;12;46;58;176;235;133;121;254;251;216;68;9;1;799
730000;Rauschgiftdelikte (soweit nicht bereits mit anderer Schlüsselzahl erfasst);6413000;Offenbach am Main;W;131;0;0;0;0;0;0;5;8;13;29;42;16;13;29;27;18;10;4;1;89
730000;Rauschgiftdelikte (soweit nicht bereits mit anderer Schlüsselzahl erfasst);6413000;Offenbach am Main;X;1165;0;0;0;0;1;1;17;54;71;205;277;149;134;283;278;234;78;13;2;888
730000;Rauschgiftdelikte (soweit nicht bereits mit anderer Schlüsselzahl erfasst);3403000;Oldenburg (Oldenburg);M;520;0;0;0;0;1;1;30;79;109;88;198;51;52;103;68;94;39;16;2;322
730000;Rauschgiftdelikte (soweit nicht bereits mit anderer Schlüsselzahl erfasst);3403000;Oldenburg (Oldenburg);W;65;0;0;0;0;1;1;2;12;14;10;25;5;4;9;9;9;6;6;1;40
730000;Rauschgiftdelikte (soweit nicht bereits mit anderer Schlüsselzahl erfasst);3403000;Oldenburg (Oldenburg);X;585;0;0;0;0;2;2;32;91;123;98;223;56;56;112;77;103;45;22;3;362
730000;Rauschgiftdelikte (soweit nicht bereits mit anderer Schlüsselzahl erfasst);3404000;Osnabrück;M;647;0;0;0;0;4;4;13;20;33;87;124;68;49;117;146;177;62;17;4;523
730000;Rauschgiftdelikte (soweit nicht bereits mit anderer Schlüsselzahl erfasst);3404000;Osnabrück;W;74;0;0;0;0;0;0;3;10;13;7;20;8;3;11;17;15;6;2;3;54
730000;Rauschgiftdelikte (soweit nicht bereits mit anderer Schlüsselzahl erfasst);3404000;Osnabrück;X;721;0;0;0;0;4;4;16;30;46;94;144;76;52;128;163;192;68;19;7;577
730000;Rauschgiftdelikte (soweit nicht bereits mit anderer Schlüsselzahl erfasst);5774032;Paderborn;M;466;0;0;0;0;1;1;25;60;85;87;173;51;39;90;76;99;23;3;2;293
730000;Rauschgiftdelikte (soweit nicht bereits mit anderer Schlüsselzahl erfasst);5774032;Paderborn;W;47;0;0;0;0;0;0;1;5;6;8;14;4;2;6;12;12;2;0;1;33
730000;Rauschgiftdelikte (soweit nicht bereits mit anderer Schlüsselzahl erfasst);5774032;Paderborn;X;513;0;0;0;0;1;1;26;65;91;95;187;55;41;96;88;111;25;3;3;326
730000;Rauschgiftdelikte (soweit nicht bereits mit anderer Schlüsselzahl erfasst);8231000;Pforzheim;M;392;0;0;0;0;3;3;15;45;60;86;149;53;42;95;52;50;38;8;0;243
730000;Rauschgiftdelikte (soweit nicht bereits mit anderer Schlüsselzahl erfasst);8231000;Pforzheim;W;65;0;0;0;0;1;1;5;6;11;13;25;7;3;10;9;13;6;1;1;40
730000;Rauschgiftdelikte (soweit nicht bereits mit anderer Schlüsselzahl erfasst);8231000;Pforzheim;X;457;0;0;0;0;4;4;20;51;71;99;174;60;45;105;61;63;44;9;1;283
730000;Rauschgiftdelikte (soweit nicht bereits mit anderer Schlüsselzahl erfasst);12054000;Potsdam;M;363;0;0;0;1;6;7;32;38;70;49;126;23;31;54;68;91;22;2;0;237
730000;Rauschgiftdelikte (soweit nicht bereits mit anderer Schlüsselzahl erfasst);12054000;Potsdam;W;77;0;0;0;0;5;5;15;12;27;10;42;7;6;13;9;13;0;0;0;35
730000;Rauschgiftdelikte (soweit nicht bereits mit anderer Schlüsselzahl erfasst);12054000;Potsdam;X;440;0;0;0;1;11;12;47;50;97;59;168;30;37;67;77;104;22;2;0;272
730000;Rauschgiftdelikte (soweit nicht bereits mit anderer Schlüsselzahl erfasst);5562032;Recklinghausen;M;486;0;0;0;0;0;0;7;21;28;88;116;50;47;97;96;112;52;13;0;370
730000;Rauschgiftdelikte (soweit nicht bereits mit anderer Schlüsselzahl erfasst);5562032;Recklinghausen;W;51;0;0;0;0;1;1;8;3;11;6;18;3;5;8;2;13;9;1;0;33
730000;Rauschgiftdelikte (soweit nicht bereits mit anderer Schlüsselzahl erfasst);5562032;Recklinghausen;X;537;0;0;0;0;1;1;15;24;39;94;134;53;52;105;98;125;61;14;0;403
730000;Rauschgiftdelikte (soweit nicht bereits mit anderer Schlüsselzahl erfasst);9362000;Regensburg;M;560;0;0;0;0;0;0;14;50;64;79;143;63;58;121;117;123;45;11;0;417
730000;Rauschgiftdelikte (soweit nicht bereits mit anderer Schlüsselzahl erfasst);9362000;Regensburg;W;96;0;0;0;0;0;0;11;13;24;10;34;6;7;13;17;22;6;4;0;62
730000;Rauschgiftdelikte (soweit nicht bereits mit anderer Schlüsselzahl erfasst);9362000;Regensburg;X;656;0;0;0;0;0;0;25;63;88;89;177;69;65;134;134;145;51;15;0;479
730000;Rauschgiftdelikte (soweit nicht bereits mit anderer Schlüsselzahl erfasst);5120000;Remscheid;M;211;0;0;0;0;3;3;8;17;25;37;65;14;18;32;40;54;15;4;1;146
730000;Rauschgiftdelikte (soweit nicht bereits mit anderer Schlüsselzahl erfasst);5120000;Remscheid;W;37;0;0;0;0;2;2;4;6;10;6;18;2;1;3;5;6;4;1;0;19
730000;Rauschgiftdelikte (soweit nicht bereits mit anderer Schlüsselzahl erfasst);5120000;Remscheid;X;248;0;0;0;0;5;5;12;23;35;43;83;16;19;35;45;60;19;5;1;165
730000;Rauschgiftdelikte (soweit nicht bereits mit anderer Schlüsselzahl erfasst);8415061;Reutlingen;M;380;0;0;0;0;1;1;18;57;75;65;141;59;35;94;61;56;22;6;0;239
730000;Rauschgiftdelikte (soweit nicht bereits mit anderer Schlüsselzahl erfasst);8415061;Reutlingen;W;53;0;0;0;0;3;3;10;10;20;7;30;7;3;10;6;3;3;1;0;23
730000;Rauschgiftdelikte (soweit nicht bereits mit anderer Schlüsselzahl erfasst);8415061;Reutlingen;X;433;0;0;0;0;4;4;28;67;95;72;171;66;38;104;67;59;25;7;0;262
730000;Rauschgiftdelikte (soweit nicht bereits mit anderer Schlüsselzahl erfasst);13003000;Rostock;M;462;0;0;0;1;0;1;11;14;25;36;62;33;62;95;113;149;32;6;5;400
730000;Rauschgiftdelikte (soweit nicht bereits mit anderer Schlüsselzahl erfasst);13003000;Rostock;W;66;0;0;0;0;1;1;6;5;11;2;14;4;12;16;13;16;4;3;0;52
730000;Rauschgiftdelikte (soweit nicht bereits mit anderer Schlüsselzahl erfasst);13003000;Rostock;X;528;0;0;0;1;1;2;17;19;36;38;76;37;74;111;126;165;36;9;5;452
730000;Rauschgiftdelikte (soweit nicht bereits mit anderer Schlüsselzahl erfasst);10041100;Saarbrücken;M;596;0;0;0;1;3;4;25;42;67;68;139;48;48;96;98;174;71;16;2;457
730000;Rauschgiftdelikte (soweit nicht bereits mit anderer Schlüsselzahl erfasst);10041100;Saarbrücken;W;114;0;0;0;0;2;2;4;2;6;6;14;6;9;15;22;32;24;6;1;100
730000;Rauschgiftdelikte (soweit nicht bereits mit anderer Schlüsselzahl erfasst);10041100;Saarbrücken;X;710;0;0;0;1;5;6;29;44;73;74;153;54;57;111;120;206;95;22;3;557
730000;Rauschgiftdelikte (soweit nicht bereits mit anderer Schlüsselzahl erfasst);5122000;Solingen;M;323;0;0;1;0;2;3;12;34;46;79;128;33;33;66;52;52;19;4;2;195
730000;Rauschgiftdelikte (soweit nicht bereits mit anderer Schlüsselzahl erfasst);5122000;Solingen;W;54;0;0;0;1;1;2;7;2;9;15;26;2;8;10;8;8;1;1;0;28
730000;Rauschgiftdelikte (soweit nicht bereits mit anderer Schlüsselzahl erfasst);5122000;Solingen;X;377;0;0;1;1;3;5;19;36;55;94;154;35;41;76;60;60;20;5;2;223
730000;Rauschgiftdelikte (soweit nicht bereits mit anderer Schlüsselzahl erfasst);8111000;Stuttgart;M;2882;0;0;0;0;5;5;66;239;305;591;901;355;306;661;522;538;204;49;7;1981
730000;Rauschgiftdelikte (soweit nicht bereits mit anderer Schlüsselzahl erfasst);8111000;Stuttgart;W;337;0;0;0;0;2;2;29;46;75;68;145;39;20;59;45;51;28;9;0;192
730000;Rauschgiftdelikte (soweit nicht bereits mit anderer Schlüsselzahl erfasst);8111000;Stuttgart;X;3219;0;0;0;0;7;7;95;285;380;659;1046;394;326;720;567;589;232;58;7;2173
730000;Rauschgiftdelikte (soweit nicht bereits mit anderer Schlüsselzahl erfasst);7211000;Trier;M;424;0;0;0;0;0;0;15;31;46;66;112;58;44;102;90;85;29;5;1;312
730000;Rauschgiftdelikte (soweit nicht bereits mit anderer Schlüsselzahl erfasst);7211000;Trier;W;45;0;0;0;0;0;0;1;4;5;10;15;3;8;11;9;8;1;1;0;30
730000;Rauschgiftdelikte (soweit nicht bereits mit anderer Schlüsselzahl erfasst);7211000;Trier;X;469;0;0;0;0;0;0;16;35;51;76;127;61;52;113;99;93;30;6;1;342
730000;Rauschgiftdelikte (soweit nicht bereits mit anderer Schlüsselzahl erfasst);8421000;Ulm;M;361;0;0;0;0;0;0;13;36;49;69;118;34;27;61;64;82;24;11;1;243
730000;Rauschgiftdelikte (soweit nicht bereits mit anderer Schlüsselzahl erfasst);8421000;Ulm;W;53;0;0;0;0;0;0;3;8;11;12;23;2;6;8;4;10;6;2;0;30
730000;Rauschgiftdelikte (soweit nicht bereits mit anderer Schlüsselzahl erfasst);8421000;Ulm;X;414;0;0;0;0;0;0;16;44;60;81;141;36;33;69;68;92;30;13;1;273
730000;Rauschgiftdelikte (soweit nicht bereits mit anderer Schlüsselzahl erfasst);6414000;Wiesbaden;M;722;0;0;0;0;1;1;14;58;72;126;199;65;62;127;140;168;59;24;5;523
730000;Rauschgiftdelikte (soweit nicht bereits mit anderer Schlüsselzahl erfasst);6414000;Wiesbaden;W;77;0;0;0;0;1;1;1;5;6;10;17;7;7;14;11;21;9;3;2;60
730000;Rauschgiftdelikte (soweit nicht bereits mit anderer Schlüsselzahl erfasst);6414000;Wiesbaden;X;799;0;0;0;0;2;2;15;63;78;136;216;72;69;141;151;189;68;27;7;583
730000;Rauschgiftdelikte (soweit nicht bereits mit anderer Schlüsselzahl erfasst);3103000;Wolfsburg;M;504;0;0;0;0;2;2;13;39;52;63;117;55;57;112;120;114;35;6;0;387
730000;Rauschgiftdelikte (soweit nicht bereits mit anderer Schlüsselzahl erfasst);3103000;Wolfsburg;W;67;0;0;0;0;0;0;7;4;11;8;19;6;8;14;11;15;5;2;1;48
730000;Rauschgiftdelikte (soweit nicht bereits mit anderer Schlüsselzahl erfasst);3103000;Wolfsburg;X;571;0;0;0;0;2;2;20;43;63;71;136;61;65;126;131;129;40;8;1;435
730000;Rauschgiftdelikte (soweit nicht bereits mit anderer Schlüsselzahl erfasst);5124000;Wuppertal;M;1001;0;0;0;0;1;1;28;90;118;158;277;103;118;221;199;197;82;23;2;724
730000;Rauschgiftdelikte (soweit nicht bereits mit anderer Schlüsselzahl erfasst);5124000;Wuppertal;W;129;0;0;0;0;2;2;15;13;28;22;52;12;8;20;13;26;14;3;1;77
730000;Rauschgiftdelikte (soweit nicht bereits mit anderer Schlüsselzahl erfasst);5124000;Wuppertal;X;1130;0;0;0;0;3;3;43;103;146;180;329;115;126;241;212;223;96;26;3;801
730000;Rauschgiftdelikte (soweit nicht bereits mit anderer Schlüsselzahl erfasst);9663000;Würzburg;M;790;0;0;0;0;1;1;13;51;64;167;232;99;80;179;152;167;48;9;3;558
730000;Rauschgiftdelikte (soweit nicht bereits mit anderer Schlüsselzahl erfasst);9663000;Würzburg;W;72;0;0;0;0;0;0;2;3;5;12;17;7;7;14;13;21;6;0;1;55
730000;Rauschgiftdelikte (soweit nicht bereits mit anderer Schlüsselzahl erfasst);9663000;Würzburg;X;862;0;0;0;0;1;1;15;54;69;179;249;106;87;193;165;188;54;9;4;613
892000;Gewaltkriminalität;5334002;Aachen;M;783;2;0;0;3;12;17;48;96;144;109;270;65;66;131;94;134;93;40;21;513
892000;Gewaltkriminalität;5334002;Aachen;W;107;0;0;0;0;4;4;8;9;17;10;31;7;7;14;15;24;10;7;6;76
892000;Gewaltkriminalität;5334002;Aachen;X;890;2;0;0;3;16;21;56;105;161;119;301;72;73;145;109;158;103;47;27;589
892000;Gewaltkriminalität;9761000;Augsburg;M;682;0;0;3;8;12;23;35;40;75;93;191;64;64;128;116;117;64;46;20;491
892000;Gewaltkriminalität;9761000;Augsburg;W;132;0;0;1;2;3;6;9;8;17;13;36;10;9;19;12;32;19;10;4;96
892000;Gewaltkriminalität;9761000;Augsburg;X;814;0;0;4;10;15;29;44;48;92;106;227;74;73;147;128;149;83;56;24;587
892000;Gewaltkriminalität;5378004;Bergisch Gladbach;M;173;0;0;0;6;1;7;13;19;32;26;65;7;8;15;27;35;20;9;2;108
892000;Gewaltkriminalität;5378004;Bergisch Gladbach;W;42;0;0;0;0;0;0;4;4;8;2;10;2;1;3;7;8;8;6;0;32
892000;Gewaltkriminalität;5378004;Bergisch Gladbach;X;215;0;0;0;6;1;7;17;23;40;28;75;9;9;18;34;43;28;15;2;140
892000;Gewaltkriminalität;11000000;Berlin;M;9371;6;22;83;148;279;538;481;720;1201;1136;2875;624;627;1251;1334;1946;1100;547;318;6496
892000;Gewaltkriminalität;11000000;Berlin;W;1792;0;2;8;14;84;108;140;102;242;143;493;84;100;184;226;375;288;137;89;1299
892000;Gewaltkriminalität;11000000;Berlin;X;11163;6;24;91;162;363;646;621;822;1443;1279;3368;708;727;1435;1560;2321;1388;684;407;7795
892000;Gewaltkriminalität;5711000;Bielefeld;M;613;0;0;2;7;5;14;19;53;72;110;196;52;44;96;88;117;73;29;14;417
892000;Gewaltkriminalität;5711000;Bielefeld;W;94;0;0;0;1;0;1;15;7;22;12;35;9;3;12;10;22;10;4;1;59
892000;Gewaltkriminalität;5711000;Bielefeld;X;707;0;0;2;8;5;15;34;60;94;122;231;61;47;108;98;139;83;33;15;476
892000;Gewaltkriminalität;5911000;Bochum;M;930;0;1;2;7;19;29;31;81;112;132;273;85;68;153;150;169;119;51;15;657
892000;Gewaltkriminalität;5911000;Bochum;W;185;0;0;0;0;10;10;12;19;31;19;60;11;13;24;15;31;36;12;7;125
892000;Gewaltkriminalität;5911000;Bochum;X;1115;0;1;2;7;29;39;43;100;143;151;333;96;81;177;165;200;155;63;22;782
892000;Gewaltkriminalität;5314000;Bonn;M;827;0;1;4;17;19;41;42;61;103;105;249;64;58;122;128;145;108;49;26;578
892000;Gewaltkriminalität;5314000;Bonn;W;134;0;0;0;0;5;5;5;10;15;10;30;11;6;17;10;38;24;5;10;104
892000;Gewaltkriminalität;5314000;Bonn;X;961;0;1;4;17;24;46;47;71;118;115;279;75;64;139;138;183;132;54;36;682
892000;Gewaltkriminalität;5512000;Bottrop;M;214;0;0;0;2;5;7;20;15;35;22;64;21;19;40;20;41;30;8;11;150
892000;Gewaltkriminalität;5512000;Bottrop;W;28;0;0;0;0;4;4;4;0;4;2;10;1;1;2;3;3;6;3;1;18
892000;Gewaltkriminalität;5512000;Bottrop;X;242;0;0;0;2;9;11;24;15;39;24;74;22;20;42;23;44;36;11;12;168
892000;Gewaltkriminalität;3101000;Braunschweig;M;726;0;2;1;3;10;16;22;53;75;121;212;78;52;130;126;149;61;40;8;514
892000;Gewaltkriminalität;3101000;Braunschweig;W;108;0;0;1;0;6;7;11;6;17;13;37;4;7;11;19;19;10;7;5;71
892000;Gewaltkriminalität;3101000;Braunschweig;X;834;0;2;2;3;16;23;33;59;92;134;249;82;59;141;145;168;71;47;13;585
892000;Gewaltkriminalität;4011000;Bremen;M;1820;1;2;5;10;23;41;102;159;261;277;579;166;152;318;252;344;208;71;48;1241
892000;Gewaltkriminalität;4011000;Bremen;W;241;0;0;1;2;3;6;15;16;31;17;54;15;21;36;33;52;33;20;13;187
892000;Gewaltkriminalität;4011000;Bremen;X;2061;1;2;6;12;26;47;117;175;292;294;633;181;173;354;285;396;241;91;61;1428
892000;Gewaltkriminalität;4012000;Bremerhaven;M;366;0;1;3;0;2;6;14;24;38;52;96;37;24;61;56;85;37;21;10;270
892000;Gewaltkriminalität;4012000;Bremerhaven;W;65;0;0;0;0;2;2;9;5;14;15;31;4;1;5;8;7;6;4;4;34
892000;Gewaltkriminalität;4012000;Bremerhaven;X;431;0;1;3;0;4;8;23;29;52;67;127;41;25;66;64;92;43;25;14;304
892000;Gewaltkriminalität;14511000;Chemnitz;M;557;0;1;1;1;5;8;14;20;34;78;120;41;55;96;120;143;50;21;7;437
892000;Gewaltkriminalität;14511000;Chemnitz;W;77;0;0;0;0;5;5;6;5;11;7;23;1;4;5;14;18;8;6;3;54
892000;Gewaltkriminalität;14511000;Chemnitz;X;634;0;1;1;1;10;13;20;25;45;85;143;42;59;101;134;161;58;27;10;491
892000;Gewaltkriminalität;6411000;Darmstadt;M;361;0;0;1;2;11;14;16;30;46;69;129;26;19;45;48;72;39;17;11;232
892000;Gewaltkriminalität;6411000;Darmstadt;W;69;0;0;0;0;2;2;0;5;5;6;13;6;4;10;7;18;10;7;4;56
892000;Gewaltkriminalität;6411000;Darmstadt;X;430;0;0;1;2;13;16;16;35;51;75;142;32;23;55;55;90;49;24;15;288
892000;Gewaltkriminalität;5913000;Dortmund;M;2134;0;3;11;27;46;87;79;177;256;279;622;190;171;361;340;419;244;106;42;1512
892000;Gewaltkriminalität;5913000;Dortmund;W;310;0;0;2;0;14;16;16;31;47;33;96;23;19;42;38;64;35;22;13;214
892000;Gewaltkriminalität;5913000;Dortmund;X;2444;0;3;13;27;60;103;95;208;303;312;718;213;190;403;378;483;279;128;55;1726
892000;Gewaltkriminalität;14612000;Dresden;M;754;0;0;1;5;15;21;23;34;57;85;163;72;66;138;156;169;71;30;27;591
892000;Gewaltkriminalität;14612000;Dresden;W;95;0;0;0;0;7;7;9;5;14;8;29;2;7;9;17;15;9;8;8;66
892000;Gewaltkriminalität;14612000;Dresden;X;849;0;0;1;5;22;28;32;39;71;93;192;74;73;147;173;184;80;38;35;657
892000;Gewaltkriminalität;5112000;Duisburg;M;1366;0;9;10;15;65;99;93;109;202;161;462;108;84;192;176;270;146;86;34;904
892000;Gewaltkriminalität;5112000;Duisburg;W;222;0;0;2;0;9;11;11;16;27;17;55;15;12;27;24;49;42;15;10;167
892000;Gewaltkriminalität;5112000;Duisburg;X;1588;0;9;12;15;74;110;104;125;229;178;517;123;96;219;200;319;188;101;44;1071
892000;Gewaltkriminalität;5111000;Düsseldorf;M;1851;0;2;8;19;25;54;64;118;182;300;536;187;152;339;274;387;204;73;38;1315
892000;Gewaltkriminalität;5111000;Düsseldorf;W;271;1;1;2;5;16;25;17;18;35;25;85;20;14;34;33;48;39;21;11;186
892000;Gewaltkriminalität;5111000;Düsseldorf;X;2122;1;3;10;24;41;79;81;136;217;325;621;207;166;373;307;435;243;94;49;1501
892000;Gewaltkriminalität;16051000;Erfurt;M;492;0;2;0;7;19;28;25;29;54;52;134;42;41;83;90;108;47;17;13;358
892000;Gewaltkriminalität;16051000;Erfurt;W;91;0;0;0;0;1;1;3;4;7;6;14;6;6;12;16;22;13;9;5;77
892000;Gewaltkriminalität;16051000;Erfurt;X;583;0;2;0;7;20;29;28;33;61;58;148;48;47;95;106;130;60;26;18;435
892000;Gewaltkriminalität;9562000;Erlangen;M;180;0;0;0;1;1;2;8;15;23;29;54;17;14;31;29;35;22;6;3;126
892000;Gewaltkriminalität;9562000;Erlangen;W;32;0;0;0;0;1;1;3;5;8;2;11;0;4;4;4;3;6;2;2;21
892000;Gewaltkriminalität;9562000;Erlangen;X;212;0;0;0;1;2;3;11;20;31;31;65;17;18;35;33;38;28;8;5;147
892000;Gewaltkriminalität;5113000;Essen;M;1385;0;0;3;12;45;60;85;121;206;195;461;106;97;203;178;253;177;76;37;924
892000;Gewaltkriminalität;5113000;Essen;W;269;0;0;1;1;14;16;28;28;56;24;96;17;13;30;36;52;31;19;5;173
892000;Gewaltkriminalität;5113000;Essen;X;1654;0;0;4;13;59;76;113;149;262;219;557;123;110;233;214;305;208;95;42;1097
892000;Gewaltkriminalität;6412000;Frankfurt am Main;M;2448;0;1;17;19;41;78;72;170;242;313;633;169;150;319;398;557;342;129;70;1815
892000;Gewaltkriminalität;6412000;Frankfurt am Main;W;423;0;0;0;1;8;9;19;21;40;48;97;33;21;54;56;104;55;33;24;326
892000;Gewaltkriminalität;6412000;Frankfurt am Main;X;2871;0;1;17;20;49;87;91;191;282;361;730;202;171;373;454;661;397;162;94;2141
892000;Gewaltkriminalität;8311000;Freiburg im Breisgau;M;682;0;0;0;1;16;17;38;81;119;109;245;76;61;137;85;93;67;42;13;437
892000;Gewaltkriminalität;8311000;Freiburg im Breisgau;W;90;0;0;0;0;0;0;3;10;13;13;26;4;6;10;15;13;11;11;4;64
892000;Gewaltkriminalität;8311000;Freiburg im Breisgau;X;772;0;0;0;1;16;17;41;91;132;122;271;80;67;147;100;106;78;53;17;501
892000;Gewaltkriminalität;9563000;Fürth;M;194;0;0;1;4;7;12;13;8;21;27;60;9;11;20;32;39;23;11;9;134
892000;Gewaltkriminalität;9563000;Fürth;W;45;0;0;0;1;4;5;5;0;5;5;15;3;4;7;5;7;7;3;1;30
892000;Gewaltkriminalität;9563000;Fürth;X;239;0;0;1;5;11;17;18;8;26;32;75;12;15;27;37;46;30;14;10;164
892000;Gewaltkriminalität;5513000;Gelsenkirchen;M;822;0;0;5;9;27;41;57;63;120;123;284;62;60;122;105;131;112;55;13;538
892000;Gewaltkriminalität;5513000;Gelsenkirchen;W;153;0;0;0;1;9;10;18;9;27;16;53;6;9;15;21;26;23;9;6;100
892000;Gewaltkriminalität;5513000;Gelsenkirchen;X;975;0;0;5;10;36;51;75;72;147;139;337;68;69;137;126;157;135;64;19;638
892000;Gewaltkriminalität;3152012;Göttingen;M;343;0;0;0;1;2;3;22;26;48;54;105;24;37;61;50;59;37;20;11;238
892000;Gewaltkriminalität;3152012;Göttingen;W;52;0;0;0;0;0;0;0;4;4;6;10;1;2;3;10;17;7;4;1;42
892000;Gewaltkriminalität;3152012;Göttingen;X;395;0;0;0;1;2;3;22;30;52;60;115;25;39;64;60;76;44;24;12;280
892000;Gewaltkriminalität;5914000;Hagen;M;439;0;2;5;9;15;31;21;48;69;89;189;37;30;67;45;84;33;16;5;250
892000;Gewaltkriminalität;5914000;Hagen;W;63;0;0;0;1;8;9;12;8;20;6;35;4;2;6;6;7;6;2;1;28
892000;Gewaltkriminalität;5914000;Hagen;X;502;0;2;5;10;23;40;33;56;89;95;224;41;32;73;51;91;39;18;6;278
892000;Gewaltkriminalität;15002000;Halle (Saale);M;639;0;0;7;12;15;34;23;37;60;68;162;57;59;116;116;135;65;31;14;477
892000;Gewaltkriminalität;15002000;Halle (Saale);W;115;0;0;0;3;16;19;12;5;17;8;44;11;8;19;11;15;12;9;5;71
892000;Gewaltkriminalität;15002000;Halle (Saale);X;754;0;0;7;15;31;53;35;42;77;76;206;68;67;135;127;150;77;40;19;548
892000;Gewaltkriminalität;2000000;Hamburg;M;6089;6;29;83;114;167;399;278;499;777;763;1939;463;433;896;888;1213;707;295;151;4150
892000;Gewaltkriminalität;2000000;Hamburg;W;1121;0;6;4;20;54;84;74;59;133;90;307;71;60;131;151;234;177;77;44;814
892000;Gewaltkriminalität;2000000;Hamburg;X;7210;6;35;87;134;221;483;352;558;910;853;2246;534;493;1027;1039;1447;884;372;195;4964
892000;Gewaltkriminalität;5915000;Hamm;M;411;0;1;2;5;7;15;15;31;46;70;131;35;33;68;61;86;47;9;9;280
892000;Gewaltkriminalität;5915000;Hamm;W;75;0;0;0;0;1;1;8;11;19;13;33;8;3;11;9;6;10;2;4;42
892000;Gewaltkriminalität;5915000;Hamm;X;486;0;1;2;5;8;16;23;42;65;83;164;43;36;79;70;92;57;11;13;322
892000;Gewaltkriminalität;3241001;Hannover;M;1959;0;0;2;23;47;72;84;151;235;268;575;178;152;330;298;401;210;96;49;1384
892000;Gewaltkriminalität;3241001;Hannover;W;303;0;0;1;1;13;15;27;23;50;23;88;20;20;40;48;66;35;14;12;215
892000;Gewaltkriminalität;3241001;Hannover;X;2262;0;0;3;24;60;87;111;174;285;291;663;198;172;370;346;467;245;110;61;1599
892000;Gewaltkriminalität;8221000;Heidelberg;M;290;0;0;1;0;3;4;13;24;37;51;92;28;27;55;28;55;32;18;10;198
892000;Gewaltkriminalität;8221000;Heidelberg;W;34;0;0;0;0;1;1;3;2;5;4;10;1;3;4;9;4;4;3;0;24
892000;Gewaltkriminalität;8221000;Heidelberg;X;324;0;0;1;0;4;5;16;26;42;55;102;29;30;59;37;59;36;21;10;222
892000;Gewaltkriminalität;8121000;Heilbronn;M;284;0;0;0;1;0;1;9;28;37;37;75;22;19;41;46;63;34;12;13;209
892000;Gewaltkriminalität;8121000;Heilbronn;W;28;0;0;0;0;0;0;2;2;4;4;8;0;1;1;7;5;3;1;3;20
892000;Gewaltkriminalität;8121000;Heilbronn;X;312;0;0;0;1;0;1;11;30;41;41;83;22;20;42;53;68;37;13;16;229
892000;Gewaltkriminalität;5916000;Herne;M;326;0;1;1;6;4;12;20;22;42;35;89;15;18;33;59;53;58;25;9;237
892000;Gewaltkriminalität;5916000;Herne;W;45;0;0;0;0;1;1;1;4;5;8;14;2;1;3;8;7;11;0;2;31
892000;Gewaltkriminalität;5916000;Herne;X;371;0;1;1;6;5;13;21;26;47;43;103;17;19;36;67;60;69;25;11;268
892000;Gewaltkriminalität;9161000;Ingolstadt;M;298;0;0;0;5;6;11;10;17;27;36;74;33;21;54;52;65;29;16;8;224
892000;Gewaltkriminalität;9161000;Ingolstadt;W;70;0;0;0;0;2;2;9;2;11;7;20;4;1;5;7;14;11;8;5;50
892000;Gewaltkriminalität;9161000;Ingolstadt;X;368;0;0;0;5;8;13;19;19;38;43;94;37;22;59;59;79;40;24;13;274
892000;Gewaltkriminalität;16053000;Jena;M;142;0;0;0;1;5;6;12;7;19;9;34;9;13;22;24;36;10;12;4;108
892000;Gewaltkriminalität;16053000;Jena;W;23;0;0;0;1;3;4;1;1;2;0;6;5;2;7;2;1;4;1;2;17
892000;Gewaltkriminalität;16053000;Jena;X;165;0;0;0;2;8;10;13;8;21;9;40;14;15;29;26;37;14;13;6;125
892000;Gewaltkriminalität;8212000;Karlsruhe;M;656;0;0;2;3;7;12;15;51;66;93;171;69;39;108;105;142;82;31;17;485
892000;Gewaltkriminalität;8212000;Karlsruhe;W;92;0;0;0;0;3;3;8;7;15;6;24;6;8;14;9;23;12;6;4;68
892000;Gewaltkriminalität;8212000;Karlsruhe;X;748;0;0;2;3;10;15;23;58;81;99;195;75;47;122;114;165;94;37;21;553
892000;Gewaltkriminalität;6611000;Kassel;M;624;0;4;1;13;7;25;20;46;66;87;178;62;57;119;100;111;65;34;17;446
892000;Gewaltkriminalität;6611000;Kassel;W;113;0;0;0;1;5;6;9;10;19;18;43;8;8;16;14;18;11;5;6;70
892000;Gewaltkriminalität;6611000;Kassel;X;737;0;4;1;14;12;31;29;56;85;105;221;70;65;135;114;129;76;39;23;516
892000;Gewaltkriminalität;1002000;Kiel;M;710;0;0;5;0;2;7;28;44;72;115;194;72;65;137;125;126;76;32;20;516
892000;Gewaltkriminalität;1002000;Kiel;W;96;0;0;0;1;3;4;5;3;8;7;19;6;9;15;15;21;16;5;5;77
892000;Gewaltkriminalität;1002000;Kiel;X;806;0;0;5;1;5;11;33;47;80;122;213;78;74;152;140;147;92;37;25;593
892000;Gewaltkriminalität;7111000;Koblenz;M;315;0;0;3;1;3;7;25;24;49;46;102;38;24;62;43;62;20;19;7;213
892000;Gewaltkriminalität;7111000;Koblenz;W;56;0;0;0;0;5;5;7;2;9;8;22;7;2;9;8;7;5;3;2;34
892000;Gewaltkriminalität;7111000;Koblenz;X;371;0;0;3;1;8;12;32;26;58;54;124;45;26;71;51;69;25;22;9;247
892000;Gewaltkriminalität;5315000;Köln;M;4015;0;4;19;37;86;146;141;327;468;511;1125;304;292;596;593;835;536;222;108;2890
892000;Gewaltkriminalität;5315000;Köln;W;809;0;4;1;1;31;37;69;60;129;90;256;36;52;88;102;163;113;58;29;553
892000;Gewaltkriminalität;5315000;Köln;X;4824;0;8;20;38;117;183;210;387;597;601;1381;340;344;684;695;998;649;280;137;3443
892000;Gewaltkriminalität;5114000;Krefeld;M;523;0;0;1;2;7;10;13;40;53;64;127;51;36;87;81;101;69;43;15;396
892000;Gewaltkriminalität;5114000;Krefeld;W;102;0;0;1;0;7;8;16;12;28;8;44;5;6;11;13;11;11;8;4;58
892000;Gewaltkriminalität;5114000;Krefeld;X;625;0;0;2;2;14;18;29;52;81;72;171;56;42;98;94;112;80;51;19;454
892000;Gewaltkriminalität;14713000;Leipzig;M;1210;0;1;0;15;38;54;37;65;102;129;285;105;114;219;241;257;140;42;26;925
892000;Gewaltkriminalität;14713000;Leipzig;W;189;0;0;1;0;11;12;18;12;30;11;53;6;14;20;35;37;22;14;8;136
892000;Gewaltkriminalität;14713000;Leipzig;X;1399;0;1;1;15;49;66;55;77;132;140;338;111;128;239;276;294;162;56;34;1061
892000;Gewaltkriminalität;5316000;Leverkusen;M;468;0;0;0;2;13;15;14;44;58;56;129;53;36;89;64;88;55;18;25;339
892000;Gewaltkriminalität;5316000;Leverkusen;W;93;0;0;0;0;3;3;8;8;16;6;25;7;3;10;11;17;16;9;5;68
892000;Gewaltkriminalität;5316000;Leverkusen;X;561;0;0;0;2;16;18;22;52;74;62;154;60;39;99;75;105;71;27;30;407
892000;Gewaltkriminalität;1003000;Lübeck;M;639;0;2;1;4;15;22;19;33;52;69;143;57;53;110;102;129;96;44;15;496
892000;Gewaltkriminalität;1003000;Lübeck;W;107;0;0;0;0;9;9;7;7;14;6;29;9;13;22;8;20;14;7;7;78
892000;Gewaltkriminalität;1003000;Lübeck;X;746;0;2;1;4;24;31;26;40;66;75;172;66;66;132;110;149;110;51;22;574
892000;Gewaltkriminalität;7314000;Ludwigshafen am Rhein;M;627;0;0;5;12;17;34;29;43;72;85;191;51;43;94;93;108;75;46;20;436
892000;Gewaltkriminalität;7314000;Ludwigshafen am Rhein;W;155;0;0;0;0;9;9;9;2;11;14;34;16;10;26;13;35;26;13;8;121
892000;Gewaltkriminalität;7314000;Ludwigshafen am Rhein;X;782;0;0;5;12;26;43;38;45;83;99;225;67;53;120;106;143;101;59;28;557
892000;Gewaltkriminalität;15003000;Magdeburg;M;606;0;0;2;8;20;30;43;46;89;81;200;47;47;94;94;112;75;22;9;406
892000;Gewaltkriminalität;15003000;Magdeburg;W;94;0;0;0;0;5;5;11;11;22;10;37;5;7;12;10;19;9;4;3;57
892000;Gewaltkriminalität;15003000;Magdeburg;X;700;0;0;2;8;25;35;54;57;111;91;237;52;54;106;104;131;84;26;12;463
892000;Gewaltkriminalität;7315000;Mainz;M;552;0;0;1;4;7;12;28;56;84;104;200;47;32;79;90;88;65;21;9;352
892000;Gewaltkriminalität;7315000;Mainz;W;90;0;0;0;0;2;2;9;6;15;13;30;6;7;13;14;16;9;6;2;60
892000;Gewaltkriminalität;7315000;Mainz;X;642;0;0;1;4;9;14;37;62;99;117;230;53;39;92;104;104;74;27;11;412
892000;Gewaltkriminalität;8222000;Mannheim;M;782;0;0;2;4;26;32;30;64;94;106;232;61;56;117;108;170;91;47;17;550
892000;Gewaltkriminalität;8222000;Mannheim;W;136;0;0;0;0;4;4;11;12;23;12;39;10;12;22;12;25;18;10;10;97
892000;Gewaltkriminalität;8222000;Mannheim;X;918;0;0;2;4;30;36;41;76;117;118;271;71;68;139;120;195;109;57;27;647
892000;Gewaltkriminalität;5170024;Moers;M;195;0;0;4;6;3;13;6;21;27;24;64;25;10;35;28;32;21;10;5;131
892000;Gewaltkriminalität;5170024;Moers;W;28;0;0;0;0;2;2;5;2;7;1;10;1;2;3;3;6;2;0;4;18
892000;Gewaltkriminalität;5170024;Moers;X;223;0;0;4;6;5;15;11;23;34;25;74;26;12;38;31;38;23;10;9;149
892000;Gewaltkriminalität;5116000;Mönchengladbach;M;671;0;0;0;1;12;13;33;46;79;112;204;57;56;113;122;104;79;37;12;467
892000;Gewaltkriminalität;5116000;Mönchengladbach;W;120;0;0;0;0;11;11;17;6;23;9;43;9;7;16;15;24;9;9;4;77
892000;Gewaltkriminalität;5116000;Mönchengladbach;X;791;0;0;0;1;23;24;50;52;102;121;247;66;63;129;137;128;88;46;16;544
892000;Gewaltkriminalität;5117000;Mülheim an der Ruhr;M;322;0;0;0;5;11;16;18;30;48;45;109;23;20;43;38;60;37;22;13;213
892000;Gewaltkriminalität;5117000;Mülheim an der Ruhr;W;63;0;0;0;0;3;3;2;4;6;4;13;5;3;8;8;11;15;5;3;50
892000;Gewaltkriminalität;5117000;Mülheim an der Ruhr;X;385;0;0;0;5;14;19;20;34;54;49;122;28;23;51;46;71;52;27;16;263
892000;Gewaltkriminalität;9162000;München;M;3264;0;2;9;17;57;85;128;269;397;457;939;290;274;564;466;645;403;158;89;2325
892000;Gewaltkriminalität;9162000;München;W;639;0;0;3;1;19;23;50;38;88;61;172;31;38;69;78;140;92;58;30;467
892000;Gewaltkriminalität;9162000;München;X;3903;0;2;12;18;76;108;178;307;485;518;1111;321;312;633;544;785;495;216;119;2792
892000;Gewaltkriminalität;5515000;Münster;M;604;0;2;0;5;20;27;37;57;94;84;205;60;49;109;80;100;66;33;11;399
892000;Gewaltkriminalität;5515000;Münster;W;80;0;1;0;0;3;4;14;8;22;13;39;2;4;6;7;15;7;4;2;41
892000;Gewaltkriminalität;5515000;Münster;X;684;0;3;0;5;23;31;51;65;116;97;244;62;53;115;87;115;73;37;13;440
892000;Gewaltkriminalität;5162024;Neuss;M;280;0;0;3;0;5;8;12;32;44;38;90;19;18;37;42;50;43;12;6;190
892000;Gewaltkriminalität;5162024;Neuss;W;40;0;0;0;0;0;0;7;3;10;5;15;4;1;5;1;8;6;2;3;25
892000;Gewaltkriminalität;5162024;Neuss;X;320;0;0;3;0;5;8;19;35;54;43;105;23;19;42;43;58;49;14;9;215
892000;Gewaltkriminalität;9564000;Nürnberg;M;1407;0;1;0;13;24;38;36;85;121;173;332;152;123;275;234;283;168;68;47;1075
892000;Gewaltkriminalität;9564000;Nürnberg;W;288;0;0;2;3;8;13;14;19;33;31;77;21;18;39;38;66;38;17;13;211
892000;Gewaltkriminalität;9564000;Nürnberg;X;1695;0;1;2;16;32;51;50;104;154;204;409;173;141;314;272;349;206;85;60;1286
892000;Gewaltkriminalität;5119000;Oberhausen;M;500;0;0;1;7;11;19;19;30;49;66;134;43;42;85;66;102;66;32;15;366
892000;Gewaltkriminalität;5119000;Oberhausen;W;100;0;0;0;2;12;14;10;7;17;10;41;3;7;10;14;13;12;5;5;59
892000;Gewaltkriminalität;5119000;Oberhausen;X;600;0;0;1;9;23;33;29;37;66;76;175;46;49;95;80;115;78;37;20;425
892000;Gewaltkriminalität;6413000;Offenbach am Main;M;411;0;0;0;0;7;7;26;36;62;43;112;25;28;53;75;86;49;21;15;299
892000;Gewaltkriminalität;6413000;Offenbach am Main;W;63;0;0;0;1;1;2;9;5;14;6;22;2;1;3;10;18;5;4;1;41
892000;Gewaltkriminalität;6413000;Offenbach am Main;X;474;0;0;0;1;8;9;35;41;76;49;134;27;29;56;85;104;54;25;16;340
892000;Gewaltkriminalität;3403000;Oldenburg (Oldenburg);M;398;0;0;4;2;7;13;18;32;50;60;123;26;34;60;76;62;42;28;7;275
892000;Gewaltkriminalität;3403000;Oldenburg (Oldenburg);W;59;0;0;0;0;1;1;4;6;10;9;20;4;4;8;4;9;12;3;3;39
892000;Gewaltkriminalität;3403000;Oldenburg (Oldenburg);X;457;0;0;4;2;8;14;22;38;60;69;143;30;38;68;80;71;54;31;10;314
892000;Gewaltkriminalität;3404000;Osnabrück;M;625;0;1;2;9;9;21;26;33;59;112;192;46;59;105;99;130;53;35;11;433
892000;Gewaltkriminalität;3404000;Osnabrück;W;97;0;0;0;2;4;6;13;11;24;9;39;3;4;7;11;15;16;7;2;58
892000;Gewaltkriminalität;3404000;Osnabrück;X;722;0;1;2;11;13;27;39;44;83;121;231;49;63;112;110;145;69;42;13;491
892000;Gewaltkriminalität;5774032;Paderborn;M;327;0;0;2;1;9;12;11;33;44;55;111;31;22;53;48;65;23;20;7;216
892000;Gewaltkriminalität;5774032;Paderborn;W;34;0;0;0;0;0;0;0;3;3;5;8;0;1;1;7;13;4;1;0;26
892000;Gewaltkriminalität;5774032;Paderborn;X;361;0;0;2;1;9;12;11;36;47;60;119;31;23;54;55;78;27;21;7;242
892000;Gewaltkriminalität;8231000;Pforzheim;M;319;0;0;0;5;6;11;17;31;48;32;91;25;24;49;53;73;26;20;7;228
892000;Gewaltkriminalität;8231000;Pforzheim;W;45;0;0;0;0;0;0;4;2;6;5;11;4;1;5;8;9;9;2;1;34
892000;Gewaltkriminalität;8231000;Pforzheim;X;364;0;0;0;5;6;11;21;33;54;37;102;29;25;54;61;82;35;22;8;262
892000;Gewaltkriminalität;12054000;Potsdam;M;208;1;0;0;2;6;9;19;14;33;23;65;20;18;38;28;41;24;7;5;143
892000;Gewaltkriminalität;12054000;Potsdam;W;31;0;0;0;0;0;0;3;1;4;4;8;0;5;5;3;7;4;3;1;23
892000;Gewaltkriminalität;12054000;Potsdam;X;239;1;0;0;2;6;9;22;15;37;27;73;20;23;43;31;48;28;10;6;166
892000;Gewaltkriminalität;5562032;Recklinghausen;M;331;0;0;1;6;9;16;27;36;63;58;137;24;23;47;42;43;31;16;15;194
892000;Gewaltkriminalität;5562032;Recklinghausen;W;69;0;0;0;2;4;6;9;8;17;12;35;4;4;8;4;10;8;3;1;34
892000;Gewaltkriminalität;5562032;Recklinghausen;X;400;0;0;1;8;13;22;36;44;80;70;172;28;27;55;46;53;39;19;16;228
892000;Gewaltkriminalität;9362000;Regensburg;M;313;0;2;0;0;2;4;7;21;28;46;78;34;31;65;64;69;26;8;3;235
892000;Gewaltkriminalität;9362000;Regensburg;W;48;0;0;0;0;0;0;3;3;6;5;11;5;4;9;7;10;5;5;1;37
892000;Gewaltkriminalität;9362000;Regensburg;X;361;0;2;0;0;2;4;10;24;34;51;89;39;35;74;71;79;31;13;4;272
892000;Gewaltkriminalität;5120000;Remscheid;M;198;0;0;3;3;4;10;5;10;15;31;56;9;15;24;30;40;18;20;10;142
892000;Gewaltkriminalität;5120000;Remscheid;W;38;0;0;0;0;0;0;2;4;6;4;10;2;4;6;3;7;7;3;2;28
892000;Gewaltkriminalität;5120000;Remscheid;X;236;0;0;3;3;4;10;7;14;21;35;66;11;19;30;33;47;25;23;12;170
892000;Gewaltkriminalität;8415061;Reutlingen;M;231;0;0;0;0;1;1;4;15;19;42;62;28;16;44;39;40;30;13;3;169
892000;Gewaltkriminalität;8415061;Reutlingen;W;29;0;0;0;0;1;1;1;6;7;3;11;1;2;3;6;5;3;1;0;18
892000;Gewaltkriminalität;8415061;Reutlingen;X;260;0;0;0;0;2;2;5;21;26;45;73;29;18;47;45;45;33;14;3;187
892000;Gewaltkriminalität;13003000;Rostock;M;443;0;0;2;13;11;26;19;27;46;40;112;26;42;68;85;116;35;19;8;331
892000;Gewaltkriminalität;13003000;Rostock;W;65;0;0;0;0;4;4;5;8;13;6;23;6;2;8;13;10;5;3;3;42
892000;Gewaltkriminalität;13003000;Rostock;X;508;0;0;2;13;15;30;24;35;59;46;135;32;44;76;98;126;40;22;11;373
892000;Gewaltkriminalität;10041100;Saarbrücken;M;699;0;0;3;3;9;15;32;70;102;104;221;51;58;109;121;140;64;27;17;478
892000;Gewaltkriminalität;10041100;Saarbrücken;W;137;0;0;0;1;2;3;6;9;15;13;31;8;16;24;16;29;20;12;5;106
892000;Gewaltkriminalität;10041100;Saarbrücken;X;836;0;0;3;4;11;18;38;79;117;117;252;59;74;133;137;169;84;39;22;584
892000;Gewaltkriminalität;5122000;Solingen;M;318;0;0;1;6;8;15;22;40;62;38;115;25;28;53;35;51;40;16;8;203
892000;Gewaltkriminalität;5122000;Solingen;W;61;0;0;1;1;3;5;3;5;8;7;20;6;4;10;4;12;12;2;1;41
892000;Gewaltkriminalität;5122000;Solingen;X;379;0;0;2;7;11;20;25;45;70;45;135;31;32;63;39;63;52;18;9;244
892000;Gewaltkriminalität;8111000;Stuttgart;M;1964;1;5;10;11;34;61;53;134;187;262;510;172;172;344;348;403;224;83;52;1454
892000;Gewaltkriminalität;8111000;Stuttgart;W;296;0;0;4;8;11;23;23;21;44;28;95;16;11;27;41;56;46;16;15;201
892000;Gewaltkriminalität;8111000;Stuttgart;X;2260;1;5;14;19;45;84;76;155;231;290;605;188;183;371;389;459;270;99;67;1655
892000;Gewaltkriminalität;7211000;Trier;M;302;0;0;0;4;5;9;10;28;38;47;94;31;33;64;46;51;30;11;6;208
892000;Gewaltkriminalität;7211000;Trier;W;56;0;0;0;1;1;2;7;5;12;3;17;2;8;10;8;7;6;6;2;39
892000;Gewaltkriminalität;7211000;Trier;X;358;0;0;0;5;6;11;17;33;50;50;111;33;41;74;54;58;36;17;8;247
892000;Gewaltkriminalität;8421000;Ulm;M;330;0;1;2;4;3;10;16;43;59;44;113;38;25;63;46;51;30;15;12;217
892000;Gewaltkriminalität;8421000;Ulm;W;58;0;0;0;0;6;6;2;4;6;12;24;2;1;3;8;8;9;5;1;34
892000;Gewaltkriminalität;8421000;Ulm;X;388;0;1;2;4;9;16;18;47;65;56;137;40;26;66;54;59;39;20;13;251
892000;Gewaltkriminalität;6414000;Wiesbaden;M;873;0;2;5;11;25;43;43;64;107;155;305;71;56;127;123;139;103;48;28;568
892000;Gewaltkriminalität;6414000;Wiesbaden;W;144;0;0;0;5;9;14;20;14;34;13;61;4;9;13;18;18;12;14;8;83
892000;Gewaltkriminalität;6414000;Wiesbaden;X;1017;0;2;5;16;34;57;63;78;141;168;366;75;65;140;141;157;115;62;36;651
892000;Gewaltkriminalität;3103000;Wolfsburg;M;292;0;0;1;2;3;6;14;32;46;46;98;26;28;54;48;57;18;9;8;194
892000;Gewaltkriminalität;3103000;Wolfsburg;W;44;0;0;0;0;3;3;9;4;13;3;19;3;2;5;4;9;3;1;3;25
892000;Gewaltkriminalität;3103000;Wolfsburg;X;336;0;0;1;2;6;9;23;36;59;49;117;29;30;59;52;66;21;10;11;219
892000;Gewaltkriminalität;5124000;Wuppertal;M;878;0;2;5;8;22;37;47;76;123;104;264;65;63;128;119;194;109;52;12;614
892000;Gewaltkriminalität;5124000;Wuppertal;W;178;0;0;0;0;5;5;19;20;39;12;56;16;11;27;15;37;21;13;9;122
892000;Gewaltkriminalität;5124000;Wuppertal;X;1056;0;2;5;8;27;42;66;96;162;116;320;81;74;155;134;231;130;65;21;736
892000;Gewaltkriminalität;9663000;Würzburg;M;285;0;0;0;1;0;1;7;25;32;50;83;41;22;63;52;46;20;15;6;202
892000;Gewaltkriminalität;9663000;Würzburg;W;46;0;0;0;0;0;0;1;9;10;2;12;6;2;8;5;8;9;1;3;34
892000;Gewaltkriminalität;9663000;Würzburg;X;331;0;0;0;1;0;1;8;34;42;52;95;47;24;71;57;54;29;16;9;236
892500;Mord und Totschlag;5334002;Aachen;M;5;0;0;0;0;0;0;0;0;0;0;0;0;0;0;0;4;0;0;1;5
892500;Mord und Totschlag;5334002;Aachen;W;0;0;0;0;0;0;0;0;0;0;0;0;0;0;0;0;0;0;0;0;0
892500;Mord und Totschlag;5334002;Aachen;X;5;0;0;0;0;0;0;0;0;0;0;0;0;0;0;0;4;0;0;1;5
892500;Mord und Totschlag;9761000;Augsburg;M;11;0;0;0;0;0;0;0;0;0;0;0;1;1;2;2;3;1;3;0;11
892500;Mord und Totschlag;9761000;Augsburg;W;1;0;0;0;0;0;0;0;0;0;0;0;1;0;1;0;0;0;0;0;1
892500;Mord und Totschlag;9761000;Augsburg;X;12;0;0;0;0;0;0;0;0;0;0;0;2;1;3;2;3;1;3;0;12
892500;Mord und Totschlag;5378004;Bergisch Gladbach;M;1;0;0;0;0;0;0;0;0;0;0;0;0;0;0;0;0;0;1;0;1
892500;Mord und Totschlag;5378004;Bergisch Gladbach;W;0;0;0;0;0;0;0;0;0;0;0;0;0;0;0;0;0;0;0;0;0
892500;Mord und Totschlag;5378004;Bergisch Gladbach;X;1;0;0;0;0;0;0;0;0;0;0;0;0;0;0;0;0;0;1;0;1
892500;Mord und Totschlag;11000000;Berlin;M;159;0;0;0;0;0;0;1;9;10;14;24;23;16;39;28;30;26;8;4;135
892500;Mord und Totschlag;11000000;Berlin;W;15;0;0;0;0;0;0;0;0;0;1;1;0;2;2;5;3;3;0;1;14
892500;Mord und Totschlag;11000000;Berlin;X;174;0;0;0;0;0;0;1;9;10;15;25;23;18;41;33;33;29;8;5;149
892500;Mord und Totschlag;5711000;Bielefeld;M;10;0;0;0;0;0;0;0;0;0;2;2;0;0;0;1;3;2;1;1;8
892500;Mord und Totschlag;5711000;Bielefeld;W;0;0;0;0;0;0;0;0;0;0;0;0;0;0;0;0;0;0;0;0;0
892500;Mord und Totschlag;5711000;Bielefeld;X;10;0;0;0;0;0;0;0;0;0;2;2;0;0;0;1;3;2;1;1;8
892500;Mord und Totschlag;5911000;Bochum;M;4;0;0;0;0;0;0;0;0;0;1;1;0;0;0;0;2;0;1;0;3
892500;Mord und Totschlag;5911000;Bochum;W;2;0;0;0;0;0;0;0;0;0;1;1;0;0;0;0;1;0;0;0;1
892500;Mord und Totschlag;5911000;Bochum;X;6;0;0;0;0;0;0;0;0;0;2;2;0;0;0;0;3;0;1;0;4
892500;Mord und Totschlag;5314000;Bonn;M;7;0;0;0;0;0;0;0;0;0;0;0;0;0;0;0;3;0;3;1;7
892500;Mord und Totschlag;5314000;Bonn;W;3;0;0;0;0;0;0;0;0;0;0;0;1;0;1;0;1;1;0;0;3
892500;Mord und Totschlag;5314000;Bonn;X;10;0;0;0;0;0;0;0;0;0;0;0;1;0;1;0;4;1;3;1;10
892500;Mord und Totschlag;5512000;Bottrop;M;0;0;0;0;0;0;0;0;0;0;0;0;0;0;0;0;0;0;0;0;0
892500;Mord und Totschlag;5512000;Bottrop;W;0;0;0;0;0;0;0;0;0;0;0;0;0;0;0;0;0;0;0;0;0
892500;Mord und Totschlag;5512000;Bottrop;X;0;0;0;0;0;0;0;0;0;0;0;0;0;0;0;0;0;0;0;0;0
892500;Mord und Totschlag;3101000;Braunschweig;M;14;0;0;0;0;0;0;0;0;0;2;2;0;1;1;7;3;1;0;0;12
892500;Mord und Totschlag;3101000;Braunschweig;W;0;0;0;0;0;0;0;0;0;0;0;0;0;0;0;0;0;0;0;0;0
892500;Mord und Totschlag;3101000;Braunschweig;X;14;0;0;0;0;0;0;0;0;0;2;2;0;1;1;7;3;1;0;0;12
892500;Mord und Totschlag;4011000;Bremen;M;12;0;0;0;0;0;0;0;0;0;4;4;1;1;2;1;5;0;0;0;8
892500;Mord und Totschlag;4011000;Bremen;W;5;0;0;0;0;1;1;0;1;1;0;2;0;0;0;0;2;1;0;0;3
892500;Mord und Totschlag;4011000;Bremen;X;17;0;0;0;0;1;1;0;1;1;4;6;1;1;2;1;7;1;0;0;11
892500;Mord und Totschlag;4012000;Bremerhaven;M;17;0;0;0;0;0;0;1;0;1;2;3;2;0;2;4;6;1;1;0;14
892500;Mord und Totschlag;4012000;Bremerhaven;W;3;0;0;0;0;0;0;0;0;0;0;0;0;0;0;1;0;1;1;0;3
892500;Mord und Totschlag;4012000;Bremerhaven;X;20;0;0;0;0;0;0;1;0;1;2;3;2;0;2;5;6;2;2;0;17
892500;Mord und Totschlag;14511000;Chemnitz;M;9;0;0;0;0;0;0;0;0;0;1;1;0;0;0;4;3;1;0;0;8
892500;Mord und Totschlag;14511000;Chemnitz;W;2;0;0;0;0;0;0;0;0;0;0;0;0;0;0;1;1;0;0;0;2
892500;Mord und Totschlag;14511000;Chemnitz;X;11;0;0;0;0;0;0;0;0;0;1;1;0;0;0;5;4;1;0;0;10
892500;Mord und Totschlag;6411000;Darmstadt;M;4;0;0;0;0;0;0;0;0;0;1;1;0;1;1;2;0;0;0;0;3
892500;Mord und Totschlag;6411000;Darmstadt;W;3;0;0;0;0;0;0;0;1;1;1;2;1;0;1;0;0;0;0;0;1
892500;Mord und Totschlag;6411000;Darmstadt;X;7;0;0;0;0;0;0;0;1;1;2;3;1;1;2;2;0;0;0;0;4
892500;Mord und Totschlag;5913000;Dortmund;M;14;0;0;0;0;0;0;0;2;2;2;4;1;2;3;2;3;2;0;0;10
892500;Mord und Totschlag;5913000;Dortmund;W;2;0;0;0;0;0;0;0;0;0;0;0;1;0;1;1;0;0;0;0;2
892500;Mord und Totschlag;5913000;Dortmund;X;16;0;0;0;0;0;0;0;2;2;2;4;2;2;4;3;3;2;0;0;12
892500;Mord und Totschlag;14612000;Dresden;M;13;0;0;0;0;0;0;0;0;0;1;1;2;1;3;4;2;1;1;1;12
892500;Mord und Totschlag;14612000;Dresden;W;0;0;0;0;0;0;0;0;0;0;0;0;0;0;0;0;0;0;0;0;0
892500;Mord und Totschlag;14612000;Dresden;X;13;0;0;0;0;0;0;0;0;0;1;1;2;1;3;4;2;1;1;1;12
892500;Mord und Totschlag;5112000;Duisburg;M;9;0;0;0;0;0;0;1;1;2;0;2;0;1;1;0;1;0;3;2;7
892500;Mord und Totschlag;5112000;Duisburg;W;0;0;0;0;0;0;0;0;0;0;0;0;0;0;0;0;0;0;0;0;0
892500;Mord und Totschlag;5112000;Duisburg;X;9;0;0;0;0;0;0;1;1;2;0;2;0;1;1;0;1;0;3;2;7
892500;Mord und Totschlag;5111000;Düsseldorf;M;11;0;0;0;0;0;0;0;0;0;2;2;1;0;1;0;3;3;2;0;9
892500;Mord und Totschlag;5111000;Düsseldorf;W;2;0;0;0;0;0;0;0;0;0;0;0;0;0;0;0;0;0;1;1;2
892500;Mord und Totschlag;5111000;Düsseldorf;X;13;0;0;0;0;0;0;0;0;0;2;2;1;0;1;0;3;3;3;1;11
892500;Mord und Totschlag;16051000;Erfurt;M;1;0;0;0;0;0;0;0;0;0;0;0;0;0;0;1;0;0;0;0;1
892500;Mord und Totschlag;16051000;Erfurt;W;3;0;0;0;0;0;0;0;1;1;0;1;1;0;1;0;0;1;0;0;2
892500;Mord und Totschlag;16051000;Erfurt;X;4;0;0;0;0;0;0;0;1;1;0;1;1;0;1;1;0;1;0;0;3
892500;Mord und Totschlag;9562000;Erlangen;M;1;0;0;0;0;0;0;0;0;0;0;0;0;0;0;1;0;0;0;0;1
892500;Mord und Totschlag;9562000;Erlangen;W;0;0;0;0;0;0;0;0;0;0;0;0;0;0;0;0;0;0;0;0;0
892500;Mord und Totschlag;9562000;Erlangen;X;1;0;0;0;0;0;0;0;0;0;0;0;0;0;0;1;0;0;0;0;1
892500;Mord und Totschlag;5113000;Essen;M;21;0;0;0;0;0;0;2;1;3;1;4;3;2;5;4;5;2;1;0;17
892500;Mord und Totschlag;5113000;Essen;W;3;0;0;0;0;0;0;0;0;0;0;0;0;0;0;1;0;2;0;0;3
892500;Mord und Totschlag;5113000;Essen;X;24;0;0;0;0;0;0;2;1;3;1;4;3;2;5;5;5;4;1;0;20
892500;Mord und Totschlag;6412000;Frankfurt am Main;M;32;0;0;0;0;0;0;0;1;1;3;4;3;2;5;6;10;5;0;2;28
892500;Mord und Totschlag;6412000;Frankfurt am Main;W;3;0;0;0;0;0;0;0;0;0;0;0;0;0;0;0;1;0;0;2;3
892500;Mord und Totschlag;6412000;Frankfurt am Main;X;35;0;0;0;0;0;0;0;1;1;3;4;3;2;5;6;11;5;0;4;31
892500;Mord und Totschlag;8311000;Freiburg im Breisgau;M;5;0;0;0;0;0;0;0;0;0;1;1;0;0;0;1;3;0;0;0;4
892500;Mord und Totschlag;8311000;Freiburg im Breisgau;W;0;0;0;0;0;0;0;0;0;0;0;0;0;0;0;0;0;0;0;0;0
892500;Mord und Totschlag;8311000;Freiburg im Breisgau;X;5;0;0;0;0;0;0;0;0;0;1;1;0;0;0;1;3;0;0;0;4
892500;Mord und Totschlag;9563000;Fürth;M;0;0;0;0;0;0;0;0;0;0;0;0;0;0;0;0;0;0;0;0;0
892500;Mord und Totschlag;9563000;Fürth;W;0;0;0;0;0;0;0;0;0;0;0;0;0;0;0;0;0;0;0;0;0
892500;Mord und Totschlag;9563000;Fürth;X;0;0;0;0;0;0;0;0;0;0;0;0;0;0;0;0;0;0;0;0;0
892500;Mord und Totschlag;5513000;Gelsenkirchen;M;6;0;0;0;0;0;0;0;0;0;0;0;1;0;1;1;1;1;0;2;6
892500;Mord und Totschlag;5513000;Gelsenkirchen;W;3;0;0;0;0;0;0;0;0;0;1;1;1;0;1;1;0;0;0;0;2
892500;Mord und Totschlag;5513000;Gelsenkirchen;X;9;0;0;0;0;0;0;0;0;0;1;1;2;0;2;2;1;1;0;2;8
892500;Mord und Totschlag;3152012;Göttingen;M;12;0;0;0;0;0;0;0;0;0;0;0;0;0;0;0;4;3;3;2;12
892500;Mord und Totschlag;3152012;Göttingen;W;4;0;0;0;0;0;0;0;0;0;0;0;0;0;0;0;2;0;2;0;4
892500;Mord und Totschlag;3152012;Göttingen;X;16;0;0;0;0;0;0;0;0;0;0;0;0;0;0;0;6;3;5;2;16
892500;Mord und Totschlag;5914000;Hagen;M;4;0;0;0;0;0;0;0;0;0;0;0;1;0;1;2;1;0;0;0;4
892500;Mord und Totschlag;5914000;Hagen;W;1;0;0;0;0;0;0;0;0;0;0;0;0;0;0;0;0;1;0;0;1
892500;Mord und Totschlag;5914000;Hagen;X;5;0;0;0;0;0;0;0;0;0;0;0;1;0;1;2;1;1;0;0;5
892500;Mord und Totschlag;15002000;Halle (Saale);M;14;0;0;0;0;0;0;0;0;0;2;2;1;2;3;4;4;0;1;0;12
892500;Mord und Totschlag;15002000;Halle (Saale);W;3;0;0;0;0;0;0;0;1;1;0;1;0;0;0;0;1;0;1;0;2
892500;Mord und Totschlag;15002000;Halle (Saale);X;17;0;0;0;0;0;0;0;1;1;2;3;1;2;3;4;5;0;2;0;14
892500;Mord und Totschlag;2000000;Hamburg;M;47;0;0;0;0;0;0;1;0;1;4;5;4;6;10;8;9;7;2;6;42
892500;Mord und Totschlag;2000000;Hamburg;W;9;0;0;0;0;0;0;0;1;1;1;2;1;0;1;1;2;2;1;0;7
892500;Mord und Totschlag;2000000;Hamburg;X;56;0;0;0;0;0;0;1;1;2;5;7;5;6;11;9;11;9;3;6;49
892500;Mord und Totschlag;5915000;Hamm;M;4;0;0;0;0;0;0;0;0;0;1;1;0;1;1;1;0;1;0;0;3
892500;Mord und Totschlag;5915000;Hamm;W;0;0;0;0;0;0;0;0;0;0;0;0;0;0;0;0;0;0;0;0;0
892500;Mord und Totschlag;5915000;Hamm;X;4;0;0;0;0;0;0;0;0;0;1;1;0;1;1;1;0;1;0;0;3
892500;Mord und Totschlag;3241001;Hannover;M;22;0;0;0;0;0;0;0;0;0;0;0;1;7;8;4;5;3;1;1;22
892500;Mord und Totschlag;3241001;Hannover;W;3;0;0;0;0;0;0;0;0;0;0;0;0;0;0;1;1;0;1;0;3
892500;Mord und Totschlag;3241001;Hannover;X;25;0;0;0;0;0;0;0;0;0;0;0;1;7;8;5;6;3;2;1;25
892500;Mord und Totschlag;8221000;Heidelberg;M;5;0;0;0;0;0;0;0;0;0;2;2;0;0;0;0;1;1;0;1;3
892500;Mord und Totschlag;8221000;Heidelberg;W;0;0;0;0;0;0;0;0;0;0;0;0;0;0;0;0;0;0;0;0;0
892500;Mord und Totschlag;8221000;Heidelberg;X;5;0;0;0;0;0;0;0;0;0;2;2;0;0;0;0;1;1;0;1;3
892500;Mord und Totschlag;8121000;Heilbronn;M;6;0;0;0;0;0;0;0;0;0;3;3;0;0;0;1;0;1;0;1;3
892500;Mord und Totschlag;8121000;Heilbronn;W;0;0;0;0;0;0;0;0;0;0;0;0;0;0;0;0;0;0;0;0;0
892500;Mord und Totschlag;8121000;Heilbronn;X;6;0;0;0;0;0;0;0;0;0;3;3;0;0;0;1;0;1;0;1;3
892500;Mord und Totschlag;5916000;Herne;M;2;0;0;0;0;0;0;0;0;0;0;0;0;0;0;0;0;2;0;0;2
892500;Mord und Totschlag;5916000;Herne;W;0;0;0;0;0;0;0;0;0;0;0;0;0;0;0;0;0;0;0;0;0
892500;Mord und Totschlag;5916000;Herne;X;2;0;0;0;0;0;0;0;0;0;0;0;0;0;0;0;0;2;0;0;2
892500;Mord und Totschlag;9161000;Ingolstadt;M;12;0;0;0;0;0;0;1;1;2;3;5;0;0;0;3;0;4;0;0;7
892500;Mord und Totschlag;9161000;Ingolstadt;W;0;0;0;0;0;0;0;0;0;0;0;0;0;0;0;0;0;0;0;0;0
892500;Mord und Totschlag;9161000;Ingolstadt;X;12;0;0;0;0;0;0;1;1;2;3;5;0;0;0;3;0;4;0;0;7
892500;Mord und Totschlag;16053000;Jena;M;1;0;0;0;0;0;0;0;0;0;0;0;1;0;1;0;0;0;0;0;1
892500;Mord und Totschlag;16053000;Jena;W;0;0;0;0;0;0;0;0;0;0;0;0;0;0;0;0;0;0;0;0;0
892500;Mord und Totschlag;16053000;Jena;X;1;0;0;0;0;0;0;0;0;0;0;0;1;0;1;0;0;0;0;0;1
892500;Mord und Totschlag;8212000;Karlsruhe;M;8;0;0;0;0;0;0;0;0;0;1;1;1;1;2;1;1;2;1;0;7
892500;Mord und Totschlag;8212000;Karlsruhe;W;5;0;0;0;0;0;0;1;3;4;0;4;0;0;0;0;0;1;0;0;1
892500;Mord und Totschlag;8212000;Karlsruhe;X;13;0;0;0;0;0;0;1;3;4;1;5;1;1;2;1;1;3;1;0;8
892500;Mord und Totschlag;6611000;Kassel;M;7;0;0;0;0;0;0;0;1;1;1;2;1;0;1;1;0;2;0;1;5
892500;Mord und Totschlag;6611000;Kassel;W;0;0;0;0;0;0;0;0;0;0;0;0;0;0;0;0;0;0;0;0;0
892500;Mord und Totschlag;6611000;Kassel;X;7;0;0;0;0;0;0;0;1;1;1;2;1;0;1;1;0;2;0;1;5
892500;Mord und Totschlag;1002000;Kiel;M;9;0;0;0;0;0;0;0;0;0;1;1;1;1;2;2;1;2;0;1;8
892500;Mord und Totschlag;1002000;Kiel;W;0;0;0;0;0;0;0;0;0;0;0;0;0;0;0;0;0;0;0;0;0
892500;Mord und Totschlag;1002000;Kiel;X;9;0;0;0;0;0;0;0;0;0;1;1;1;1;2;2;1;2;0;1;8
892500;Mord und Totschlag;7111000;Koblenz;M;1;0;0;0;0;0;0;0;0;0;0;0;0;0;0;0;1;0;0;0;1
892500;Mord und Totschlag;7111000;Koblenz;W;0;0;0;0;0;0;0;0;0;0;0;0;0;0;0;0;0;0;0;0;0
892500;Mord und Totschlag;7111000;Koblenz;X;1;0;0;0;0;0;0;0;0;0;0;0;0;0;0;0;1;0;0;0;1
892500;Mord und Totschlag;5315000;Köln;M;24;0;0;0;0;0;0;0;0;0;4;4;0;1;1;3;6;4;4;2;20
892500;Mord und Totschlag;5315000;Köln;W;5;0;0;0;0;0;0;0;0;0;1;1;0;1;1;0;1;1;0;1;4
892500;Mord und Totschlag;5315000;Köln;X;29;0;0;0;0;0;0;0;0;0;5;5;0;2;2;3;7;5;4;3;24
892500;Mord und Totschlag;5114000;Krefeld;M;8;0;0;0;0;0;0;0;0;0;0;0;3;1;4;0;4;0;0;0;8
892500;Mord und Totschlag;5114000;Krefeld;W;2;0;0;0;0;0;0;0;0;0;0;0;0;1;1;0;1;0;0;0;2
892500;Mord und Totschlag;5114000;Krefeld;X;10;0;0;0;0;0;0;0;0;0;0;0;3;2;5;0;5;0;0;0;10
892500;Mord und Totschlag;14713000;Leipzig;M;19;0;0;0;0;0;0;0;0;0;1;1;0;1;1;3;7;6;0;1;18
892500;Mord und Totschlag;14713000;Leipzig;W;0;0;0;0;0;0;0;0;0;0;0;0;0;0;0;0;0;0;0;0;0
892500;Mord und Totschlag;14713000;Leipzig;X;19;0;0;0;0;0;0;0;0;0;1;1;0;1;1;3;7;6;0;1;18
892500;Mord und Totschlag;5316000;Leverkusen;M;4;0;0;0;0;0;0;0;0;0;0;0;0;0;0;2;1;0;0;1;4
892500;Mord und Totschlag;5316000;Leverkusen;W;0;0;0;0;0;0;0;0;0;0;0;0;0;0;0;0;0;0;0;0;0
892500;Mord und Totschlag;5316000;Leverkusen;X;4;0;0;0;0;0;0;0;0;0;0;0;0;0;0;2;1;0;0;1;4
892500;Mord und Totschlag;1003000;Lübeck;M;6;0;0;0;0;0;0;0;0;0;1;1;0;0;0;0;1;2;2;0;5
892500;Mord und Totschlag;1003000;Lübeck;W;1;0;0;0;0;0;0;0;0;0;0;0;0;1;1;0;0;0;0;0;1
892500;Mord und Totschlag;1003000;Lübeck;X;7;0;0;0;0;0;0;0;0;0;1;1;0;1;1;0;1;2;2;0;6
892500;Mord und Totschlag;7314000;Ludwigshafen am Rhein;M;4;0;0;0;0;0;0;0;0;0;0;0;0;0;0;2;1;0;0;1;4
892500;Mord und Totschlag;7314000;Ludwigshafen am Rhein;W;2;0;0;0;0;0;0;0;0;0;0;0;0;0;0;0;0;0;0;2;2
892500;Mord und Totschlag;7314000;Ludwigshafen am Rhein;X;6;0;0;0;0;0;0;0;0;0;0;0;0;0;0;2;1;0;0;3;6
892500;Mord und Totschlag;15003000;Magdeburg;M;13;0;0;0;0;0;0;0;1;1;0;1;1;0;1;0;7;4;0;0;12
892500;Mord und Totschlag;15003000;Magdeburg;W;0;0;0;0;0;0;0;0;0;0;0;0;0;0;0;0;0;0;0;0;0
892500;Mord und Totschlag;15003000;Magdeburg;X;13;0;0;0;0;0;0;0;1;1;0;1;1;0;1;0;7;4;0;0;12
892500;Mord und Totschlag;7315000;Mainz;M;8;0;0;0;0;0;0;0;0;0;2;2;1;0;1;1;1;1;2;0;6
892500;Mord und Totschlag;7315000;Mainz;W;2;0;0;0;0;0;0;0;0;0;0;0;1;1;2;0;0;0;0;0;2
892500;Mord und Totschlag;7315000;Mainz;X;10;0;0;0;0;0;0;0;0;0;2;2;2;1;3;1;1;1;2;0;8
892500;Mord und Totschlag;8222000;Mannheim;M;13;0;0;0;0;0;0;0;1;1;1;2;1;0;1;3;5;2;0;0;11
892500;Mord und Totschlag;8222000;Mannheim;W;1;0;0;0;0;0;0;0;0;0;0;0;0;0;0;0;1;0;0;0;1
892500;Mord und Totschlag;8222000;Mannheim;X;14;0;0;0;0;0;0;0;1;1;1;2;1;0;1;3;6;2;0;0;12
892500;Mord und Totschlag;5170024;Moers;M;0;0;0;0;0;0;0;0;0;0;0;0;0;0;0;0;0;0;0;0;0
892500;Mord und Totschlag;5170024;Moers;W;0;0;0;0;0;0;0;0;0;0;0;0;0;0;0;0;0;0;0;0;0
892500;Mord und Totschlag;5170024;Moers;X;0;0;0;0;0;0;0;0;0;0;0;0;0;0;0;0;0;0;0;0;0
892500;Mord und Totschlag;5116000;Mönchengladbach;M;3;0;0;0;0;0;0;0;0;0;1;1;0;0;0;0;0;0;2;0;2
892500;Mord und Totschlag;5116000;Mönchengladbach;W;1;0;0;0;0;0;0;0;0;0;0;0;0;0;0;0;1;0;0;0;1
892500;Mord und Totschlag;5116000;Mönchengladbach;X;4;0;0;0;0;0;0;0;0;0;1;1;0;0;0;0;1;0;2;0;3
892500;Mord und Totschlag;5117000;Mülheim an der Ruhr;M;1;0;0;0;0;0;0;0;0;0;0;0;0;0;0;0;0;0;0;1;1
892500;Mord und Totschlag;5117000;Mülheim an der Ruhr;W;0;0;0;0;0;0;0;0;0;0;0;0;0;0;0;0;0;0;0;0;0
892500;Mord und Totschlag;5117000;Mülheim an der Ruhr;X;1;0;0;0;0;0;0;0;0;0;0;0;0;0;0;0;0;0;0;1;1
892500;Mord und Totschlag;9162000;München;M;27;0;0;0;0;0;0;0;2;2;4;6;0;1;1;3;5;7;1;4;21
892500;Mord und Totschlag;9162000;München;W;2;0;0;0;0;0;0;0;0;0;0;0;0;0;0;1;0;0;1;0;2
892500;Mord und Totschlag;9162000;München;X;29;0;0;0;0;0;0;0;2;2;4;6;0;1;1;4;5;7;2;4;23
892500;Mord und Totschlag;5515000;Münster;M;7;0;0;0;0;0;0;1;0;1;0;1;0;1;1;0;1;2;2;0;6
892500;Mord und Totschlag;5515000;Münster;W;0;0;0;0;0;0;0;0;0;0;0;0;0;0;0;0;0;0;0;0;0
892500;Mord und Totschlag;5515000;Münster;X;7;0;0;0;0;0;0;1;0;1;0;1;0;1;1;0;1;2;2;0;6
892500;Mord und Totschlag;5162024;Neuss;M;6;0;0;0;0;0;0;0;0;0;0;0;0;0;0;0;1;1;2;2;6
892500;Mord und Totschlag;5162024;Neuss;W;0;0;0;0;0;0;0;0;0;0;0;0;0;0;0;0;0;0;0;0;0
892500;Mord und Totschlag;5162024;Neuss;X;6;0;0;0;0;0;0;0;0;0;0;0;0;0;0;0;1;1;2;2;6
892500;Mord und Totschlag;9564000;Nürnberg;M;56;0;0;0;0;0;0;0;0;0;4;4;4;4;8;18;12;8;5;1;52
892500;Mord und Totschlag;9564000;Nürnberg;W;3;0;0;0;0;0;0;0;0;0;0;0;0;0;0;0;2;1;0;0;3
892500;Mord und Totschlag;9564000;Nürnberg;X;59;0;0;0;0;0;0;0;0;0;4;4;4;4;8;18;14;9;5;1;55
892500;Mord und Totschlag;5119000;Oberhausen;M;5;0;0;0;0;0;0;0;0;0;0;0;0;0;0;0;3;0;1;1;5
892500;Mord und Totschlag;5119000;Oberhausen;W;1;0;0;0;0;0;0;0;0;0;0;0;0;0;0;1;0;0;0;0;1
892500;Mord und Totschlag;5119000;Oberhausen;X;6;0;0;0;0;0;0;0;0;0;0;0;0;0;0;1;3;0;1;1;6
892500;Mord und Totschlag;6413000;Offenbach am Main;M;9;0;0;0;0;0;0;0;0;0;1;1;1;0;1;3;3;0;1;0;8
892500;Mord und Totschlag;6413000;Offenbach am Main;W;0;0;0;0;0;0;0;0;0;0;0;0;0;0;0;0;0;0;0;0;0
892500;Mord und Totschlag;6413000;Offenbach am Main;X;9;0;0;0;0;0;0;0;0;0;1;1;1;0;1;3;3;0;1;0;8
892500;Mord und Totschlag;3403000;Oldenburg (Oldenburg);M;9;0;0;0;0;0;0;0;0;0;1;1;3;1;4;1;2;0;1;0;8
892500;Mord und Totschlag;3403000;Oldenburg (Oldenburg);W;1;0;0;0;0;0;0;0;0;0;0;0;0;0;0;0;0;0;1;0;1
892500;Mord und Totschlag;3403000;Oldenburg (Oldenburg);X;10;0;0;0;0;0;0;0;0;0;1;1;3;1;4;1;2;0;2;0;9
892500;Mord und Totschlag;3404000;Osnabrück;M;12;0;0;0;0;0;0;0;0;0;2;2;2;3;5;0;3;1;1;0;10
892500;Mord und Totschlag;3404000;Osnabrück;W;2;0;0;0;0;0;0;0;0;0;0;0;0;1;1;0;0;1;0;0;2
892500;Mord und Totschlag;3404000;Osnabrück;X;14;0;0;0;0;0;0;0;0;0;2;2;2;4;6;0;3;2;1;0;12
892500;Mord und Totschlag;5774032;Paderborn;M;2;0;0;0;0;0;0;0;0;0;0;0;1;0;1;0;0;0;1;0;2
892500;Mord und Totschlag;5774032;Paderborn;W;0;0;0;0;0;0;0;0;0;0;0;0;0;0;0;0;0;0;0;0;0
892500;Mord und Totschlag;5774032;Paderborn;X;2;0;0;0;0;0;0;0;0;0;0;0;1;0;1;0;0;0;1;0;2
892500;Mord und Totschlag;8231000;Pforzheim;M;3;0;0;0;0;0;0;0;0;0;0;0;0;0;0;1;2;0;0;0;3
892500;Mord und Totschlag;8231000;Pforzheim;W;0;0;0;0;0;0;0;0;0;0;0;0;0;0;0;0;0;0;0;0;0
892500;Mord und Totschlag;8231000;Pforzheim;X;3;0;0;0;0;0;0;0;0;0;0;0;0;0;0;1;2;0;0;0;3
892500;Mord und Totschlag;12054000;Potsdam;M;0;0;0;0;0;0;0;0;0;0;0;0;0;0;0;0;0;0;0;0;0
892500;Mord und Totschlag;12054000;Potsdam;W;0;0;0;0;0;0;0;0;0;0;0;0;0;0;0;0;0;0;0;0;0
892500;Mord und Totschlag;12054000;Potsdam;X;0;0;0;0;0;0;0;0;0;0;0;0;0;0;0;0;0;0;0;0;0
892500;Mord und Totschlag;5562032;Recklinghausen;M;3;0;0;0;0;0;0;0;0;0;0;0;0;0;0;0;1;1;0;1;3
892500;Mord und Totschlag;5562032;Recklinghausen;W;0;0;0;0;0;0;0;0;0;0;0;0;0;0;0;0;0;0;0;0;0
892500;Mord und Totschlag;5562032;Recklinghausen;X;3;0;0;0;0;0;0;0;0;0;0;0;0;0;0;0;1;1;0;1;3
892500;Mord und Totschlag;9362000;Regensburg;M;4;0;0;0;0;0;0;0;0;0;0;0;2;0;2;0;2;0;0;0;4
892500;Mord und Totschlag;9362000;Regensburg;W;1;0;0;0;0;0;0;0;0;0;0;0;1;0;1;0;0;0;0;0;1
892500;Mord und Totschlag;9362000;Regensburg;X;5;0;0;0;0;0;0;0;0;0;0;0;3;0;3;0;2;0;0;0;5
892500;Mord und Totschlag;5120000;Remscheid;M;3;0;0;0;0;0;0;0;0;0;0;0;0;0;0;1;0;1;1;0;3
892500;Mord und Totschlag;5120000;Remscheid;W;0;0;0;0;0;0;0;0;0;0;0;0;0;0;0;0;0;0;0;0;0
892500;Mord und Totschlag;5120000;Remscheid;X;3;0;0;0;0;0;0;0;0;0;0;0;0;0;0;1;0;1;1;0;3
892500;Mord und Totschlag;8415061;Reutlingen;M;9;0;0;0;0;0;0;0;0;0;0;0;0;1;1;2;3;2;0;1;9
892500;Mord und Totschlag;8415061;Reutlingen;W;1;0;0;0;0;0;0;0;0;0;0;0;0;0;0;0;1;0;0;0;1
892500;Mord und Totschlag;8415061;Reutlingen;X;10;0;0;0;0;0;0;0;0;0;0;0;0;1;1;2;4;2;0;1;10
892500;Mord und Totschlag;13003000;Rostock;M;9;0;0;0;0;0;0;0;0;0;0;0;0;0;0;1;3;4;1;0;9
892500;Mord und Totschlag;13003000;Rostock;W;1;0;0;0;0;0;0;0;0;0;1;1;0;0;0;0;0;0;0;0;0
892500;Mord und Totschlag;13003000;Rostock;X;10;0;0;0;0;0;0;0;0;0;1;1;0;0;0;1;3;4;1;0;9
892500;Mord und Totschlag;10041100;Saarbrücken;M;11;0;0;0;0;0;0;0;0;0;0;0;1;1;2;3;3;1;1;1;11
892500;Mord und Totschlag;10041100;Saarbrücken;W;0;0;0;0;0;0;0;0;0;0;0;0;0;0;0;0;0;0;0;0;0
892500;Mord und Totschlag;10041100;Saarbrücken;X;11;0;0;0;0;0;0;0;0;0;0;0;1;1;2;3;3;1;1;1;11
892500;Mord und Totschlag;5122000;Solingen;M;5;0;0;0;0;0;0;0;0;0;1;1;0;0;0;1;1;2;0;0;4
892500;Mord und Totschlag;5122000;Solingen;W;1;0;0;0;0;0;0;0;0;0;0;0;0;0;0;0;1;0;0;0;1
892500;Mord und Totschlag;5122000;Solingen;X;6;0;0;0;0;0;0;0;0;0;1;1;0;0;0;1;2;2;0;0;5
892500;Mord und Totschlag;8111000;Stuttgart;M;40;0;0;0;0;0;0;0;1;1;9;10;5;3;8;6;5;8;3;0;30
892500;Mord und Totschlag;8111000;Stuttgart;W;4;0;0;0;0;0;0;0;0;0;0;0;0;0;0;0;1;2;1;0;4
892500;Mord und Totschlag;8111000;Stuttgart;X;44;0;0;0;0;0;0;0;1;1;9;10;5;3;8;6;6;10;4;0;34
892500;Mord und Totschlag;7211000;Trier;M;5;0;0;0;0;0;0;0;0;0;2;2;1;0;1;0;1;0;0;1;3
892500;Mord und Totschlag;7211000;Trier;W;0;0;0;0;0;0;0;0;0;0;0;0;0;0;0;0;0;0;0;0;0
892500;Mord und Totschlag;7211000;Trier;X;5;0;0;0;0;0;0;0;0;0;2;2;1;0;1;0;1;0;0;1;3
892500;Mord und Totschlag;8421000;Ulm;M;1;0;0;0;0;0;0;0;0;0;0;0;0;0;0;0;1;0;0;0;1
892500;Mord und Totschlag;8421000;Ulm;W;2;0;0;0;0;0;0;0;0;0;0;0;0;0;0;0;0;2;0;0;2
892500;Mord und Totschlag;8421000;Ulm;X;3;0;0;0;0;0;0;0;0;0;0;0;0;0;0;0;1;2;0;0;3
892500;Mord und Totschlag;6414000;Wiesbaden;M;22;0;0;0;0;0;0;0;0;0;4;4;1;4;5;0;5;3;2;3;18
892500;Mord und Totschlag;6414000;Wiesbaden;W;2;0;0;0;0;0;0;1;0;1;0;1;0;1;1;0;0;0;0;0;1
892500;Mord und Totschlag;6414000;Wiesbaden;X;24;0;0;0;0;0;0;1;0;1;4;5;1;5;6;0;5;3;2;3;19
892500;Mord und Totschlag;3103000;Wolfsburg;M;14;0;0;0;0;0;0;0;0;0;0;0;0;0;0;1;8;3;0;2;14
892500;Mord und Totschlag;3103000;Wolfsburg;W;0;0;0;0;0;0;0;0;0;0;0;0;0;0;0;0;0;0;0;0;0
892500;Mord und Totschlag;3103000;Wolfsburg;X;14;0;0;0;0;0;0;0;0;0;0;0;0;0;0;1;8;3;0;2;14
892500;Mord und Totschlag;5124000;Wuppertal;M;7;0;0;0;0;0;0;0;0;0;0;0;2;0;2;0;1;2;2;0;7
892500;Mord und Totschlag;5124000;Wuppertal;W;2;0;0;0;0;0;0;0;1;1;0;1;1;0;1;0;0;0;0;0;1
892500;Mord und Totschlag;5124000;Wuppertal;X;9;0;0;0;0;0;0;0;1;1;0;1;3;0;3;0;1;2;2;0;8
892500;Mord und Totschlag;9663000;Würzburg;M;1;0;0;0;0;0;0;0;0;0;0;0;0;0;0;0;1;0;0;0;1
892500;Mord und Totschlag;9663000;Würzburg;W;1;0;0;0;0;0;0;0;0;0;0;0;0;0;0;0;1;0;0;0;1
892500;Mord und Totschlag;9663000;Würzburg;X;2;0;0;0;0;0;0;0;0;0;0;0;0;0;0;0;2;0;0;0;2
897000;Computerkriminalität;5334002;Aachen;M;83;0;0;0;0;0;0;1;10;11;11;22;5;3;8;14;20;10;9;0;61
897000;Computerkriminalität;5334002;Aachen;W;37;0;0;0;0;0;0;1;2;3;1;4;2;0;2;8;11;8;3;1;33
897000;Computerkriminalität;5334002;Aachen;X;120;0;0;0;0;0;0;2;12;14;12;26;7;3;10;22;31;18;12;1;94
897000;Computerkriminalität;9761000;Augsburg;M;40;0;0;0;0;0;0;0;5;5;3;8;3;1;4;8;5;11;3;1;32
897000;Computerkriminalität;9761000;Augsburg;W;16;0;0;0;0;1;1;0;0;0;2;3;1;2;3;0;6;1;2;1;13
897000;Computerkriminalität;9761000;Augsburg;X;56;0;0;0;0;1;1;0;5;5;5;11;4;3;7;8;11;12;5;2;45
897000;Computerkriminalität;5378004;Bergisch Gladbach;M;10;0;0;0;0;0;0;0;0;0;1;1;1;1;2;3;2;1;1;0;9
897000;Computerkriminalität;5378004;Bergisch Gladbach;W;1;0;0;0;0;0;0;0;0;0;0;0;0;0;0;0;1;0;0;0;1
897000;Computerkriminalität;5378004;Bergisch Gladbach;X;11;0;0;0;0;0;0;0;0;0;1;1;1;1;2;3;3;1;1;0;10
897000;Computerkriminalität;11000000;Berlin;M;635;0;0;0;0;4;4;14;22;36;51;91;50;45;95;100;155;124;49;21;544
897000;Computerkriminalität;11000000;Berlin;W;202;0;0;0;1;1;2;5;4;9;15;26;11;13;24;38;40;40;27;7;176
897000;Computerkriminalität;11000000;Berlin;X;837;0;0;0;1;5;6;19;26;45;66;117;61;58;119;138;195;164;76;28;720
897000;Computerkriminalität;5711000;Bielefeld;M;38;0;0;0;0;1;1;0;0;0;3;4;2;3;5;9;12;7;1;0;34
897000;Computerkriminalität;5711000;Bielefeld;W;12;0;0;0;0;0;0;0;0;0;2;2;0;2;2;2;4;0;1;1;10
897000;Computerkriminalität;5711000;Bielefeld;X;50;0;0;0;0;1;1;0;0;0;5;6;2;5;7;11;16;7;2;1;44
897000;Computerkriminalität;5911000;Bochum;M;64;0;0;0;0;0;0;0;2;2;1;3;4;8;12;10;19;10;6;4;61
897000;Computerkriminalität;5911000;Bochum;W;22;0;0;0;0;1;1;0;0;0;2;3;0;3;3;4;5;3;3;1;19
897000;Computerkriminalität;5911000;Bochum;X;86;0;0;0;0;1;1;0;2;2;3;6;4;11;15;14;24;13;9;5;80
897000;Computerkriminalität;5314000;Bonn;M;45;0;0;0;0;0;0;2;0;2;4;6;3;2;5;7;15;7;4;1;39
897000;Computerkriminalität;5314000;Bonn;W;33;0;0;0;0;1;1;2;2;4;4;9;3;3;6;6;4;7;0;1;24
897000;Computerkriminalität;5314000;Bonn;X;78;0;0;0;0;1;1;4;2;6;8;15;6;5;11;13;19;14;4;2;63
897000;Computerkriminalität;5512000;Bottrop;M;20;0;0;0;0;0;0;2;1;3;2;5;3;3;6;3;4;2;0;0;15
897000;Computerkriminalität;5512000;Bottrop;W;8;0;0;0;0;0;0;0;0;0;1;1;0;2;2;2;1;1;1;0;7
897000;Computerkriminalität;5512000;Bottrop;X;28;0;0;0;0;0;0;2;1;3;3;6;3;5;8;5;5;3;1;0;22
897000;Computerkriminalität;3101000;Braunschweig;M;61;0;0;0;0;0;0;0;1;1;4;5;7;5;12;17;15;7;5;0;56
897000;Computerkriminalität;3101000;Braunschweig;W;20;0;0;0;0;1;1;2;0;2;2;5;2;0;2;1;0;6;3;3;15
897000;Computerkriminalität;3101000;Braunschweig;X;81;0;0;0;0;1;1;2;1;3;6;10;9;5;14;18;15;13;8;3;71
897000;Computerkriminalität;4011000;Bremen;M;154;0;0;0;1;0;1;3;8;11;18;30;12;11;23;34;29;29;7;2;124
897000;Computerkriminalität;4011000;Bremen;W;49;0;0;0;0;0;0;1;3;4;4;8;4;1;5;5;17;6;4;4;41
897000;Computerkriminalität;4011000;Bremen;X;203;0;0;0;1;0;1;4;11;15;22;38;16;12;28;39;46;35;11;6;165
897000;Computerkriminalität;4012000;Bremerhaven;M;19;0;0;0;0;0;0;1;0;1;2;3;0;2;2;4;5;0;4;1;16
897000;Computerkriminalität;4012000;Bremerhaven;W;16;0;0;0;0;0;0;0;0;0;5;5;2;1;3;3;1;1;1;2;11
897000;Computerkriminalität;4012000;Bremerhaven;X;35;0;0;0;0;0;0;1;0;1;7;8;2;3;5;7;6;1;5;3;27
897000;Computerkriminalität;14511000;Chemnitz;M;66;0;0;0;0;0;0;0;0;0;8;8;5;4;9;14;20;9;6;0;58
897000;Computerkriminalität;14511000;Chemnitz;W;27;0;0;0;0;0;0;0;1;1;4;5;3;3;6;4;3;5;4;0;22
897000;Computerkriminalität;14511000;Chemnitz;X;93;0;0;0;0;0;0;0;1;1;12;13;8;7;15;18;23;14;10;0;80
897000;Computerkriminalität;6411000;Darmstadt;M;26;0;0;0;0;0;0;1;1;2;1;3;1;0;1;8;8;4;2;0;23
897000;Computerkriminalität;6411000;Darmstadt;W;6;0;0;0;0;0;0;0;0;0;1;1;1;2;3;1;1;0;0;0;5
897000;Computerkriminalität;6411000;Darmstadt;X;32;0;0;0;0;0;0;1;1;2;2;4;2;2;4;9;9;4;2;0;28
897000;Computerkriminalität;5913000;Dortmund;M;66;0;0;0;0;3;3;2;1;3;10;16;5;5;10;6;20;8;6;0;50
897000;Computerkriminalität;5913000;Dortmund;W;25;0;0;0;1;0;1;0;0;0;2;3;6;0;6;5;4;6;1;0;22
897000;Computerkriminalität;5913000;Dortmund;X;91;0;0;0;1;3;4;2;1;3;12;19;11;5;16;11;24;14;7;0;72
897000;Computerkriminalität;14612000;Dresden;M;112;0;0;0;0;0;0;3;2;5;2;7;4;8;12;20;46;17;8;2;105
897000;Computerkriminalität;14612000;Dresden;W;36;0;0;0;0;1;1;0;0;0;4;5;1;1;2;13;8;7;1;0;31
897000;Computerkriminalität;14612000;Dresden;X;148;0;0;0;0;1;1;3;2;5;6;12;5;9;14;33;54;24;9;2;136
897000;Computerkriminalität;5112000;Duisburg;M;83;0;0;0;0;0;0;2;3;5;9;14;8;5;13;14;15;15;11;1;69
897000;Computerkriminalität;5112000;Duisburg;W;36;0;0;0;0;0;0;1;1;2;5;7;1;3;4;5;4;11;4;1;29
897000;Computerkriminalität;5112000;Duisburg;X;119;0;0;0;0;0;0;3;4;7;14;21;9;8;17;19;19;26;15;2;98
897000;Computerkriminalität;5111000;Düsseldorf;M;78;0;0;0;0;1;1;1;1;2;4;7;8;7;15;14;18;15;5;4;71
897000;Computerkriminalität;5111000;Düsseldorf;W;23;0;0;0;0;0;0;0;0;0;3;3;0;3;3;3;5;8;1;0;20
897000;Computerkriminalität;5111000;Düsseldorf;X;101;0;0;0;0;1;1;1;1;2;7;10;8;10;18;17;23;23;6;4;91
897000;Computerkriminalität;16051000;Erfurt;M;32;0;0;1;0;0;1;0;1;1;3;5;1;3;4;4;9;9;1;0;27
897000;Computerkriminalität;16051000;Erfurt;W;14;0;0;0;0;1;1;1;2;3;2;6;0;2;2;2;3;1;0;0;8
897000;Computerkriminalität;16051000;Erfurt;X;46;0;0;1;0;1;2;1;3;4;5;11;1;5;6;6;12;10;1;0;35
897000;Computerkriminalität;9562000;Erlangen;M;23;0;0;0;0;0;0;2;1;3;4;7;3;1;4;4;6;2;0;0;16
897000;Computerkriminalität;9562000;Erlangen;W;4;0;0;0;0;0;0;0;0;0;0;0;0;0;0;0;2;2;0;0;4
897000;Computerkriminalität;9562000;Erlangen;X;27;0;0;0;0;0;0;2;1;3;4;7;3;1;4;4;8;4;0;0;20
897000;Computerkriminalität;5113000;Essen;M;48;0;0;0;0;0;0;0;2;2;3;5;3;3;6;12;13;8;2;2;43
897000;Computerkriminalität;5113000;Essen;W;16;0;0;0;0;0;0;0;0;0;2;2;0;2;2;3;2;3;4;0;14
897000;Computerkriminalität;5113000;Essen;X;64;0;0;0;0;0;0;0;2;2;5;7;3;5;8;15;15;11;6;2;57
897000;Computerkriminalität;6412000;Frankfurt am Main;M;140;0;0;0;1;0;1;0;2;2;17;20;10;11;21;23;41;23;10;2;120
897000;Computerkriminalität;6412000;Frankfurt am Main;W;58;0;0;0;0;0;0;1;2;3;7;10;7;4;11;6;16;10;3;2;48
897000;Computerkriminalität;6412000;Frankfurt am Main;X;198;0;0;0;1;0;1;1;4;5;24;30;17;15;32;29;57;33;13;4;168
897000;Computerkriminalität;8311000;Freiburg im Breisgau;M;43;0;1;0;0;1;2;0;2;2;2;6;3;3;6;8;11;6;6;0;37
897000;Computerkriminalität;8311000;Freiburg im Breisgau;W;11;0;0;0;0;0;0;1;1;2;1;3;1;0;1;5;2;0;0;0;8
897000;Computerkriminalität;8311000;Freiburg im Breisgau;X;54;0;1;0;0;1;2;1;3;4;3;9;4;3;7;13;13;6;6;0;45
897000;Computerkriminalität;9563000;Fürth;M;15;0;0;0;0;0;0;0;3;3;1;4;1;2;3;1;3;4;0;0;11
897000;Computerkriminalität;9563000;Fürth;W;5;0;0;0;0;0;0;0;0;0;0;0;0;1;1;0;3;1;0;0;5
897000;Computerkriminalität;9563000;Fürth;X;20;0;0;0;0;0;0;0;3;3;1;4;1;3;4;1;6;5;0;0;16
897000;Computerkriminalität;5513000;Gelsenkirchen;M;40;0;0;0;0;1;1;2;1;3;4;8;1;4;5;13;6;5;2;1;32
897000;Computerkriminalität;5513000;Gelsenkirchen;W;11;0;0;0;0;0;0;0;0;0;1;1;1;2;3;1;2;2;1;1;10
897000;Computerkriminalität;5513000;Gelsenkirchen;X;51;0;0;0;0;1;1;2;1;3;5;9;2;6;8;14;8;7;3;2;42
897000;Computerkriminalität;3152012;Göttingen;M;27;0;0;0;0;0;0;0;2;2;1;3;2;1;3;4;10;4;3;0;24
897000;Computerkriminalität;3152012;Göttingen;W;7;0;0;0;0;0;0;0;0;0;1;1;0;0;0;1;3;1;0;1;6
897000;Computerkriminalität;3152012;Göttingen;X;34;0;0;0;0;0;0;0;2;2;2;4;2;1;3;5;13;5;3;1;30
897000;Computerkriminalität;5914000;Hagen;M;46;0;0;0;0;0;0;0;1;1;6;7;6;3;9;8;6;11;4;1;39
897000;Computerkriminalität;5914000;Hagen;W;15;0;0;0;0;0;0;0;1;1;1;2;1;2;3;1;4;3;2;0;13
897000;Computerkriminalität;5914000;Hagen;X;61;0;0;0;0;0;0;0;2;2;7;9;7;5;12;9;10;14;6;1;52
897000;Computerkriminalität;15002000;Halle (Saale);M;78;0;0;0;0;0;0;1;9;10;5;15;4;2;6;8;32;14;2;1;63
897000;Computerkriminalität;15002000;Halle (Saale);W;16;0;0;0;0;0;0;0;0;0;0;0;1;1;2;4;3;5;2;0;16
897000;Computerkriminalität;15002000;Halle (Saale);X;94;0;0;0;0;0;0;1;9;10;5;15;5;3;8;12;35;19;4;1;79
897000;Computerkriminalität;2000000;Hamburg;M;262;0;0;0;0;1;1;3;13;16;27;44;19;24;43;47;57;39;20;12;218
897000;Computerkriminalität;2000000;Hamburg;W;219;0;0;0;0;2;2;3;1;4;23;29;19;32;51;56;55;15;10;3;190
897000;Computerkriminalität;2000000;Hamburg;X;481;0;0;0;0;3;3;6;14;20;50;73;38;56;94;103;112;54;30;15;408
897000;Computerkriminalität;5915000;Hamm;M;28;0;0;0;0;0;0;0;1;1;3;4;0;2;2;6;8;8;0;0;24
897000;Computerkriminalität;5915000;Hamm;W;13;0;0;0;0;0;0;0;0;0;1;1;2;1;3;4;1;2;2;0;12
897000;Computerkriminalität;5915000;Hamm;X;41;0;0;0;0;0;0;0;1;1;4;5;2;3;5;10;9;10;2;0;36
897000;Computerkriminalität;3241001;Hannover;M;147;0;0;0;0;0;0;4;9;13;7;20;13;7;20;27;35;28;11;6;127
897000;Computerkriminalität;3241001;Hannover;W;37;0;0;0;0;0;0;0;1;1;5;6;0;1;1;9;8;7;5;1;31
897000;Computerkriminalität;3241001;Hannover;X;184;0;0;0;0;0;0;4;10;14;12;26;13;8;21;36;43;35;16;7;158
897000;Computerkriminalität;8221000;Heidelberg;M;18;0;0;0;0;0;0;0;0;0;3;3;2;1;3;4;4;2;1;1;15
897000;Computerkriminalität;8221000;Heidelberg;W;17;0;0;0;0;0;0;1;1;2;4;6;3;0;3;0;5;3;0;0;11
897000;Computerkriminalität;8221000;Heidelberg;X;35;0;0;0;0;0;0;1;1;2;7;9;5;1;6;4;9;5;1;1;26
897000;Computerkriminalität;8121000;Heilbronn;M;17;0;0;0;0;0;0;0;2;2;2;4;0;0;0;3;5;3;2;0;13
897000;Computerkriminalität;8121000;Heilbronn;W;8;0;0;0;0;0;0;0;0;0;1;1;0;1;1;2;0;4;0;0;7
897000;Computerkriminalität;8121000;Heilbronn;X;25;0;0;0;0;0;0;0;2;2;3;5;0;1;1;5;5;7;2;0;20
897000;Computerkriminalität;5916000;Herne;M;24;0;0;0;0;0;0;0;1;1;4;5;3;0;3;2;7;5;1;1;19
897000;Computerkriminalität;5916000;Herne;W;12;0;0;0;0;0;0;1;1;2;1;3;1;1;2;4;0;3;0;0;9
897000;Computerkriminalität;5916000;Herne;X;36;0;0;0;0;0;0;1;2;3;5;8;4;1;5;6;7;8;1;1;28
897000;Computerkriminalität;9161000;Ingolstadt;M;23;0;0;0;0;0;0;3;0;3;0;3;3;1;4;4;5;6;1;0;20
897000;Computerkriminalität;9161000;Ingolstadt;W;10;0;0;0;0;0;0;1;0;1;1;2;0;1;1;2;4;1;0;0;8
897000;Computerkriminalität;9161000;Ingolstadt;X;33;0;0;0;0;0;0;4;0;4;1;5;3;2;5;6;9;7;1;0;28
897000;Computerkriminalität;16053000;Jena;M;20;0;0;0;0;0;0;0;0;0;1;1;0;1;1;3;10;4;1;0;19
897000;Computerkriminalität;16053000;Jena;W;4;0;0;0;0;0;0;0;0;0;0;0;0;0;0;2;1;1;0;0;4
897000;Computerkriminalität;16053000;Jena;X;24;0;0;0;0;0;0;0;0;0;1;1;0;1;1;5;11;5;1;0;23
897000;Computerkriminalität;8212000;Karlsruhe;M;71;0;0;1;2;1;4;0;4;4;5;13;7;7;14;8;17;18;1;0;58
897000;Computerkriminalität;8212000;Karlsruhe;W;19;0;0;0;0;0;0;0;0;0;3;3;1;0;1;3;7;2;3;0;16
897000;Computerkriminalität;8212000;Karlsruhe;X;90;0;0;1;2;1;4;0;4;4;8;16;8;7;15;11;24;20;4;0;74
897000;Computerkriminalität;6611000;Kassel;M;39;0;0;0;0;0;0;2;2;4;4;8;3;3;6;1;11;8;1;4;31
897000;Computerkriminalität;6611000;Kassel;W;17;0;0;0;0;0;0;1;0;1;1;2;4;3;7;0;4;4;0;0;15
897000;Computerkriminalität;6611000;Kassel;X;56;0;0;0;0;0;0;3;2;5;5;10;7;6;13;1;15;12;1;4;46
897000;Computerkriminalität;1002000;Kiel;M;59;0;0;0;0;0;0;1;0;1;5;6;8;6;14;8;13;12;5;1;53
897000;Computerkriminalität;1002000;Kiel;W;18;0;0;0;0;0;0;1;0;1;2;3;0;4;4;2;4;3;2;0;15
897000;Computerkriminalität;1002000;Kiel;X;77;0;0;0;0;0;0;2;0;2;7;9;8;10;18;10;17;15;7;1;68
897000;Computerkriminalität;7111000;Koblenz;M;19;0;0;0;0;0;0;2;1;3;2;5;3;2;5;2;4;3;0;0;14
897000;Computerkriminalität;7111000;Koblenz;W;7;0;0;0;0;0;0;0;1;1;0;1;1;0;1;1;3;1;0;0;6
897000;Computerkriminalität;7111000;Koblenz;X;26;0;0;0;0;0;0;2;2;4;2;6;4;2;6;3;7;4;0;0;20
897000;Computerkriminalität;5315000;Köln;M;156;0;0;0;0;1;1;2;4;6;18;25;14;12;26;27;40;21;12;5;131
897000;Computerkriminalität;5315000;Köln;W;56;0;0;0;2;1;3;3;0;3;6;12;2;8;10;6;16;8;3;1;44
897000;Computerkriminalität;5315000;Köln;X;212;0;0;0;2;2;4;5;4;9;24;37;16;20;36;33;56;29;15;6;175
897000;Computerkriminalität;5114000;Krefeld;M;46;0;0;0;0;1;1;3;0;3;5;9;4;4;8;8;9;7;5;0;37
897000;Computerkriminalität;5114000;Krefeld;W;16;0;0;0;0;0;0;0;0;0;2;2;2;1;3;1;3;6;1;0;14
897000;Computerkriminalität;5114000;Krefeld;X;62;0;0;0;0;1;1;3;0;3;7;11;6;5;11;9;12;13;6;0;51
897000;Computerkriminalität;14713000;Leipzig;M;128;0;0;0;0;0;0;2;0;2;7;9;11;9;20;24;50;22;1;2;119
897000;Computerkriminalität;14713000;Leipzig;W;44;0;0;0;0;0;0;1;1;2;2;4;1;3;4;18;9;6;1;2;40
897000;Computerkriminalität;14713000;Leipzig;X;172;0;0;0;0;0;0;3;1;4;9;13;12;12;24;42;59;28;2;4;159
897000;Computerkriminalität;5316000;Leverkusen;M;16;0;0;0;0;0;0;1;0;1;1;2;1;1;2;0;8;2;1;1;14
897000;Computerkriminalität;5316000;Leverkusen;W;4;0;0;0;0;0;0;0;1;1;0;1;0;0;0;1;0;2;0;0;3
897000;Computerkriminalität;5316000;Leverkusen;X;20;0;0;0;0;0;0;1;1;2;1;3;1;1;2;1;8;4;1;1;17
897000;Computerkriminalität;1003000;Lübeck;M;43;0;0;0;1;0;1;0;0;0;4;5;4;3;7;4;11;9;5;2;38
897000;Computerkriminalität;1003000;Lübeck;W;19;0;0;0;0;0;0;1;1;2;4;6;1;1;2;2;3;4;2;0;13
897000;Computerkriminalität;1003000;Lübeck;X;62;0;0;0;1;0;1;1;1;2;8;11;5;4;9;6;14;13;7;2;51
897000;Computerkriminalität;7314000;Ludwigshafen am Rhein;M;43;0;0;0;0;0;0;0;5;5;8;13;3;2;5;7;7;7;4;0;30
897000;Computerkriminalität;7314000;Ludwigshafen am Rhein;W;22;0;0;0;0;0;0;0;2;2;0;2;2;2;4;2;6;5;2;1;20
897000;Computerkriminalität;7314000;Ludwigshafen am Rhein;X;65;0;0;0;0;0;0;0;7;7;8;15;5;4;9;9;13;12;6;1;50
897000;Computerkriminalität;15003000;Magdeburg;M;52;0;0;0;0;0;0;1;1;2;4;6;6;4;10;5;8;9;12;2;46
897000;Computerkriminalität;15003000;Magdeburg;W;30;0;0;0;0;0;0;0;0;0;3;3;0;4;4;4;9;8;1;1;27
897000;Computerkriminalität;15003000;Magdeburg;X;82;0;0;0;0;0;0;1;1;2;7;9;6;8;14;9;17;17;13;3;73
897000;Computerkriminalität;7315000;Mainz;M;34;0;0;0;0;0;0;0;3;3;2;5;4;3;7;6;7;7;2;0;29
897000;Computerkriminalität;7315000;Mainz;W;11;0;0;0;0;0;0;0;1;1;1;2;2;2;4;0;3;0;1;1;9
897000;Computerkriminalität;7315000;Mainz;X;45;0;0;0;0;0;0;0;4;4;3;7;6;5;11;6;10;7;3;1;38
897000;Computerkriminalität;8222000;Mannheim;M;71;0;0;0;0;0;0;0;3;3;10;13;6;4;10;8;20;13;6;1;58
897000;Computerkriminalität;8222000;Mannheim;W;27;0;0;0;0;0;0;0;0;0;2;2;3;3;6;4;8;5;1;1;25
897000;Computerkriminalität;8222000;Mannheim;X;98;0;0;0;0;0;0;0;3;3;12;15;9;7;16;12;28;18;7;2;83
897000;Computerkriminalität;5170024;Moers;M;11;0;0;0;0;0;0;1;0;1;1;2;3;1;4;1;1;3;0;0;9
897000;Computerkriminalität;5170024;Moers;W;4;0;0;0;0;0;0;0;1;1;1;2;1;0;1;0;0;1;0;0;2
897000;Computerkriminalität;5170024;Moers;X;15;0;0;0;0;0;0;1;1;2;2;4;4;1;5;1;1;4;0;0;11
897000;Computerkriminalität;5116000;Mönchengladbach;M;52;0;0;0;0;0;0;1;2;3;3;6;5;2;7;7;20;5;6;1;46
897000;Computerkriminalität;5116000;Mönchengladbach;W;19;0;0;0;0;0;0;1;0;1;2;3;0;1;1;6;3;3;3;0;16
897000;Computerkriminalität;5116000;Mönchengladbach;X;71;0;0;0;0;0;0;2;2;4;5;9;5;3;8;13;23;8;9;1;62
897000;Computerkriminalität;5117000;Mülheim an der Ruhr;M;16;0;0;0;0;0;0;0;0;0;2;2;2;1;3;0;4;5;2;0;14
897000;Computerkriminalität;5117000;Mülheim an der Ruhr;W;2;0;0;0;0;0;0;0;0;0;0;0;0;1;1;0;1;0;0;0;2
897000;Computerkriminalität;5117000;Mülheim an der Ruhr;X;18;0;0;0;0;0;0;0;0;0;2;2;2;2;4;0;5;5;2;0;16
897000;Computerkriminalität;9162000;München;M;199;0;0;0;0;0;0;3;8;11;13;24;12;11;23;36;45;42;21;8;175
897000;Computerkriminalität;9162000;München;W;73;0;0;0;0;1;1;0;4;4;6;11;7;3;10;10;21;14;4;3;62
897000;Computerkriminalität;9162000;München;X;272;0;0;0;0;1;1;3;12;15;19;35;19;14;33;46;66;56;25;11;237
897000;Computerkriminalität;5515000;Münster;M;53;0;0;0;0;0;0;1;2;3;4;7;3;5;8;18;12;2;6;0;46
897000;Computerkriminalität;5515000;Münster;W;13;0;0;0;0;0;0;0;0;0;2;2;2;0;2;5;1;2;0;1;11
897000;Computerkriminalität;5515000;Münster;X;66;0;0;0;0;0;0;1;2;3;6;9;5;5;10;23;13;4;6;1;57
897000;Computerkriminalität;5162024;Neuss;M;19;0;0;0;0;0;0;0;0;0;2;2;0;2;2;5;7;2;0;1;17
897000;Computerkriminalität;5162024;Neuss;W;9;0;0;0;0;0;0;0;0;0;4;4;0;0;0;1;1;2;1;0;5
897000;Computerkriminalität;5162024;Neuss;X;28;0;0;0;0;0;0;0;0;0;6;6;0;2;2;6;8;4;1;1;22
897000;Computerkriminalität;9564000;Nürnberg;M;117;0;0;0;1;1;2;0;2;2;16;20;11;7;18;13;40;17;6;3;97
897000;Computerkriminalität;9564000;Nürnberg;W;38;0;0;0;0;0;0;1;1;2;2;4;3;1;4;8;9;7;4;2;34
897000;Computerkriminalität;9564000;Nürnberg;X;155;0;0;0;1;1;2;1;3;4;18;24;14;8;22;21;49;24;10;5;131
897000;Computerkriminalität;5119000;Oberhausen;M;28;0;0;0;0;1;1;0;0;0;2;3;2;7;9;8;5;3;0;0;25
897000;Computerkriminalität;5119000;Oberhausen;W;14;0;0;0;0;1;1;0;1;1;1;3;1;1;2;2;3;1;2;1;11
897000;Computerkriminalität;5119000;Oberhausen;X;42;0;0;0;0;2;2;0;1;1;3;6;3;8;11;10;8;4;2;1;36
897000;Computerkriminalität;6413000;Offenbach am Main;M;41;0;0;0;0;0;0;0;0;0;3;3;3;3;6;13;10;5;3;1;38
897000;Computerkriminalität;6413000;Offenbach am Main;W;14;0;0;0;0;0;0;0;1;1;2;3;3;1;4;0;4;2;1;0;11
897000;Computerkriminalität;6413000;Offenbach am Main;X;55;0;0;0;0;0;0;0;1;1;5;6;6;4;10;13;14;7;4;1;49
897000;Computerkriminalität;3403000;Oldenburg (Oldenburg);M;46;0;0;0;0;0;0;0;1;1;3;4;7;6;13;9;13;1;4;2;42
897000;Computerkriminalität;3403000;Oldenburg (Oldenburg);W;9;0;0;0;0;0;0;2;1;3;1;4;0;0;0;0;2;1;1;1;5
897000;Computerkriminalität;3403000;Oldenburg (Oldenburg);X;55;0;0;0;0;0;0;2;2;4;4;8;7;6;13;9;15;2;5;3;47
897000;Computerkriminalität;3404000;Osnabrück;M;58;0;0;0;0;0;0;0;0;0;3;3;7;6;13;16;12;8;3;3;55
897000;Computerkriminalität;3404000;Osnabrück;W;22;0;0;0;0;0;0;0;1;1;3;4;8;3;11;1;2;4;0;0;18
897000;Computerkriminalität;3404000;Osnabrück;X;80;0;0;0;0;0;0;0;1;1;6;7;15;9;24;17;14;12;3;3;73
897000;Computerkriminalität;5774032;Paderborn;M;14;0;0;0;0;0;0;0;0;0;5;5;0;0;0;2;4;2;0;1;9
897000;Computerkriminalität;5774032;Paderborn;W;8;0;0;0;0;0;0;0;0;0;0;0;1;1;2;0;0;3;3;0;8
897000;Computerkriminalität;5774032;Paderborn;X;22;0;0;0;0;0;0;0;0;0;5;5;1;1;2;2;4;5;3;1;17
897000;Computerkriminalität;8231000;Pforzheim;M;31;0;0;0;0;0;0;1;0;1;3;4;2;1;3;3;6;9;6;0;27
897000;Computerkriminalität;8231000;Pforzheim;W;12;0;0;0;0;1;1;1;0;1;1;3;2;0;2;3;2;1;1;0;9
897000;Computerkriminalität;8231000;Pforzheim;X;43;0;0;0;0;1;1;2;0;2;4;7;4;1;5;6;8;10;7;0;36
897000;Computerkriminalität;12054000;Potsdam;M;20;0;0;0;0;0;0;0;1;1;1;2;1;1;2;3;5;6;2;0;18
897000;Computerkriminalität;12054000;Potsdam;W;9;0;0;0;0;0;0;0;0;0;0;0;0;0;0;4;4;1;0;0;9
897000;Computerkriminalität;12054000;Potsdam;X;29;0;0;0;0;0;0;0;1;1;1;2;1;1;2;7;9;7;2;0;27
897000;Computerkriminalität;5562032;Recklinghausen;M;32;0;0;0;0;0;0;0;0;0;1;1;1;2;3;7;9;6;5;1;31
897000;Computerkriminalität;5562032;Recklinghausen;W;8;0;0;0;0;0;0;0;0;0;0;0;1;0;1;0;0;2;5;0;8
897000;Computerkriminalität;5562032;Recklinghausen;X;40;0;0;0;0;0;0;0;0;0;1;1;2;2;4;7;9;8;10;1;39
897000;Computerkriminalität;9362000;Regensburg;M;26;0;0;0;0;1;1;3;0;3;1;5;2;1;3;3;8;3;4;0;21
897000;Computerkriminalität;9362000;Regensburg;W;4;0;0;0;0;0;0;1;0;1;0;1;0;0;0;1;2;0;0;0;3
897000;Computerkriminalität;9362000;Regensburg;X;30;0;0;0;0;1;1;4;0;4;1;6;2;1;3;4;10;3;4;0;24
897000;Computerkriminalität;5120000;Remscheid;M;22;0;0;0;0;0;0;0;0;0;0;0;3;2;5;5;7;2;3;0;22
897000;Computerkriminalität;5120000;Remscheid;W;11;0;0;0;0;0;0;0;0;0;1;1;2;2;4;3;2;1;0;0;10
897000;Computerkriminalität;5120000;Remscheid;X;33;0;0;0;0;0;0;0;0;0;1;1;5;4;9;8;9;3;3;0;32
897000;Computerkriminalität;8415061;Reutlingen;M;22;0;0;0;0;0;0;1;1;2;3;5;5;2;7;3;5;1;1;0;17
897000;Computerkriminalität;8415061;Reutlingen;W;6;0;0;0;0;0;0;0;0;0;2;2;0;0;0;0;3;0;1;0;4
897000;Computerkriminalität;8415061;Reutlingen;X;28;0;0;0;0;0;0;1;1;2;5;7;5;2;7;3;8;1;2;0;21
897000;Computerkriminalität;13003000;Rostock;M;49;0;0;0;0;1;1;0;0;0;5;6;3;3;6;14;14;6;2;1;43
897000;Computerkriminalität;13003000;Rostock;W;11;0;0;0;0;0;0;2;0;2;0;2;0;2;2;3;1;2;1;0;9
897000;Computerkriminalität;13003000;Rostock;X;60;0;0;0;0;1;1;2;0;2;5;8;3;5;8;17;15;8;3;1;52
897000;Computerkriminalität;10041100;Saarbrücken;M;37;0;0;0;0;0;0;0;0;0;1;1;3;1;4;10;9;7;6;0;36
897000;Computerkriminalität;10041100;Saarbrücken;W;20;0;0;0;0;0;0;0;2;2;7;9;1;1;2;4;4;0;1;0;11
897000;Computerkriminalität;10041100;Saarbrücken;X;57;0;0;0;0;0;0;0;2;2;8;10;4;2;6;14;13;7;7;0;47
897000;Computerkriminalität;5122000;Solingen;M;20;0;0;0;0;0;0;0;1;1;3;4;0;1;1;1;5;4;3;2;16
897000;Computerkriminalität;5122000;Solingen;W;7;0;0;0;0;0;0;0;1;1;0;1;0;0;0;1;1;1;3;0;6
897000;Computerkriminalität;5122000;Solingen;X;27;0;0;0;0;0;0;0;2;2;3;5;0;1;1;2;6;5;6;2;22
897000;Computerkriminalität;8111000;Stuttgart;M;117;0;0;0;1;2;3;3;4;7;12;22;11;8;19;12;31;20;7;6;95
897000;Computerkriminalität;8111000;Stuttgart;W;64;0;0;0;0;5;5;5;3;8;5;18;5;2;7;10;10;11;4;4;46
897000;Computerkriminalität;8111000;Stuttgart;X;181;0;0;0;1;7;8;8;7;15;17;40;16;10;26;22;41;31;11;10;141
897000;Computerkriminalität;7211000;Trier;M;21;0;0;0;0;0;0;1;3;4;0;4;0;3;3;4;8;1;1;0;17
897000;Computerkriminalität;7211000;Trier;W;9;0;0;0;0;0;0;0;0;0;2;2;0;2;2;2;2;0;1;0;7
897000;Computerkriminalität;7211000;Trier;X;30;0;0;0;0;0;0;1;3;4;2;6;0;5;5;6;10;1;2;0;24
897000;Computerkriminalität;8421000;Ulm;M;17;0;0;0;1;0;1;0;1;1;2;4;0;1;1;3;5;4;0;0;13
897000;Computerkriminalität;8421000;Ulm;W;12;0;0;0;0;0;0;0;0;0;1;1;0;0;0;3;2;2;3;1;11
897000;Computerkriminalität;8421000;Ulm;X;29;0;0;0;1;0;1;0;1;1;3;5;0;1;1;6;7;6;3;1;24
897000;Computerkriminalität;6414000;Wiesbaden;M;69;0;0;0;1;0;1;1;9;10;2;13;6;9;15;11;15;10;3;2;56
897000;Computerkriminalität;6414000;Wiesbaden;W;31;0;0;0;0;1;1;0;1;1;2;4;1;2;3;4;11;5;3;1;27
897000;Computerkriminalität;6414000;Wiesbaden;X;100;0;0;0;1;1;2;1;10;11;4;17;7;11;18;15;26;15;6;3;83
897000;Computerkriminalität;3103000;Wolfsburg;M;21;0;0;0;0;0;0;1;0;1;0;1;4;0;4;7;2;4;1;2;20
897000;Computerkriminalität;3103000;Wolfsburg;W;7;0;0;0;0;0;0;0;0;0;1;1;0;0;0;1;3;1;1;0;6
897000;Computerkriminalität;3103000;Wolfsburg;X;28;0;0;0;0;0;0;1;0;1;1;2;4;0;4;8;5;5;2;2;26
897000;Computerkriminalität;5124000;Wuppertal;M;60;0;0;1;0;0;1;0;4;4;3;8;5;12;17;8;13;8;3;3;52
897000;Computerkriminalität;5124000;Wuppertal;W;23;0;0;0;0;0;0;0;0;0;6;6;1;0;1;5;7;3;1;0;17
897000;Computerkriminalität;5124000;Wuppertal;X;83;0;0;1;0;0;1;0;4;4;9;14;6;12;18;13;20;11;4;3;69
897000;Computerkriminalität;9663000;Würzburg;M;20;0;0;0;0;0;0;0;0;0;3;3;4;1;5;5;3;1;2;1;17
897000;Computerkriminalität;9663000;Würzburg;W;13;0;0;0;0;0;0;1;1;2;1;3;2;1;3;0;4;2;1;0;10
897000;Computerkriminalität;9663000;Würzburg;X;33;0;0;0;0;0;0;1;1;2;4;6;6;2;8;5;7;3;3;1;27
899000;Straßenkriminalität;5334002;Aachen;M;995;2;1;2;6;20;31;74;116;190;157;378;95;84;179;107;165;100;41;25;617
899000;Straßenkriminalität;5334002;Aachen;W;97;0;0;0;0;4;4;10;10;20;5;29;6;8;14;11;16;12;9;6;68
899000;Straßenkriminalität;5334002;Aachen;X;1092;2;1;2;6;24;35;84;126;210;162;407;101;92;193;118;181;112;50;31;685
899000;Straßenkriminalität;9761000;Augsburg;M;639;0;1;7;5;8;21;48;61;109;106;236;61;59;120;98;89;42;30;24;403
899000;Straßenkriminalität;9761000;Augsburg;W;68;0;0;0;1;1;2;8;6;14;6;22;3;9;12;5;14;4;8;3;46
899000;Straßenkriminalität;9761000;Augsburg;X;707;0;1;7;6;9;23;56;67;123;112;258;64;68;132;103;103;46;38;27;449
899000;Straßenkriminalität;5378004;Bergisch Gladbach;M;255;0;0;2;8;4;14;12;34;46;59;119;10;17;27;36;27;30;8;8;136
899000;Straßenkriminalität;5378004;Bergisch Gladbach;W;39;0;0;0;0;0;0;3;5;8;3;11;3;0;3;4;9;5;5;2;28
899000;Straßenkriminalität;5378004;Bergisch Gladbach;X;294;0;0;2;8;4;14;15;39;54;62;130;13;17;30;40;36;35;13;10;164
899000;Straßenkriminalität;11000000;Berlin;M;9892;6;30;57;123;266;482;551;902;1453;1362;3297;737;743;1480;1431;2017;976;444;247;6595
899000;Straßenkriminalität;11000000;Berlin;W;1314;1;6;10;13;82;112;150;106;256;118;486;78;85;163;154;229;150;82;50;828
899000;Straßenkriminalität;11000000;Berlin;X;11206;7;36;67;136;348;594;701;1008;1709;1480;3783;815;828;1643;1585;2246;1126;526;297;7423
899000;Straßenkriminalität;5711000;Bielefeld;M;874;2;0;4;4;12;22;42;79;121;154;297;87;77;164;130;158;69;38;18;577
899000;Straßenkriminalität;5711000;Bielefeld;W;99;0;0;0;0;2;2;19;7;26;11;39;7;4;11;10;19;13;5;2;60
899000;Straßenkriminalität;5711000;Bielefeld;X;973;2;0;4;4;14;24;61;86;147;165;336;94;81;175;140;177;82;43;20;637
899000;Straßenkriminalität;5911000;Bochum;M;1089;1;3;9;18;32;63;52;114;166;178;407;110;81;191;154;166;94;52;25;682
899000;Straßenkriminalität;5911000;Bochum;W;162;0;0;1;0;11;12;14;16;30;20;62;9;8;17;17;23;24;9;10;100
899000;Straßenkriminalität;5911000;Bochum;X;1251;1;3;10;18;43;75;66;130;196;198;469;119;89;208;171;189;118;61;35;782
899000;Straßenkriminalität;5314000;Bonn;M;1110;0;5;10;26;34;75;76;106;182;143;400;87;83;170;149;188;113;55;35;710
899000;Straßenkriminalität;5314000;Bonn;W;165;0;0;0;1;10;11;10;18;28;16;55;12;7;19;18;31;18;12;12;110
899000;Straßenkriminalität;5314000;Bonn;X;1275;0;5;10;27;44;86;86;124;210;159;455;99;90;189;167;219;131;67;47;820
899000;Straßenkriminalität;5512000;Bottrop;M;249;0;1;0;5;6;12;21;27;48;30;90;22;15;37;35;41;23;10;13;159
899000;Straßenkriminalität;5512000;Bottrop;W;30;0;0;0;0;2;2;4;1;5;6;13;3;1;4;2;4;4;2;1;17
899000;Straßenkriminalität;5512000;Bottrop;X;279;0;1;0;5;8;14;25;28;53;36;103;25;16;41;37;45;27;12;14;176
899000;Straßenkriminalität;3101000;Braunschweig;M;998;1;2;7;3;14;27;49;78;127;173;327;100;96;196;141;179;93;39;23;671
899000;Straßenkriminalität;3101000;Braunschweig;W;108;0;0;1;0;7;8;6;6;12;26;46;6;5;11;18;12;12;4;5;62
899000;Straßenkriminalität;3101000;Braunschweig;X;1106;1;2;8;3;21;35;55;84;139;199;373;106;101;207;159;191;105;43;28;733
899000;Straßenkriminalität;4011000;Bremen;M;1820;2;5;4;15;26;52;82;191;273;291;616;169;153;322;257;347;167;67;44;1204
899000;Straßenkriminalität;4011000;Bremen;W;173;0;1;1;0;2;4;8;13;21;24;49;10;11;21;22;38;32;9;2;124
899000;Straßenkriminalität;4011000;Bremen;X;1993;2;6;5;15;28;56;90;204;294;315;665;179;164;343;279;385;199;76;46;1328
899000;Straßenkriminalität;4012000;Bremerhaven;M;419;4;0;5;3;7;19;22;34;56;53;128;39;28;67;62;88;44;20;10;291
899000;Straßenkriminalität;4012000;Bremerhaven;W;46;0;0;0;3;4;7;5;3;8;11;26;3;0;3;2;7;5;2;1;20
899000;Straßenkriminalität;4012000;Bremerhaven;X;465;4;0;5;6;11;26;27;37;64;64;154;42;28;70;64;95;49;22;11;311
899000;Straßenkriminalität;14511000;Chemnitz;M;755;2;1;1;3;13;20;31;45;76;106;202;57;63;120;171;159;68;22;13;553
899000;Straßenkriminalität;14511000;Chemnitz;W;69;0;0;0;3;3;6;8;8;16;4;26;2;3;5;10;12;7;5;4;43
899000;Straßenkriminalität;14511000;Chemnitz;X;824;2;1;1;6;16;26;39;53;92;110;228;59;66;125;181;171;75;27;17;596
899000;Straßenkriminalität;6411000;Darmstadt;M;423;0;0;2;2;7;11;27;62;89;79;179;31;27;58;40;77;42;17;10;244
899000;Straßenkriminalität;6411000;Darmstadt;W;46;0;0;0;0;3;3;1;5;6;6;15;4;4;8;3;7;8;5;0;31
899000;Straßenkriminalität;6411000;Darmstadt;X;469;0;0;2;2;10;14;28;67;95;85;194;35;31;66;43;84;50;22;10;275
899000;Straßenkriminalität;5913000;Dortmund;M;2788;1;6;16;28;61;112;116;283;399;452;963;264;223;487;447;473;252;113;53;1825
899000;Straßenkriminalität;5913000;Dortmund;W;369;0;0;3;2;13;18;25;32;57;46;121;31;25;56;48;71;45;17;11;248
899000;Straßenkriminalität;5913000;Dortmund;X;3157;1;6;19;30;74;130;141;315;456;498;1084;295;248;543;495;544;297;130;64;2073
899000;Straßenkriminalität;14612000;Dresden;M;1632;3;1;3;7;23;37;61;104;165;188;390;147;170;317;325;391;129;51;29;1242
899000;Straßenkriminalität;14612000;Dresden;W;194;0;0;1;1;9;11;34;16;50;23;84;9;18;27;34;28;12;4;5;110
899000;Straßenkriminalität;14612000;Dresden;X;1826;3;1;4;8;32;48;95;120;215;211;474;156;188;344;359;419;141;55;34;1352
899000;Straßenkriminalität;5112000;Duisburg;M;1554;0;13;22;27;65;127;113;151;264;212;603;120;107;227;199;271;163;64;27;951
899000;Straßenkriminalität;5112000;Duisburg;W;213;1;1;3;3;12;20;20;16;36;23;79;17;10;27;20;39;29;11;8;134
899000;Straßenkriminalität;5112000;Duisburg;X;1767;1;14;25;30;77;147;133;167;300;235;682;137;117;254;219;310;192;75;35;1085
899000;Straßenkriminalität;5111000;Düsseldorf;M;2610;1;7;13;28;60;109;116;219;335;481;925;246;228;474;380;434;244;96;57;1685
899000;Straßenkriminalität;5111000;Düsseldorf;W;365;0;3;3;7;21;34;33;35;68;54;156;22;22;44;42;59;29;24;11;209
899000;Straßenkriminalität;5111000;Düsseldorf;X;2975;1;10;16;35;81;143;149;254;403;535;1081;268;250;518;422;493;273;120;68;1894
899000;Straßenkriminalität;16051000;Erfurt;M;506;1;4;4;6;8;23;28;33;61;64;148;41;44;85;106;93;43;10;21;358
899000;Straßenkriminalität;16051000;Erfurt;W;49;0;0;0;2;3;5;5;2;7;4;16;6;5;11;7;7;7;0;1;33
899000;Straßenkriminalität;16051000;Erfurt;X;555;1;4;4;8;11;28;33;35;68;68;164;47;49;96;113;100;50;10;22;391
899000;Straßenkriminalität;9562000;Erlangen;M;320;0;1;0;0;6;7;20;39;59;72;138;35;26;61;39;38;27;10;7;182
899000;Straßenkriminalität;9562000;Erlangen;W;32;0;0;0;0;1;1;5;7;12;2;15;3;2;5;2;3;3;2;2;17
899000;Straßenkriminalität;9562000;Erlangen;X;352;0;1;0;0;7;8;25;46;71;74;153;38;28;66;41;41;30;12;9;199
899000;Straßenkriminalität;5113000;Essen;M;1692;0;0;5;20;59;84;129;194;323;250;657;152;112;264;199;266;195;72;39;1035
899000;Straßenkriminalität;5113000;Essen;W;272;0;0;0;0;18;18;26;19;45;28;91;15;13;28;40;46;34;17;16;181
899000;Straßenkriminalität;5113000;Essen;X;1964;0;0;5;20;77;102;155;213;368;278;748;167;125;292;239;312;229;89;55;1216
899000;Straßenkriminalität;6412000;Frankfurt am Main;M;2598;2;1;10;19;42;74;101;212;313;394;781;206;193;399;410;534;305;114;55;1817
899000;Straßenkriminalität;6412000;Frankfurt am Main;W;333;0;0;1;0;8;9;18;31;49;55;113;29;22;51;39;71;32;19;8;220
899000;Straßenkriminalität;6412000;Frankfurt am Main;X;2931;2;1;11;19;50;83;119;243;362;449;894;235;215;450;449;605;337;133;63;2037
899000;Straßenkriminalität;8311000;Freiburg im Breisgau;M;759;0;1;4;7;14;26;45;130;175;149;350;69;61;130;85;83;68;25;18;409
899000;Straßenkriminalität;8311000;Freiburg im Breisgau;W;79;0;0;0;1;0;1;3;9;12;6;19;6;13;19;11;10;11;6;3;60
899000;Straßenkriminalität;8311000;Freiburg im Breisgau;X;838;0;1;4;8;14;27;48;139;187;155;369;75;74;149;96;93;79;31;21;469
899000;Straßenkriminalität;9563000;Fürth;M;283;0;0;3;8;17;28;21;18;39;50;117;20;17;37;42;47;23;10;7;166
899000;Straßenkriminalität;9563000;Fürth;W;52;0;0;0;2;2;4;4;1;5;8;17;1;4;5;5;8;9;7;1;35
899000;Straßenkriminalität;9563000;Fürth;X;335;0;0;3;10;19;32;25;19;44;58;134;21;21;42;47;55;32;17;8;201
899000;Straßenkriminalität;5513000;Gelsenkirchen;M;969;0;1;9;15;24;49;64;77;141;162;352;90;81;171;126;148;101;52;19;617
899000;Straßenkriminalität;5513000;Gelsenkirchen;W;129;0;2;2;1;10;15;13;10;23;20;58;5;4;9;12;18;20;7;5;71
899000;Straßenkriminalität;5513000;Gelsenkirchen;X;1098;0;3;11;16;34;64;77;87;164;182;410;95;85;180;138;166;121;59;24;688
899000;Straßenkriminalität;3152012;Göttingen;M;382;0;0;3;0;7;10;20;30;50;48;108;33;33;66;57;76;42;19;14;274
899000;Straßenkriminalität;3152012;Göttingen;W;49;0;0;0;0;0;0;3;0;3;5;8;2;2;4;11;10;10;3;3;41
899000;Straßenkriminalität;3152012;Göttingen;X;431;0;0;3;0;7;10;23;30;53;53;116;35;35;70;68;86;52;22;17;315
899000;Straßenkriminalität;5914000;Hagen;M;560;0;6;10;11;25;52;26;68;94;104;250;53;42;95;57;82;49;18;9;310
899000;Straßenkriminalität;5914000;Hagen;W;78;1;0;0;3;7;11;13;8;21;10;42;6;2;8;6;5;12;3;2;36
899000;Straßenkriminalität;5914000;Hagen;X;638;1;6;10;14;32;63;39;76;115;114;292;59;44;103;63;87;61;21;11;346
899000;Straßenkriminalität;15002000;Halle (Saale);M;757;2;3;8;17;14;44;40;62;102;85;231;58;61;119;158;146;62;30;11;526
899000;Straßenkriminalität;15002000;Halle (Saale);W;81;1;1;1;3;10;16;7;3;10;8;34;12;4;16;11;9;4;4;3;47
899000;Straßenkriminalität;15002000;Halle (Saale);X;838;3;4;9;20;24;60;47;65;112;93;265;70;65;135;169;155;66;34;14;573
899000;Straßenkriminalität;2000000;Hamburg;M;6514;5;18;56;83;177;339;336;667;1003;952;2294;510;462;972;906;1232;700;277;133;4220
899000;Straßenkriminalität;2000000;Hamburg;W;900;0;6;8;18;46;78;75;67;142;94;314;60;58;118;113;172;112;43;28;586
899000;Straßenkriminalität;2000000;Hamburg;X;7414;5;24;64;101;223;417;411;734;1145;1046;2608;570;520;1090;1019;1404;812;320;161;4806
899000;Straßenkriminalität;5915000;Hamm;M;529;0;4;3;8;10;25;33;39;72;89;186;48;38;86;70;112;56;11;8;343
899000;Straßenkriminalität;5915000;Hamm;W;87;0;0;0;0;1;1;11;16;27;14;42;7;2;9;10;9;16;1;0;45
899000;Straßenkriminalität;5915000;Hamm;X;616;0;4;3;8;11;26;44;55;99;103;228;55;40;95;80;121;72;12;8;388
899000;Straßenkriminalität;3241001;Hannover;M;2382;1;5;11;29;53;99;132;206;338;390;827;211;182;393;324;428;251;111;48;1555
899000;Straßenkriminalität;3241001;Hannover;W;298;0;0;1;2;14;17;23;19;42;30;89;20;24;44;39;64;34;20;8;209
899000;Straßenkriminalität;3241001;Hannover;X;2680;1;5;12;31;67;116;155;225;380;420;916;231;206;437;363;492;285;131;56;1764
899000;Straßenkriminalität;8221000;Heidelberg;M;317;0;2;0;1;9;12;18;40;58;56;126;30;28;58;37;51;22;15;8;191
899000;Straßenkriminalität;8221000;Heidelberg;W;54;0;0;0;0;1;1;5;2;7;9;17;7;4;11;8;9;7;1;1;37
899000;Straßenkriminalität;8221000;Heidelberg;X;371;0;2;0;1;10;13;23;42;65;65;143;37;32;69;45;60;29;16;9;228
899000;Straßenkriminalität;8121000;Heilbronn;M;255;0;0;0;1;0;1;10;29;39;34;74;25;19;44;41;52;25;10;9;181
899000;Straßenkriminalität;8121000;Heilbronn;W;28;1;0;0;0;0;1;1;3;4;6;11;1;2;3;4;5;2;3;0;17
899000;Straßenkriminalität;8121000;Heilbronn;X;283;1;0;0;1;0;2;11;32;43;40;85;26;21;47;45;57;27;13;9;198
899000;Straßenkriminalität;5916000;Herne;M;489;0;1;2;9;10;22;42;64;106;60;188;32;28;60;77;72;58;22;12;301
899000;Straßenkriminalität;5916000;Herne;W;60;0;0;0;3;1;4;1;8;9;6;19;6;4;10;9;7;12;2;1;41
899000;Straßenkriminalität;5916000;Herne;X;549;0;1;2;12;11;26;43;72;115;66;207;38;32;70;86;79;70;24;13;342
899000;Straßenkriminalität;9161000;Ingolstadt;M;298;0;0;0;1;5;6;17;31;48;40;94;34;22;56;45;55;31;12;5;204
899000;Straßenkriminalität;9161000;Ingolstadt;W;45;0;0;0;0;1;1;6;0;6;8;15;2;1;3;5;11;9;0;2;30
899000;Straßenkriminalität;9161000;Ingolstadt;X;343;0;0;0;1;6;7;23;31;54;48;109;36;23;59;50;66;40;12;7;234
899000;Straßenkriminalität;16053000;Jena;M;231;0;2;0;1;7;10;11;15;26;23;59;20;25;45;34;57;14;15;7;172
899000;Straßenkriminalität;16053000;Jena;W;17;0;0;0;1;2;3;0;1;1;0;4;1;2;3;6;3;0;1;0;13
899000;Straßenkriminalität;16053000;Jena;X;248;0;2;0;2;9;13;11;16;27;23;63;21;27;48;40;60;14;16;7;185
899000;Straßenkriminalität;8212000;Karlsruhe;M;691;0;0;4;0;11;15;32;70;102;93;210;65;58;123;122;134;64;24;14;481
899000;Straßenkriminalität;8212000;Karlsruhe;W;77;0;0;2;0;3;5;7;8;15;5;25;5;10;15;2;16;5;7;7;52
899000;Straßenkriminalität;8212000;Karlsruhe;X;768;0;0;6;0;14;20;39;78;117;98;235;70;68;138;124;150;69;31;21;533
899000;Straßenkriminalität;6611000;Kassel;M;593;0;2;0;4;9;15;23;50;73;82;170;76;51;127;101;107;48;27;13;423
899000;Straßenkriminalität;6611000;Kassel;W;81;0;1;0;0;2;3;5;10;15;16;34;8;7;15;10;10;7;3;2;47
899000;Straßenkriminalität;6611000;Kassel;X;674;0;3;0;4;11;18;28;60;88;98;204;84;58;142;111;117;55;30;15;470
899000;Straßenkriminalität;1002000;Kiel;M;769;0;3;11;8;8;30;31;74;105;129;264;80;71;151;99;116;90;31;18;505
899000;Straßenkriminalität;1002000;Kiel;W;58;0;0;0;0;0;0;5;6;11;5;16;3;3;6;11;9;8;4;4;42
899000;Straßenkriminalität;1002000;Kiel;X;827;0;3;11;8;8;30;36;80;116;134;280;83;74;157;110;125;98;35;22;547
899000;Straßenkriminalität;7111000;Koblenz;M;480;0;1;6;2;10;19;31;43;74;75;168;59;37;96;65;73;41;24;13;312
899000;Straßenkriminalität;7111000;Koblenz;W;56;0;0;1;3;3;7;7;2;9;7;23;7;0;7;3;10;9;3;1;33
899000;Straßenkriminalität;7111000;Koblenz;X;536;0;1;7;5;13;26;38;45;83;82;191;66;37;103;68;83;50;27;14;345
899000;Straßenkriminalität;5315000;Köln;M;5056;0;5;11;43;115;174;231;512;743;782;1699;446;405;851;749;908;528;214;107;3357
899000;Straßenkriminalität;5315000;Köln;W;852;0;0;0;3;47;50;88;76;164;119;333;42;66;108;90;145;99;55;22;519
899000;Straßenkriminalität;5315000;Köln;X;5908;0;5;11;46;162;224;319;588;907;901;2032;488;471;959;839;1053;627;269;129;3876
899000;Straßenkriminalität;5114000;Krefeld;M;706;1;3;5;10;25;44;33;62;95;92;231;52;58;110;98;135;74;39;19;475
899000;Straßenkriminalität;5114000;Krefeld;W;129;1;1;2;1;3;8;18;13;31;9;48;8;8;16;20;18;10;13;4;81
899000;Straßenkriminalität;5114000;Krefeld;X;835;2;4;7;11;28;52;51;75;126;101;279;60;66;126;118;153;84;52;23;556
899000;Straßenkriminalität;14713000;Leipzig;M;2092;0;4;5;23;44;76;75;141;216;245;537;167;210;377;406;495;175;63;39;1555
899000;Straßenkriminalität;14713000;Leipzig;W;250;0;0;3;0;19;22;21;15;36;22;80;10;19;29;53;49;23;12;4;170
899000;Straßenkriminalität;14713000;Leipzig;X;2342;0;4;8;23;63;98;96;156;252;267;617;177;229;406;459;544;198;75;43;1725
899000;Straßenkriminalität;5316000;Leverkusen;M;513;0;3;4;6;25;38;33;47;80;77;195;61;33;94;62;85;37;22;18;318
899000;Straßenkriminalität;5316000;Leverkusen;W;77;0;0;0;0;2;2;8;7;15;8;25;9;5;14;7;13;8;4;6;52
899000;Straßenkriminalität;5316000;Leverkusen;X;590;0;3;4;6;27;40;41;54;95;85;220;70;38;108;69;98;45;26;24;370
899000;Straßenkriminalität;1003000;Lübeck;M;732;0;4;1;5;26;36;51;59;110;81;227;54;64;118;127;128;74;38;20;505
899000;Straßenkriminalität;1003000;Lübeck;W;78;0;0;0;2;3;5;7;6;13;8;26;5;9;14;12;12;8;4;2;52
899000;Straßenkriminalität;1003000;Lübeck;X;810;0;4;1;7;29;41;58;65;123;89;253;59;73;132;139;140;82;42;22;557
899000;Straßenkriminalität;7314000;Ludwigshafen am Rhein;M;586;2;6;12;13;23;56;24;48;72;72;200;54;40;94;85;96;63;33;15;386
899000;Straßenkriminalität;7314000;Ludwigshafen am Rhein;W;113;0;0;2;2;8;12;8;5;13;14;39;16;6;22;9;18;10;11;4;74
899000;Straßenkriminalität;7314000;Ludwigshafen am Rhein;X;699;2;6;14;15;31;68;32;53;85;86;239;70;46;116;94;114;73;44;19;460
899000;Straßenkriminalität;15003000;Magdeburg;M;861;0;1;6;8;20;35;53;63;116;141;292;91;82;173;139;131;77;37;12;569
899000;Straßenkriminalität;15003000;Magdeburg;W;111;0;0;0;1;5;6;17;13;30;11;47;12;11;23;15;12;10;2;2;64
899000;Straßenkriminalität;15003000;Magdeburg;X;972;0;1;6;9;25;41;70;76;146;152;339;103;93;196;154;143;87;39;14;633
899000;Straßenkriminalität;7315000;Mainz;M;678;0;0;2;2;12;16;46;74;120;133;269;68;48;116;91;96;64;32;10;409
899000;Straßenkriminalität;7315000;Mainz;W;76;0;0;0;6;6;12;7;6;13;10;35;4;6;10;5;9;10;4;3;41
899000;Straßenkriminalität;7315000;Mainz;X;754;0;0;2;8;18;28;53;80;133;143;304;72;54;126;96;105;74;36;13;450
899000;Straßenkriminalität;8222000;Mannheim;M;741;0;1;2;6;29;38;43;58;101;99;238;74;51;125;109;139;79;37;14;503
899000;Straßenkriminalität;8222000;Mannheim;W;117;0;0;0;2;4;6;7;10;17;14;37;12;11;23;13;11;22;8;3;80
899000;Straßenkriminalität;8222000;Mannheim;X;858;0;1;2;8;33;44;50;68;118;113;275;86;62;148;122;150;101;45;17;583
899000;Straßenkriminalität;5170024;Moers;M;271;0;1;4;7;11;23;15;23;38;37;98;28;11;39;35;39;32;21;7;173
899000;Straßenkriminalität;5170024;Moers;W;38;0;0;0;0;2;2;2;3;5;3;10;1;1;2;7;7;3;3;6;28
899000;Straßenkriminalität;5170024;Moers;X;309;0;1;4;7;13;25;17;26;43;40;108;29;12;41;42;46;35;24;13;201
899000;Straßenkriminalität;5116000;Mönchengladbach;M;878;1;2;4;7;23;37;48;82;130;147;314;93;70;163;117;143;80;47;14;564
899000;Straßenkriminalität;5116000;Mönchengladbach;W;115;0;0;0;1;10;11;18;7;25;9;45;7;3;10;17;23;12;5;3;70
899000;Straßenkriminalität;5116000;Mönchengladbach;X;993;1;2;4;8;33;48;66;89;155;156;359;100;73;173;134;166;92;52;17;634
899000;Straßenkriminalität;5117000;Mülheim an der Ruhr;M;347;0;1;1;6;24;32;28;45;73;43;148;24;25;49;39;50;31;17;13;199
899000;Straßenkriminalität;5117000;Mülheim an der Ruhr;W;43;0;0;1;1;2;4;2;1;3;1;8;3;6;9;2;8;10;3;3;35
899000;Straßenkriminalität;5117000;Mülheim an der Ruhr;X;390;0;1;2;7;26;36;30;46;76;44;156;27;31;58;41;58;41;20;16;234
899000;Straßenkriminalität;9162000;München;M;3785;0;4;9;23;80;116;205;385;590;617;1323;366;297;663;550;663;330;147;109;2462
899000;Straßenkriminalität;9162000;München;W;422;0;0;5;1;22;28;41;36;77;59;164;24;14;38;52;67;48;29;24;258
899000;Straßenkriminalität;9162000;München;X;4207;0;4;14;24;102;144;246;421;667;676;1487;390;311;701;602;730;378;176;133;2720
899000;Straßenkriminalität;5515000;Münster;M;1062;1;1;3;11;35;51;71;109;180;190;421;108;89;197;127;154;102;38;23;641
899000;Straßenkriminalität;5515000;Münster;W;135;0;0;1;0;3;4;15;14;29;21;54;6;10;16;12;31;8;10;4;81
899000;Straßenkriminalität;5515000;Münster;X;1197;1;1;4;11;38;55;86;123;209;211;475;114;99;213;139;185;110;48;27;722
899000;Straßenkriminalität;5162024;Neuss;M;482;0;0;5;4;13;22;30;48;78;85;185;36;35;71;68;78;53;21;6;297
899000;Straßenkriminalität;5162024;Neuss;W;78;0;0;0;1;8;9;9;8;17;7;33;2;1;3;6;15;14;4;3;45
899000;Straßenkriminalität;5162024;Neuss;X;560;0;0;5;5;21;31;39;56;95;92;218;38;36;74;74;93;67;25;9;342
899000;Straßenkriminalität;9564000;Nürnberg;M;1448;0;3;1;7;21;32;53;104;157;239;428;140;128;268;236;266;155;49;46;1020
899000;Straßenkriminalität;9564000;Nürnberg;W;172;0;0;2;1;3;6;17;9;26;28;60;9;10;19;20;31;26;7;9;112
899000;Straßenkriminalität;9564000;Nürnberg;X;1620;0;3;3;8;24;38;70;113;183;267;488;149;138;287;256;297;181;56;55;1132
899000;Straßenkriminalität;5119000;Oberhausen;M;643;0;0;5;8;15;28;49;63;112;105;245;54;62;116;89;107;54;19;13;398
899000;Straßenkriminalität;5119000;Oberhausen;W;119;0;0;0;0;2;2;14;9;23;17;42;6;6;12;15;23;17;6;4;77
899000;Straßenkriminalität;5119000;Oberhausen;X;762;0;0;5;8;17;30;63;72;135;122;287;60;68;128;104;130;71;25;17;475
899000;Straßenkriminalität;6413000;Offenbach am Main;M;424;0;2;1;1;12;16;36;48;84;57;157;29;27;56;64;74;41;18;14;267
899000;Straßenkriminalität;6413000;Offenbach am Main;W;44;0;0;0;0;2;2;9;6;15;4;21;2;2;4;5;8;3;2;1;23
899000;Straßenkriminalität;6413000;Offenbach am Main;X;468;0;2;1;1;14;18;45;54;99;61;178;31;29;60;69;82;44;20;15;290
899000;Straßenkriminalität;3403000;Oldenburg (Oldenburg);M;525;0;1;3;1;11;16;27;59;86;100;202;45;42;87;77;75;45;25;14;323
899000;Straßenkriminalität;3403000;Oldenburg (Oldenburg);W;78;0;0;0;0;3;3;7;7;14;16;33;8;5;13;7;11;6;4;4;45
899000;Straßenkriminalität;3403000;Oldenburg (Oldenburg);X;603;0;1;3;1;14;19;34;66;100;116;235;53;47;100;84;86;51;29;18;368
899000;Straßenkriminalität;3404000;Osnabrück;M;697;0;1;1;5;12;19;27;40;67;129;215;59;65;124;133;122;55;34;14;482
899000;Straßenkriminalität;3404000;Osnabrück;W;84;0;0;1;0;3;4;11;6;17;10;31;6;4;10;15;11;11;4;2;53
899000;Straßenkriminalität;3404000;Osnabrück;X;781;0;1;2;5;15;23;38;46;84;139;246;65;69;134;148;133;66;38;16;535
899000;Straßenkriminalität;5774032;Paderborn;M;455;0;0;0;1;12;13;22;60;82;88;183;43;37;80;61;77;38;11;5;272
899000;Straßenkriminalität;5774032;Paderborn;W;49;0;0;0;1;1;2;2;3;5;8;15;1;3;4;10;11;8;1;0;34
899000;Straßenkriminalität;5774032;Paderborn;X;504;0;0;0;2;13;15;24;63;87;96;198;44;40;84;71;88;46;12;5;306
899000;Straßenkriminalität;8231000;Pforzheim;M;290;0;2;1;7;6;16;19;40;59;46;121;22;25;47;44;38;26;5;9;169
899000;Straßenkriminalität;8231000;Pforzheim;W;45;0;0;0;0;0;0;1;6;7;7;14;6;5;11;7;4;5;2;2;31
899000;Straßenkriminalität;8231000;Pforzheim;X;335;0;2;1;7;6;16;20;46;66;53;135;28;30;58;51;42;31;7;11;200
899000;Straßenkriminalität;12054000;Potsdam;M;408;1;2;1;1;15;20;28;35;63;44;127;38;42;80;52;88;34;22;5;281
899000;Straßenkriminalität;12054000;Potsdam;W;42;0;0;0;0;1;1;5;6;11;4;16;1;4;5;7;8;2;2;2;26
899000;Straßenkriminalität;12054000;Potsdam;X;450;1;2;1;1;16;21;33;41;74;48;143;39;46;85;59;96;36;24;7;307
899000;Straßenkriminalität;5562032;Recklinghausen;M;419;0;0;2;8;17;27;48;49;97;70;194;29;19;48;48;62;39;17;11;225
899000;Straßenkriminalität;5562032;Recklinghausen;W;64;0;0;0;2;2;4;10;11;21;15;40;4;2;6;3;10;2;3;0;24
899000;Straßenkriminalität;5562032;Recklinghausen;X;483;0;0;2;10;19;31;58;60;118;85;234;33;21;54;51;72;41;20;11;249
899000;Straßenkriminalität;9362000;Regensburg;M;386;0;1;0;1;4;6;11;29;40;65;111;34;39;73;72;78;25;18;9;275
899000;Straßenkriminalität;9362000;Regensburg;W;35;0;0;0;0;3;3;1;2;3;3;9;2;3;5;4;11;5;0;1;26
899000;Straßenkriminalität;9362000;Regensburg;X;421;0;1;0;1;7;9;12;31;43;68;120;36;42;78;76;89;30;18;10;301
899000;Straßenkriminalität;5120000;Remscheid;M;236;0;4;3;8;5;20;12;14;26;39;85;18;15;33;24;41;20;26;7;151
899000;Straßenkriminalität;5120000;Remscheid;W;45;0;0;0;1;2;3;5;4;9;3;15;2;3;5;4;6;9;4;2;30
899000;Straßenkriminalität;5120000;Remscheid;X;281;0;4;3;9;7;23;17;18;35;42;100;20;18;38;28;47;29;30;9;181
899000;Straßenkriminalität;8415061;Reutlingen;M;192;0;0;2;1;3;6;10;25;35;41;82;27;15;42;25;24;10;6;3;110
899000;Straßenkriminalität;8415061;Reutlingen;W;30;0;0;0;1;1;2;4;7;11;4;17;1;3;4;3;3;0;3;0;13
899000;Straßenkriminalität;8415061;Reutlingen;X;222;0;0;2;2;4;8;14;32;46;45;99;28;18;46;28;27;10;9;3;123
899000;Straßenkriminalität;13003000;Rostock;M;648;0;3;6;13;18;40;45;49;94;77;211;61;58;119;112;124;44;21;17;437
899000;Straßenkriminalität;13003000;Rostock;W;73;0;2;0;1;8;11;6;9;15;8;34;3;5;8;10;9;4;3;5;39
899000;Straßenkriminalität;13003000;Rostock;X;721;0;5;6;14;26;51;51;58;109;85;245;64;63;127;122;133;48;24;22;476
899000;Straßenkriminalität;10041100;Saarbrücken;M;674;0;3;4;3;15;25;51;68;119;103;247;63;48;111;94;118;61;25;18;427
899000;Straßenkriminalität;10041100;Saarbrücken;W;129;0;0;2;0;7;9;5;12;17;19;45;8;8;16;16;26;15;9;2;84
899000;Straßenkriminalität;10041100;Saarbrücken;X;803;0;3;6;3;22;34;56;80;136;122;292;71;56;127;110;144;76;34;20;511
899000;Straßenkriminalität;5122000;Solingen;M;381;0;1;4;6;13;24;25;59;84;51;159;28;34;62;33;64;36;14;13;222
899000;Straßenkriminalität;5122000;Solingen;W;64;0;0;1;0;2;3;4;6;10;5;18;5;2;7;8;13;9;6;3;46
899000;Straßenkriminalität;5122000;Solingen;X;445;0;1;5;6;15;27;29;65;94;56;177;33;36;69;41;77;45;20;16;268
899000;Straßenkriminalität;8111000;Stuttgart;M;1610;1;3;10;10;26;50;52;127;179;265;494;150;137;287;255;295;148;75;56;1116
899000;Straßenkriminalität;8111000;Stuttgart;W;221;2;0;3;2;10;17;21;21;42;21;80;12;14;26;40;32;23;14;6;141
899000;Straßenkriminalität;8111000;Stuttgart;X;1831;3;3;13;12;36;67;73;148;221;286;574;162;151;313;295;327;171;89;62;1257
899000;Straßenkriminalität;7211000;Trier;M;328;0;0;2;7;6;15;17;41;58;52;125;29;31;60;41;50;29;12;11;203
899000;Straßenkriminalität;7211000;Trier;W;33;0;0;0;0;2;2;3;5;8;4;14;0;3;3;5;5;2;3;1;19
899000;Straßenkriminalität;7211000;Trier;X;361;0;0;2;7;8;17;20;46;66;56;139;29;34;63;46;55;31;15;12;222
899000;Straßenkriminalität;8421000;Ulm;M;305;0;0;3;2;4;9;9;45;54;39;102;30;26;56;48;49;28;16;6;203
899000;Straßenkriminalität;8421000;Ulm;W;44;0;0;0;0;4;4;2;5;7;13;24;3;1;4;8;3;2;3;0;20
899000;Straßenkriminalität;8421000;Ulm;X;349;0;0;3;2;8;13;11;50;61;52;126;33;27;60;56;52;30;19;6;223
899000;Straßenkriminalität;6414000;Wiesbaden;M;905;0;1;7;13;30;51;62;100;162;167;380;86;57;143;121;120;79;41;21;525
899000;Straßenkriminalität;6414000;Wiesbaden;W;150;0;0;2;6;10;18;23;18;41;12;71;8;8;16;16;20;12;10;5;79
899000;Straßenkriminalität;6414000;Wiesbaden;X;1055;0;1;9;19;40;69;85;118;203;179;451;94;65;159;137;140;91;51;26;604
899000;Straßenkriminalität;3103000;Wolfsburg;M;351;1;2;2;0;13;18;21;41;62;58;138;34;31;65;62;48;14;15;9;213
899000;Straßenkriminalität;3103000;Wolfsburg;W;35;0;0;0;0;2;2;6;5;11;6;19;2;1;3;5;2;1;2;3;16
899000;Straßenkriminalität;3103000;Wolfsburg;X;386;1;2;2;0;15;20;27;46;73;64;157;36;32;68;67;50;15;17;12;229
899000;Straßenkriminalität;5124000;Wuppertal;M;1013;0;4;17;15;27;63;69;108;177;163;403;70;70;140;120;168;109;43;30;610
899000;Straßenkriminalität;5124000;Wuppertal;W;171;0;0;0;1;8;9;25;17;42;19;70;16;9;25;19;25;16;13;3;101
899000;Straßenkriminalität;5124000;Wuppertal;X;1184;0;4;17;16;35;72;94;125;219;182;473;86;79;165;139;193;125;56;33;711
899000;Straßenkriminalität;9663000;Würzburg;M;311;0;0;1;1;1;3;17;28;45;48;96;45;24;69;51;56;22;9;8;215
899000;Straßenkriminalität;9663000;Würzburg;W;43;0;0;0;1;1;2;2;9;11;6;19;3;1;4;5;9;2;2;2;24
899000;Straßenkriminalität;9663000;Würzburg;X;354;0;0;1;2;2;5;19;37;56;54;115;48;25;73;56;65;24;11;10;239
899500;Sachbeschädigung durch Graffiti insgesamt;5334002;Aachen;M;35;0;0;1;0;0;1;2;9;11;9;21;6;0;6;2;3;1;1;1;14
899500;Sachbeschädigung durch Graffiti insgesamt;5334002;Aachen;W;5;0;0;0;0;0;0;3;1;4;1;5;0;0;0;0;0;0;0;0;0
899500;Sachbeschädigung durch Graffiti insgesamt;5334002;Aachen;X;40;0;0;1;0;0;1;5;10;15;10;26;6;0;6;2;3;1;1;1;14
899500;Sachbeschädigung durch Graffiti insgesamt;9761000;Augsburg;M;31;0;0;0;1;1;2;9;7;16;7;25;0;2;2;2;2;0;0;0;6
899500;Sachbeschädigung durch Graffiti insgesamt;9761000;Augsburg;W;1;0;0;0;0;0;0;0;0;0;1;1;0;0;0;0;0;0;0;0;0
899500;Sachbeschädigung durch Graffiti insgesamt;9761000;Augsburg;X;32;0;0;0;1;1;2;9;7;16;8;26;0;2;2;2;2;0;0;0;6
899500;Sachbeschädigung durch Graffiti insgesamt;5378004;Bergisch Gladbach;M;20;0;0;0;0;1;1;1;9;10;9;20;0;0;0;0;0;0;0;0;0
899500;Sachbeschädigung durch Graffiti insgesamt;5378004;Bergisch Gladbach;W;0;0;0;0;0;0;0;0;0;0;0;0;0;0;0;0;0;0;0;0;0
899500;Sachbeschädigung durch Graffiti insgesamt;5378004;Bergisch Gladbach;X;20;0;0;0;0;1;1;1;9;10;9;20;0;0;0;0;0;0;0;0;0
899500;Sachbeschädigung durch Graffiti insgesamt;11000000;Berlin;M;1075;0;0;0;10;46;56;102;132;234;200;490;108;132;240;209;108;17;7;4;585
899500;Sachbeschädigung durch Graffiti insgesamt;11000000;Berlin;W;98;0;0;0;3;11;14;22;14;36;11;61;9;6;15;12;6;3;0;1;37
899500;Sachbeschädigung durch Graffiti insgesamt;11000000;Berlin;X;1173;0;0;0;13;57;70;124;146;270;211;551;117;138;255;221;114;20;7;5;622
899500;Sachbeschädigung durch Graffiti insgesamt;5711000;Bielefeld;M;56;0;0;0;0;2;2;6;6;12;12;26;11;7;18;9;2;0;1;0;30
899500;Sachbeschädigung durch Graffiti insgesamt;5711000;Bielefeld;W;10;0;0;0;0;0;0;6;3;9;0;9;1;0;1;0;0;0;0;0;1
899500;Sachbeschädigung durch Graffiti insgesamt;5711000;Bielefeld;X;66;0;0;0;0;2;2;12;9;21;12;35;12;7;19;9;2;0;1;0;31
899500;Sachbeschädigung durch Graffiti insgesamt;5911000;Bochum;M;36;0;0;0;2;0;2;2;3;5;12;19;5;5;10;4;1;1;1;0;17
899500;Sachbeschädigung durch Graffiti insgesamt;5911000;Bochum;W;4;0;0;0;0;0;0;2;0;2;0;2;0;1;1;0;0;1;0;0;2
899500;Sachbeschädigung durch Graffiti insgesamt;5911000;Bochum;X;40;0;0;0;2;0;2;4;3;7;12;21;5;6;11;4;1;2;1;0;19
899500;Sachbeschädigung durch Graffiti insgesamt;5314000;Bonn;M;49;0;0;1;0;1;2;6;12;18;9;29;5;4;9;7;3;1;0;0;20
899500;Sachbeschädigung durch Graffiti insgesamt;5314000;Bonn;W;6;0;0;0;1;0;1;1;1;2;1;4;0;0;0;0;1;1;0;0;2
899500;Sachbeschädigung durch Graffiti insgesamt;5314000;Bonn;X;55;0;0;1;1;1;3;7;13;20;10;33;5;4;9;7;4;2;0;0;22
899500;Sachbeschädigung durch Graffiti insgesamt;5512000;Bottrop;M;5;0;0;0;0;0;0;0;1;1;3;4;1;0;1;0;0;0;0;0;1
899500;Sachbeschädigung durch Graffiti insgesamt;5512000;Bottrop;W;0;0;0;0;0;0;0;0;0;0;0;0;0;0;0;0;0;0;0;0;0
899500;Sachbeschädigung durch Graffiti insgesamt;5512000;Bottrop;X;5;0;0;0;0;0;0;0;1;1;3;4;1;0;1;0;0;0;0;0;1
899500;Sachbeschädigung durch Graffiti insgesamt;3101000;Braunschweig;M;64;0;0;2;0;1;3;8;6;14;17;34;6;6;12;9;8;0;1;0;30
899500;Sachbeschädigung durch Graffiti insgesamt;3101000;Braunschweig;W;4;0;0;0;0;2;2;0;0;0;1;3;1;0;1;0;0;0;0;0;1
899500;Sachbeschädigung durch Graffiti insgesamt;3101000;Braunschweig;X;68;0;0;2;0;3;5;8;6;14;18;37;7;6;13;9;8;0;1;0;31
899500;Sachbeschädigung durch Graffiti insgesamt;4011000;Bremen;M;95;0;0;0;3;1;4;6;14;20;18;42;7;7;14;14;12;9;1;3;53
899500;Sachbeschädigung durch Graffiti insgesamt;4011000;Bremen;W;22;0;0;0;1;5;6;2;3;5;2;13;1;1;2;0;2;3;2;0;9
899500;Sachbeschädigung durch Graffiti insgesamt;4011000;Bremen;X;117;0;0;0;4;6;10;8;17;25;20;55;8;8;16;14;14;12;3;3;62
899500;Sachbeschädigung durch Graffiti insgesamt;4012000;Bremerhaven;M;18;0;1;0;0;1;2;6;2;8;3;13;0;0;0;4;1;0;0;0;5
899500;Sachbeschädigung durch Graffiti insgesamt;4012000;Bremerhaven;W;12;0;0;0;2;4;6;3;0;3;2;11;0;0;0;0;0;1;0;0;1
899500;Sachbeschädigung durch Graffiti insgesamt;4012000;Bremerhaven;X;30;0;1;0;2;5;8;9;2;11;5;24;0;0;0;4;1;1;0;0;6
899500;Sachbeschädigung durch Graffiti insgesamt;14511000;Chemnitz;M;53;0;0;0;0;1;1;9;9;18;8;27;3;5;8;10;3;1;2;2;26
899500;Sachbeschädigung durch Graffiti insgesamt;14511000;Chemnitz;W;5;0;0;0;1;1;2;2;0;2;1;5;0;0;0;0;0;0;0;0;0
899500;Sachbeschädigung durch Graffiti insgesamt;14511000;Chemnitz;X;58;0;0;0;1;2;3;11;9;20;9;32;3;5;8;10;3;1;2;2;26
899500;Sachbeschädigung durch Graffiti insgesamt;6411000;Darmstadt;M;21;0;0;0;0;0;0;1;8;9;1;10;3;1;4;5;2;0;0;0;11
899500;Sachbeschädigung durch Graffiti insgesamt;6411000;Darmstadt;W;3;0;0;0;0;0;0;1;0;1;0;1;0;1;1;1;0;0;0;0;2
899500;Sachbeschädigung durch Graffiti insgesamt;6411000;Darmstadt;X;24;0;0;0;0;0;0;2;8;10;1;11;3;2;5;6;2;0;0;0;13
899500;Sachbeschädigung durch Graffiti insgesamt;5913000;Dortmund;M;129;0;0;0;0;2;2;16;26;42;29;73;9;10;19;15;15;4;3;0;56
899500;Sachbeschädigung durch Graffiti insgesamt;5913000;Dortmund;W;12;0;0;0;0;0;0;1;5;6;1;7;3;0;3;0;1;0;1;0;5
899500;Sachbeschädigung durch Graffiti insgesamt;5913000;Dortmund;X;141;0;0;0;0;2;2;17;31;48;30;80;12;10;22;15;16;4;4;0;61
899500;Sachbeschädigung durch Graffiti insgesamt;14612000;Dresden;M;73;0;0;3;1;4;8;5;14;19;7;34;5;7;12;19;6;2;0;0;39
899500;Sachbeschädigung durch Graffiti insgesamt;14612000;Dresden;W;6;0;0;0;0;2;2;2;1;3;0;5;1;0;1;0;0;0;0;0;1
899500;Sachbeschädigung durch Graffiti insgesamt;14612000;Dresden;X;79;0;0;3;1;6;10;7;15;22;7;39;6;7;13;19;6;2;0;0;40
899500;Sachbeschädigung durch Graffiti insgesamt;5112000;Duisburg;M;65;0;0;0;1;5;6;11;9;20;17;43;8;4;12;4;4;2;0;0;22
899500;Sachbeschädigung durch Graffiti insgesamt;5112000;Duisburg;W;8;0;0;0;0;2;2;1;0;1;2;5;1;1;2;0;0;1;0;0;3
899500;Sachbeschädigung durch Graffiti insgesamt;5112000;Duisburg;X;73;0;0;0;1;7;8;12;9;21;19;48;9;5;14;4;4;3;0;0;25
899500;Sachbeschädigung durch Graffiti insgesamt;5111000;Düsseldorf;M;82;0;0;0;2;3;5;10;22;32;9;46;5;7;12;12;8;2;1;1;36
899500;Sachbeschädigung durch Graffiti insgesamt;5111000;Düsseldorf;W;7;0;0;0;1;1;2;1;2;3;1;6;0;0;0;0;0;1;0;0;1
899500;Sachbeschädigung durch Graffiti insgesamt;5111000;Düsseldorf;X;89;0;0;0;3;4;7;11;24;35;10;52;5;7;12;12;8;3;1;1;37
899500;Sachbeschädigung durch Graffiti insgesamt;16051000;Erfurt;M;63;0;0;0;3;4;7;7;10;17;10;34;6;9;15;12;2;0;0;0;29
899500;Sachbeschädigung durch Graffiti insgesamt;16051000;Erfurt;W;4;0;0;0;1;0;1;0;2;2;1;4;0;0;0;0;0;0;0;0;0
899500;Sachbeschädigung durch Graffiti insgesamt;16051000;Erfurt;X;67;0;0;0;4;4;8;7;12;19;11;38;6;9;15;12;2;0;0;0;29
899500;Sachbeschädigung durch Graffiti insgesamt;9562000;Erlangen;M;20;0;0;0;0;2;2;9;1;10;6;18;0;1;1;0;1;0;0;0;2
899500;Sachbeschädigung durch Graffiti insgesamt;9562000;Erlangen;W;3;0;0;0;0;0;0;2;1;3;0;3;0;0;0;0;0;0;0;0;0
899500;Sachbeschädigung durch Graffiti insgesamt;9562000;Erlangen;X;23;0;0;0;0;2;2;11;2;13;6;21;0;1;1;0;1;0;0;0;2
899500;Sachbeschädigung durch Graffiti insgesamt;5113000;Essen;M;60;0;0;0;0;2;2;15;19;34;8;44;2;2;4;6;4;1;0;1;16
899500;Sachbeschädigung durch Graffiti insgesamt;5113000;Essen;W;7;0;0;0;0;1;1;2;0;2;1;4;0;0;0;1;0;2;0;0;3
899500;Sachbeschädigung durch Graffiti insgesamt;5113000;Essen;X;67;0;0;0;0;3;3;17;19;36;9;48;2;2;4;7;4;3;0;1;19
899500;Sachbeschädigung durch Graffiti insgesamt;6412000;Frankfurt am Main;M;70;0;1;1;0;4;6;8;5;13;20;39;3;6;9;13;5;3;0;1;31
899500;Sachbeschädigung durch Graffiti insgesamt;6412000;Frankfurt am Main;W;6;0;0;0;0;0;0;1;3;4;0;4;0;0;0;1;1;0;0;0;2
899500;Sachbeschädigung durch Graffiti insgesamt;6412000;Frankfurt am Main;X;76;0;1;1;0;4;6;9;8;17;20;43;3;6;9;14;6;3;0;1;33
899500;Sachbeschädigung durch Graffiti insgesamt;8311000;Freiburg im Breisgau;M;31;0;0;0;0;1;1;7;5;12;6;19;2;2;4;4;1;0;0;3;12
899500;Sachbeschädigung durch Graffiti insgesamt;8311000;Freiburg im Breisgau;W;6;0;0;0;0;0;0;0;1;1;0;1;0;0;0;2;1;2;0;0;5
899500;Sachbeschädigung durch Graffiti insgesamt;8311000;Freiburg im Breisgau;X;37;0;0;0;0;1;1;7;6;13;6;20;2;2;4;6;2;2;0;3;17
899500;Sachbeschädigung durch Graffiti insgesamt;9563000;Fürth;M;25;0;0;1;0;6;7;7;1;8;6;21;3;0;3;1;0;0;0;0;4
899500;Sachbeschädigung durch Graffiti insgesamt;9563000;Fürth;W;2;0;0;0;0;0;0;0;1;1;0;1;1;0;1;0;0;0;0;0;1
899500;Sachbeschädigung durch Graffiti insgesamt;9563000;Fürth;X;27;0;0;1;0;6;7;7;2;9;6;22;4;0;4;1;0;0;0;0;5
899500;Sachbeschädigung durch Graffiti insgesamt;5513000;Gelsenkirchen;M;13;0;0;0;0;0;0;2;1;3;4;7;1;4;5;1;0;0;0;0;6
899500;Sachbeschädigung durch Graffiti insgesamt;5513000;Gelsenkirchen;W;1;0;0;0;0;0;0;0;0;0;0;0;0;0;0;1;0;0;0;0;1
899500;Sachbeschädigung durch Graffiti insgesamt;5513000;Gelsenkirchen;X;14;0;0;0;0;0;0;2;1;3;4;7;1;4;5;2;0;0;0;0;7
899500;Sachbeschädigung durch Graffiti insgesamt;3152012;Göttingen;M;8;0;0;0;0;2;2;0;0;0;3;5;1;1;2;1;0;0;0;0;3
899500;Sachbeschädigung durch Graffiti insgesamt;3152012;Göttingen;W;1;0;0;0;0;0;0;0;0;0;0;0;0;0;0;0;0;0;1;0;1
899500;Sachbeschädigung durch Graffiti insgesamt;3152012;Göttingen;X;9;0;0;0;0;2;2;0;0;0;3;5;1;1;2;1;0;0;1;0;4
899500;Sachbeschädigung durch Graffiti insgesamt;5914000;Hagen;M;11;0;0;0;0;2;2;0;5;5;1;8;0;0;0;1;2;0;0;0;3
899500;Sachbeschädigung durch Graffiti insgesamt;5914000;Hagen;W;1;0;0;0;0;0;0;0;0;0;0;0;0;1;1;0;0;0;0;0;1
899500;Sachbeschädigung durch Graffiti insgesamt;5914000;Hagen;X;12;0;0;0;0;2;2;0;5;5;1;8;0;1;1;1;2;0;0;0;4
899500;Sachbeschädigung durch Graffiti insgesamt;15002000;Halle (Saale);M;88;0;0;0;0;6;6;11;10;21;15;42;4;11;15;19;6;4;2;0;46
899500;Sachbeschädigung durch Graffiti insgesamt;15002000;Halle (Saale);W;5;0;0;0;0;1;1;1;0;1;1;3;1;0;1;0;0;1;0;0;2
899500;Sachbeschädigung durch Graffiti insgesamt;15002000;Halle (Saale);X;93;0;0;0;0;7;7;12;10;22;16;45;5;11;16;19;6;5;2;0;48
899500;Sachbeschädigung durch Graffiti insgesamt;2000000;Hamburg;M;436;0;0;3;5;33;41;60;62;122;73;236;53;24;77;59;47;12;1;4;200
899500;Sachbeschädigung durch Graffiti insgesamt;2000000;Hamburg;W;42;0;0;0;0;4;4;10;6;16;4;24;6;1;7;5;2;4;0;0;18
899500;Sachbeschädigung durch Graffiti insgesamt;2000000;Hamburg;X;478;0;0;3;5;37;45;70;68;138;77;260;59;25;84;64;49;16;1;4;218
899500;Sachbeschädigung durch Graffiti insgesamt;5915000;Hamm;M;25;0;0;0;0;0;0;4;2;6;1;7;6;2;8;4;6;0;0;0;18
899500;Sachbeschädigung durch Graffiti insgesamt;5915000;Hamm;W;1;0;0;0;0;0;0;1;0;1;0;1;0;0;0;0;0;0;0;0;0
899500;Sachbeschädigung durch Graffiti insgesamt;5915000;Hamm;X;26;0;0;0;0;0;0;5;2;7;1;8;6;2;8;4;6;0;0;0;18
899500;Sachbeschädigung durch Graffiti insgesamt;3241001;Hannover;M;177;0;0;0;0;3;3;28;25;53;40;96;25;13;38;30;7;3;3;0;81
899500;Sachbeschädigung durch Graffiti insgesamt;3241001;Hannover;W;20;0;0;0;0;0;0;5;1;6;3;9;4;3;7;2;0;1;1;0;11
899500;Sachbeschädigung durch Graffiti insgesamt;3241001;Hannover;X;197;0;0;0;0;3;3;33;26;59;43;105;29;16;45;32;7;4;4;0;92
899500;Sachbeschädigung durch Graffiti insgesamt;8221000;Heidelberg;M;21;0;0;0;4;2;6;1;3;4;4;14;4;0;4;0;1;0;0;2;7
899500;Sachbeschädigung durch Graffiti insgesamt;8221000;Heidelberg;W;1;0;0;0;0;0;0;0;0;0;0;0;0;0;0;1;0;0;0;0;1
899500;Sachbeschädigung durch Graffiti insgesamt;8221000;Heidelberg;X;22;0;0;0;4;2;6;1;3;4;4;14;4;0;4;1;1;0;0;2;8
899500;Sachbeschädigung durch Graffiti insgesamt;8121000;Heilbronn;M;9;0;0;0;1;4;5;0;1;1;0;6;0;0;0;1;1;1;0;0;3
899500;Sachbeschädigung durch Graffiti insgesamt;8121000;Heilbronn;W;1;0;0;0;0;1;1;0;0;0;0;1;0;0;0;0;0;0;0;0;0
899500;Sachbeschädigung durch Graffiti insgesamt;8121000;Heilbronn;X;10;0;0;0;1;5;6;0;1;1;0;7;0;0;0;1;1;1;0;0;3
899500;Sachbeschädigung durch Graffiti insgesamt;5916000;Herne;M;22;0;0;1;0;2;3;3;2;5;5;13;0;4;4;4;1;0;0;0;9
899500;Sachbeschädigung durch Graffiti insgesamt;5916000;Herne;W;3;0;0;0;2;1;3;0;0;0;0;3;0;0;0;0;0;0;0;0;0
899500;Sachbeschädigung durch Graffiti insgesamt;5916000;Herne;X;25;0;0;1;2;3;6;3;2;5;5;16;0;4;4;4;1;0;0;0;9
899500;Sachbeschädigung durch Graffiti insgesamt;9161000;Ingolstadt;M;4;0;0;0;0;1;1;0;0;0;0;1;1;0;1;2;0;0;0;0;3
899500;Sachbeschädigung durch Graffiti insgesamt;9161000;Ingolstadt;W;0;0;0;0;0;0;0;0;0;0;0;0;0;0;0;0;0;0;0;0;0
899500;Sachbeschädigung durch Graffiti insgesamt;9161000;Ingolstadt;X;4;0;0;0;0;1;1;0;0;0;0;1;1;0;1;2;0;0;0;0;3
899500;Sachbeschädigung durch Graffiti insgesamt;16053000;Jena;M;17;0;0;0;0;0;0;0;5;5;1;6;5;2;7;2;1;1;0;0;11
899500;Sachbeschädigung durch Graffiti insgesamt;16053000;Jena;W;1;0;0;0;0;0;0;0;0;0;0;0;0;0;0;1;0;0;0;0;1
899500;Sachbeschädigung durch Graffiti insgesamt;16053000;Jena;X;18;0;0;0;0;0;0;0;5;5;1;6;5;2;7;3;1;1;0;0;12
899500;Sachbeschädigung durch Graffiti insgesamt;8212000;Karlsruhe;M;23;0;0;0;0;2;2;3;5;8;5;15;0;2;2;2;2;1;1;0;8
899500;Sachbeschädigung durch Graffiti insgesamt;8212000;Karlsruhe;W;1;0;0;0;0;0;0;1;0;1;0;1;0;0;0;0;0;0;0;0;0
899500;Sachbeschädigung durch Graffiti insgesamt;8212000;Karlsruhe;X;24;0;0;0;0;2;2;4;5;9;5;16;0;2;2;2;2;1;1;0;8
899500;Sachbeschädigung durch Graffiti insgesamt;6611000;Kassel;M;9;0;0;0;0;0;0;0;2;2;3;5;1;1;2;0;2;0;0;0;4
899500;Sachbeschädigung durch Graffiti insgesamt;6611000;Kassel;W;1;0;0;0;0;0;0;1;0;1;0;1;0;0;0;0;0;0;0;0;0
899500;Sachbeschädigung durch Graffiti insgesamt;6611000;Kassel;X;10;0;0;0;0;0;0;1;2;3;3;6;1;1;2;0;2;0;0;0;4
899500;Sachbeschädigung durch Graffiti insgesamt;1002000;Kiel;M;48;0;1;0;3;3;7;3;6;9;6;22;7;6;13;3;4;1;3;2;26
899500;Sachbeschädigung durch Graffiti insgesamt;1002000;Kiel;W;6;0;0;0;1;1;2;0;1;1;0;3;0;0;0;2;0;0;1;0;3
899500;Sachbeschädigung durch Graffiti insgesamt;1002000;Kiel;X;54;0;1;0;4;4;9;3;7;10;6;25;7;6;13;5;4;1;4;2;29
899500;Sachbeschädigung durch Graffiti insgesamt;7111000;Koblenz;M;10;0;1;1;0;0;2;2;0;2;0;4;2;3;5;1;0;0;0;0;6
899500;Sachbeschädigung durch Graffiti insgesamt;7111000;Koblenz;W;1;0;0;0;1;0;1;0;0;0;0;1;0;0;0;0;0;0;0;0;0
899500;Sachbeschädigung durch Graffiti insgesamt;7111000;Koblenz;X;11;0;1;1;1;0;3;2;0;2;0;5;2;3;5;1;0;0;0;0;6
899500;Sachbeschädigung durch Graffiti insgesamt;5315000;Köln;M;156;0;0;0;0;3;3;19;21;40;30;73;20;12;32;29;16;5;1;0;83
899500;Sachbeschädigung durch Graffiti insgesamt;5315000;Köln;W;16;0;0;0;0;1;1;4;3;7;4;12;0;0;0;2;1;1;0;0;4
899500;Sachbeschädigung durch Graffiti insgesamt;5315000;Köln;X;172;0;0;0;0;4;4;23;24;47;34;85;20;12;32;31;17;6;1;0;87
899500;Sachbeschädigung durch Graffiti insgesamt;5114000;Krefeld;M;25;0;0;2;1;3;6;2;6;8;2;16;0;4;4;0;2;2;1;0;9
899500;Sachbeschädigung durch Graffiti insgesamt;5114000;Krefeld;W;5;0;0;0;0;0;0;0;1;1;0;1;0;1;1;1;1;0;1;0;4
899500;Sachbeschädigung durch Graffiti insgesamt;5114000;Krefeld;X;30;0;0;2;1;3;6;2;7;9;2;17;0;5;5;1;3;2;2;0;13
899500;Sachbeschädigung durch Graffiti insgesamt;14713000;Leipzig;M;224;0;0;0;4;19;23;25;33;58;47;128;27;19;46;32;14;2;2;0;96
899500;Sachbeschädigung durch Graffiti insgesamt;14713000;Leipzig;W;19;0;0;2;0;4;6;5;2;7;1;14;2;0;2;2;0;1;0;0;5
899500;Sachbeschädigung durch Graffiti insgesamt;14713000;Leipzig;X;243;0;0;2;4;23;29;30;35;65;48;142;29;19;48;34;14;3;2;0;101
899500;Sachbeschädigung durch Graffiti insgesamt;5316000;Leverkusen;M;17;0;1;4;1;2;8;3;3;6;2;16;0;0;0;0;1;0;0;0;1
899500;Sachbeschädigung durch Graffiti insgesamt;5316000;Leverkusen;W;3;0;0;0;0;0;0;2;0;2;1;3;0;0;0;0;0;0;0;0;0
899500;Sachbeschädigung durch Graffiti insgesamt;5316000;Leverkusen;X;20;0;1;4;1;2;8;5;3;8;3;19;0;0;0;0;1;0;0;0;1
899500;Sachbeschädigung durch Graffiti insgesamt;1003000;Lübeck;M;45;0;0;0;0;2;2;3;9;12;14;28;2;3;5;4;3;2;1;2;17
899500;Sachbeschädigung durch Graffiti insgesamt;1003000;Lübeck;W;4;0;0;0;0;3;3;0;0;0;1;4;0;0;0;0;0;0;0;0;0
899500;Sachbeschädigung durch Graffiti insgesamt;1003000;Lübeck;X;49;0;0;0;0;5;5;3;9;12;15;32;2;3;5;4;3;2;1;2;17
899500;Sachbeschädigung durch Graffiti insgesamt;7314000;Ludwigshafen am Rhein;M;13;0;0;0;0;0;0;1;1;2;1;3;1;1;2;2;4;1;1;0;10
899500;Sachbeschädigung durch Graffiti insgesamt;7314000;Ludwigshafen am Rhein;W;0;0;0;0;0;0;0;0;0;0;0;0;0;0;0;0;0;0;0;0;0
899500;Sachbeschädigung durch Graffiti insgesamt;7314000;Ludwigshafen am Rhein;X;13;0;0;0;0;0;0;1;1;2;1;3;1;1;2;2;4;1;1;0;10
899500;Sachbeschädigung durch Graffiti insgesamt;15003000;Magdeburg;M;62;0;0;1;0;7;8;5;7;12;18;38;8;6;14;8;2;0;0;0;24
899500;Sachbeschädigung durch Graffiti insgesamt;15003000;Magdeburg;W;14;0;0;0;0;4;4;4;2;6;1;11;2;0;2;1;0;0;0;0;3
899500;Sachbeschädigung durch Graffiti insgesamt;15003000;Magdeburg;X;76;0;0;1;0;11;12;9;9;18;19;49;10;6;16;9;2;0;0;0;27
899500;Sachbeschädigung durch Graffiti insgesamt;7315000;Mainz;M;11;0;0;0;0;0;0;0;1;1;3;4;3;3;6;1;0;0;0;0;7
899500;Sachbeschädigung durch Graffiti insgesamt;7315000;Mainz;W;6;0;0;0;2;2;4;0;1;1;0;5;0;0;0;0;1;0;0;0;1
899500;Sachbeschädigung durch Graffiti insgesamt;7315000;Mainz;X;17;0;0;0;2;2;4;0;2;2;3;9;3;3;6;1;1;0;0;0;8
899500;Sachbeschädigung durch Graffiti insgesamt;8222000;Mannheim;M;13;0;0;0;0;1;1;0;1;1;6;8;1;1;2;2;1;0;0;0;5
899500;Sachbeschädigung durch Graffiti insgesamt;8222000;Mannheim;W;0;0;0;0;0;0;0;0;0;0;0;0;0;0;0;0;0;0;0;0;0
899500;Sachbeschädigung durch Graffiti insgesamt;8222000;Mannheim;X;13;0;0;0;0;1;1;0;1;1;6;8;1;1;2;2;1;0;0;0;5
899500;Sachbeschädigung durch Graffiti insgesamt;5170024;Moers;M;10;0;0;0;1;1;2;1;1;2;1;5;2;1;3;1;1;0;0;0;5
899500;Sachbeschädigung durch Graffiti insgesamt;5170024;Moers;W;1;0;0;0;0;0;0;0;1;1;0;1;0;0;0;0;0;0;0;0;0
899500;Sachbeschädigung durch Graffiti insgesamt;5170024;Moers;X;11;0;0;0;1;1;2;1;2;3;1;6;2;1;3;1;1;0;0;0;5
899500;Sachbeschädigung durch Graffiti insgesamt;5116000;Mönchengladbach;M;33;0;0;0;1;3;4;1;7;8;5;17;5;3;8;5;0;1;2;0;16
899500;Sachbeschädigung durch Graffiti insgesamt;5116000;Mönchengladbach;W;1;0;0;0;0;0;0;1;0;1;0;1;0;0;0;0;0;0;0;0;0
899500;Sachbeschädigung durch Graffiti insgesamt;5116000;Mönchengladbach;X;34;0;0;0;1;3;4;2;7;9;5;18;5;3;8;5;0;1;2;0;16
899500;Sachbeschädigung durch Graffiti insgesamt;5117000;Mülheim an der Ruhr;M;17;0;0;1;1;2;4;1;4;5;1;10;1;2;3;2;2;0;0;0;7
899500;Sachbeschädigung durch Graffiti insgesamt;5117000;Mülheim an der Ruhr;W;1;0;0;0;0;0;0;1;0;1;0;1;0;0;0;0;0;0;0;0;0
899500;Sachbeschädigung durch Graffiti insgesamt;5117000;Mülheim an der Ruhr;X;18;0;0;1;1;2;4;2;4;6;1;11;1;2;3;2;2;0;0;0;7
899500;Sachbeschädigung durch Graffiti insgesamt;9162000;München;M;130;0;0;1;1;4;6;11;25;36;34;76;13;7;20;13;13;3;2;3;54
899500;Sachbeschädigung durch Graffiti insgesamt;9162000;München;W;20;0;0;2;0;5;7;2;5;7;2;16;1;0;1;1;1;1;0;0;4
899500;Sachbeschädigung durch Graffiti insgesamt;9162000;München;X;150;0;0;3;1;9;13;13;30;43;36;92;14;7;21;14;14;4;2;3;58
899500;Sachbeschädigung durch Graffiti insgesamt;5515000;Münster;M;27;0;1;0;1;1;3;1;3;4;7;14;2;1;3;4;2;2;2;0;13
899500;Sachbeschädigung durch Graffiti insgesamt;5515000;Münster;W;2;0;0;0;0;0;0;1;0;1;1;2;0;0;0;0;0;0;0;0;0
899500;Sachbeschädigung durch Graffiti insgesamt;5515000;Münster;X;29;0;1;0;1;1;3;2;3;5;8;16;2;1;3;4;2;2;2;0;13
899500;Sachbeschädigung durch Graffiti insgesamt;5162024;Neuss;M;22;0;0;0;0;2;2;3;8;11;5;18;3;0;3;0;1;0;0;0;4
899500;Sachbeschädigung durch Graffiti insgesamt;5162024;Neuss;W;1;0;0;0;0;0;0;0;0;0;0;0;0;0;0;0;0;0;1;0;1
899500;Sachbeschädigung durch Graffiti insgesamt;5162024;Neuss;X;23;0;0;0;0;2;2;3;8;11;5;18;3;0;3;0;1;0;1;0;5
899500;Sachbeschädigung durch Graffiti insgesamt;9564000;Nürnberg;M;56;0;2;1;2;1;6;4;7;11;13;30;9;2;11;8;5;1;0;1;26
899500;Sachbeschädigung durch Graffiti insgesamt;9564000;Nürnberg;W;9;0;0;1;1;0;2;4;1;5;1;8;0;1;1;0;0;0;0;0;1
899500;Sachbeschädigung durch Graffiti insgesamt;9564000;Nürnberg;X;65;0;2;2;3;1;8;8;8;16;14;38;9;3;12;8;5;1;0;1;27
899500;Sachbeschädigung durch Graffiti insgesamt;5119000;Oberhausen;M;14;0;0;1;0;0;1;0;0;0;3;4;1;2;3;2;3;2;0;0;10
899500;Sachbeschädigung durch Graffiti insgesamt;5119000;Oberhausen;W;5;0;0;0;0;0;0;0;0;0;2;2;0;0;0;0;0;3;0;0;3
899500;Sachbeschädigung durch Graffiti insgesamt;5119000;Oberhausen;X;19;0;0;1;0;0;1;0;0;0;5;6;1;2;3;2;3;5;0;0;13
899500;Sachbeschädigung durch Graffiti insgesamt;6413000;Offenbach am Main;M;8;2;0;1;0;0;3;0;3;3;0;6;0;1;1;0;0;0;1;0;2
899500;Sachbeschädigung durch Graffiti insgesamt;6413000;Offenbach am Main;W;1;0;0;1;0;0;1;0;0;0;0;1;0;0;0;0;0;0;0;0;0
899500;Sachbeschädigung durch Graffiti insgesamt;6413000;Offenbach am Main;X;9;2;0;2;0;0;4;0;3;3;0;7;0;1;1;0;0;0;1;0;2
899500;Sachbeschädigung durch Graffiti insgesamt;3403000;Oldenburg (Oldenburg);M;45;0;0;0;0;0;0;7;5;12;17;29;4;6;10;4;2;0;0;0;16
899500;Sachbeschädigung durch Graffiti insgesamt;3403000;Oldenburg (Oldenburg);W;7;0;0;0;0;0;0;2;1;3;1;4;0;0;0;1;0;1;1;0;3
899500;Sachbeschädigung durch Graffiti insgesamt;3403000;Oldenburg (Oldenburg);X;52;0;0;0;0;0;0;9;6;15;18;33;4;6;10;5;2;1;1;0;19
899500;Sachbeschädigung durch Graffiti insgesamt;3404000;Osnabrück;M;19;0;0;0;0;0;0;3;5;8;2;10;2;0;2;1;4;1;1;0;9
899500;Sachbeschädigung durch Graffiti insgesamt;3404000;Osnabrück;W;5;0;0;0;0;0;0;4;1;5;0;5;0;0;0;0;0;0;0;0;0
899500;Sachbeschädigung durch Graffiti insgesamt;3404000;Osnabrück;X;24;0;0;0;0;0;0;7;6;13;2;15;2;0;2;1;4;1;1;0;9
899500;Sachbeschädigung durch Graffiti insgesamt;5774032;Paderborn;M;6;0;0;0;0;0;0;0;2;2;3;5;1;0;1;0;0;0;0;0;1
899500;Sachbeschädigung durch Graffiti insgesamt;5774032;Paderborn;W;1;0;0;0;0;0;0;0;1;1;0;1;0;0;0;0;0;0;0;0;0
899500;Sachbeschädigung durch Graffiti insgesamt;5774032;Paderborn;X;7;0;0;0;0;0;0;0;3;3;3;6;1;0;1;0;0;0;0;0;1
899500;Sachbeschädigung durch Graffiti insgesamt;8231000;Pforzheim;M;1;0;0;0;0;0;0;0;0;0;0;0;1;0;1;0;0;0;0;0;1
899500;Sachbeschädigung durch Graffiti insgesamt;8231000;Pforzheim;W;2;0;0;0;0;2;2;0;0;0;0;2;0;0;0;0;0;0;0;0;0
899500;Sachbeschädigung durch Graffiti insgesamt;8231000;Pforzheim;X;3;0;0;0;0;2;2;0;0;0;0;2;1;0;1;0;0;0;0;0;1
899500;Sachbeschädigung durch Graffiti insgesamt;12054000;Potsdam;M;74;0;0;0;0;5;5;16;23;39;10;54;1;3;4;9;6;1;0;0;20
899500;Sachbeschädigung durch Graffiti insgesamt;12054000;Potsdam;W;2;0;0;0;0;0;0;0;0;0;1;1;0;0;0;1;0;0;0;0;1
899500;Sachbeschädigung durch Graffiti insgesamt;12054000;Potsdam;X;76;0;0;0;0;5;5;16;23;39;11;55;1;3;4;10;6;1;0;0;21
899500;Sachbeschädigung durch Graffiti insgesamt;5562032;Recklinghausen;M;16;0;0;2;1;1;4;3;4;7;2;13;1;0;1;2;0;0;0;0;3
899500;Sachbeschädigung durch Graffiti insgesamt;5562032;Recklinghausen;W;1;0;0;0;0;0;0;1;0;1;0;1;0;0;0;0;0;0;0;0;0
899500;Sachbeschädigung durch Graffiti insgesamt;5562032;Recklinghausen;X;17;0;0;2;1;1;4;4;4;8;2;14;1;0;1;2;0;0;0;0;3
899500;Sachbeschädigung durch Graffiti insgesamt;9362000;Regensburg;M;11;0;0;0;1;1;2;3;3;6;2;10;0;0;0;0;0;1;0;0;1
899500;Sachbeschädigung durch Graffiti insgesamt;9362000;Regensburg;W;1;0;0;0;0;0;0;0;1;1;0;1;0;0;0;0;0;0;0;0;0
899500;Sachbeschädigung durch Graffiti insgesamt;9362000;Regensburg;X;12;0;0;0;1;1;2;3;4;7;2;11;0;0;0;0;0;1;0;0;1
899500;Sachbeschädigung durch Graffiti insgesamt;5120000;Remscheid;M;14;0;1;0;3;0;4;3;2;5;1;10;1;0;1;0;2;1;0;0;4
899500;Sachbeschädigung durch Graffiti insgesamt;5120000;Remscheid;W;3;0;0;0;0;0;0;0;1;1;0;1;1;0;1;0;0;0;0;1;2
899500;Sachbeschädigung durch Graffiti insgesamt;5120000;Remscheid;X;17;0;1;0;3;0;4;3;3;6;1;11;2;0;2;0;2;1;0;1;6
899500;Sachbeschädigung durch Graffiti insgesamt;8415061;Reutlingen;M;8;0;0;0;1;0;1;5;0;5;0;6;1;0;1;0;1;0;0;0;2
899500;Sachbeschädigung durch Graffiti insgesamt;8415061;Reutlingen;W;2;0;0;0;2;0;2;0;0;0;0;2;0;0;0;0;0;0;0;0;0
899500;Sachbeschädigung durch Graffiti insgesamt;8415061;Reutlingen;X;10;0;0;0;3;0;3;5;0;5;0;8;1;0;1;0;1;0;0;0;2
899500;Sachbeschädigung durch Graffiti insgesamt;13003000;Rostock;M;75;0;0;3;1;5;9;16;13;29;12;50;4;6;10;10;5;0;0;0;25
899500;Sachbeschädigung durch Graffiti insgesamt;13003000;Rostock;W;8;0;0;0;1;2;3;3;1;4;1;8;0;0;0;0;0;0;0;0;0
899500;Sachbeschädigung durch Graffiti insgesamt;13003000;Rostock;X;83;0;0;3;2;7;12;19;14;33;13;58;4;6;10;10;5;0;0;0;25
899500;Sachbeschädigung durch Graffiti insgesamt;10041100;Saarbrücken;M;48;0;0;1;0;2;3;8;14;22;6;31;6;2;8;3;6;0;0;0;17
899500;Sachbeschädigung durch Graffiti insgesamt;10041100;Saarbrücken;W;3;0;0;1;0;0;1;1;1;2;0;3;0;0;0;0;0;0;0;0;0
899500;Sachbeschädigung durch Graffiti insgesamt;10041100;Saarbrücken;X;51;0;0;2;0;2;4;9;15;24;6;34;6;2;8;3;6;0;0;0;17
899500;Sachbeschädigung durch Graffiti insgesamt;5122000;Solingen;M;10;0;0;0;1;0;1;1;0;1;3;5;2;1;3;2;0;0;0;0;5
899500;Sachbeschädigung durch Graffiti insgesamt;5122000;Solingen;W;1;0;0;0;0;0;0;0;0;0;0;0;0;0;0;0;1;0;0;0;1
899500;Sachbeschädigung durch Graffiti insgesamt;5122000;Solingen;X;11;0;0;0;1;0;1;1;0;1;3;5;2;1;3;2;1;0;0;0;6
899500;Sachbeschädigung durch Graffiti insgesamt;8111000;Stuttgart;M;65;0;0;0;0;10;10;14;10;24;4;38;6;5;11;6;9;0;1;0;27
899500;Sachbeschädigung durch Graffiti insgesamt;8111000;Stuttgart;W;11;0;0;0;2;1;3;6;2;8;0;11;0;0;0;0;0;0;0;0;0
899500;Sachbeschädigung durch Graffiti insgesamt;8111000;Stuttgart;X;76;0;0;0;2;11;13;20;12;32;4;49;6;5;11;6;9;0;1;0;27
899500;Sachbeschädigung durch Graffiti insgesamt;7211000;Trier;M;6;0;0;0;0;0;0;0;0;0;3;3;0;3;3;0;0;0;0;0;3
899500;Sachbeschädigung durch Graffiti insgesamt;7211000;Trier;W;2;0;0;0;0;0;0;0;0;0;1;1;0;1;1;0;0;0;0;0;1
899500;Sachbeschädigung durch Graffiti insgesamt;7211000;Trier;X;8;0;0;0;0;0;0;0;0;0;4;4;0;4;4;0;0;0;0;0;4
899500;Sachbeschädigung durch Graffiti insgesamt;8421000;Ulm;M;12;0;0;0;0;0;0;1;1;2;3;5;3;0;3;4;0;0;0;0;7
899500;Sachbeschädigung durch Graffiti insgesamt;8421000;Ulm;W;1;0;0;0;0;0;0;0;0;0;0;0;0;0;0;0;0;0;1;0;1
899500;Sachbeschädigung durch Graffiti insgesamt;8421000;Ulm;X;13;0;0;0;0;0;0;1;1;2;3;5;3;0;3;4;0;0;1;0;8
899500;Sachbeschädigung durch Graffiti insgesamt;6414000;Wiesbaden;M;25;0;0;0;1;1;2;7;6;13;5;20;1;1;2;0;2;1;0;0;5
899500;Sachbeschädigung durch Graffiti insgesamt;6414000;Wiesbaden;W;3;0;0;0;0;0;0;1;1;2;1;3;0;0;0;0;0;0;0;0;0
899500;Sachbeschädigung durch Graffiti insgesamt;6414000;Wiesbaden;X;28;0;0;0;1;1;2;8;7;15;6;23;1;1;2;0;2;1;0;0;5
899500;Sachbeschädigung durch Graffiti insgesamt;3103000;Wolfsburg;M;13;0;0;0;0;4;4;0;1;1;1;6;1;1;2;1;4;0;0;0;7
899500;Sachbeschädigung durch Graffiti insgesamt;3103000;Wolfsburg;W;5;0;0;0;0;0;0;1;2;3;1;4;0;0;0;0;1;0;0;0;1
899500;Sachbeschädigung durch Graffiti insgesamt;3103000;Wolfsburg;X;18;0;0;0;0;4;4;1;3;4;2;10;1;1;2;1;5;0;0;0;8
899500;Sachbeschädigung durch Graffiti insgesamt;5124000;Wuppertal;M;46;0;0;0;1;0;1;7;7;14;12;27;3;4;7;4;6;1;1;0;19
899500;Sachbeschädigung durch Graffiti insgesamt;5124000;Wuppertal;W;8;0;0;0;0;0;0;0;0;0;3;3;0;2;2;2;0;1;0;0;5
899500;Sachbeschädigung durch Graffiti insgesamt;5124000;Wuppertal;X;54;0;0;0;1;0;1;7;7;14;15;30;3;6;9;6;6;2;1;0;24
899500;Sachbeschädigung durch Graffiti insgesamt;9663000;Würzburg;M;15;0;0;0;0;1;1;3;2;5;1;7;1;1;2;2;3;0;0;1;8
899500;Sachbeschädigung durch Graffiti insgesamt;9663000;Würzburg;W;2;0;0;0;0;0;0;0;0;0;1;1;1;0;1;0;0;0;0;0;1
899500;Sachbeschädigung durch Graffiti insgesamt;9663000;Würzburg;X;17;0;0;0;0;1;1;3;2;5;2;8;2;1;3;2;3;0;0;1;9
972500;Unerlaubt eingereiste/aufhältige Personen (SZ: 725100, 725700);5334002;Aachen;M;2502;0;0;0;0;3;3;160;319;479;342;824;197;254;451;549;481;168;22;7;1678
972500;Unerlaubt eingereiste/aufhältige Personen (SZ: 725100, 725700);5334002;Aachen;W;374;0;0;0;0;0;0;15;25;40;47;87;39;33;72;69;80;43;17;6;287
972500;Unerlaubt eingereiste/aufhältige Personen (SZ: 725100, 725700);5334002;Aachen;X;2876;0;0;0;0;3;3;175;344;519;389;911;236;287;523;618;561;211;39;13;1965
972500;Unerlaubt eingereiste/aufhältige Personen (SZ: 725100, 725700);9761000;Augsburg;M;373;0;0;0;0;0;0;15;54;69;32;101;33;45;78;75;80;31;5;3;272
972500;Unerlaubt eingereiste/aufhältige Personen (SZ: 725100, 725700);9761000;Augsburg;W;70;0;0;0;0;0;0;0;6;6;12;18;6;7;13;13;11;6;7;2;52
972500;Unerlaubt eingereiste/aufhältige Personen (SZ: 725100, 725700);9761000;Augsburg;X;443;0;0;0;0;0;0;15;60;75;44;119;39;52;91;88;91;37;12;5;324
972500;Unerlaubt eingereiste/aufhältige Personen (SZ: 725100, 725700);5378004;Bergisch Gladbach;M;10;0;0;0;0;0;0;0;2;2;1;3;0;1;1;2;2;1;1;0;7
972500;Unerlaubt eingereiste/aufhältige Personen (SZ: 725100, 725700);5378004;Bergisch Gladbach;W;4;0;0;0;0;0;0;1;1;2;0;2;0;0;0;0;1;1;0;0;2
972500;Unerlaubt eingereiste/aufhältige Personen (SZ: 725100, 725700);5378004;Bergisch Gladbach;X;14;0;0;0;0;0;0;1;3;4;1;5;0;1;1;2;3;2;1;0;9
972500;Unerlaubt eingereiste/aufhältige Personen (SZ: 725100, 725700);11000000;Berlin;M;3086;40;9;11;7;10;77;144;259;403;294;774;212;249;461;598;748;327;132;46;2312
972500;Unerlaubt eingereiste/aufhältige Personen (SZ: 725100, 725700);11000000;Berlin;W;1121;45;11;8;10;8;82;48;51;99;77;258;48;70;118;188;286;127;82;62;863
972500;Unerlaubt eingereiste/aufhältige Personen (SZ: 725100, 725700);11000000;Berlin;X;4207;85;20;19;17;18;159;192;310;502;371;1032;260;319;579;786;1034;454;214;108;3175
972500;Unerlaubt eingereiste/aufhältige Personen (SZ: 725100, 725700);5711000;Bielefeld;M;358;4;0;0;0;1;5;11;95;106;26;137;21;21;42;55;83;29;8;4;221
972500;Unerlaubt eingereiste/aufhältige Personen (SZ: 725100, 725700);5711000;Bielefeld;W;89;4;3;2;0;0;9;1;9;10;3;22;1;8;9;13;26;10;7;2;67
972500;Unerlaubt eingereiste/aufhältige Personen (SZ: 725100, 725700);5711000;Bielefeld;X;447;8;3;2;0;1;14;12;104;116;29;159;22;29;51;68;109;39;15;6;288
972500;Unerlaubt eingereiste/aufhältige Personen (SZ: 725100, 725700);5911000;Bochum;M;64;0;0;0;0;0;0;0;9;9;5;14;5;7;12;15;15;8;0;0;50
972500;Unerlaubt eingereiste/aufhältige Personen (SZ: 725100, 725700);5911000;Bochum;W;10;0;1;0;0;0;1;0;2;2;2;5;1;1;2;0;1;1;1;0;5
972500;Unerlaubt eingereiste/aufhältige Personen (SZ: 725100, 725700);5911000;Bochum;X;74;0;1;0;0;0;1;0;11;11;7;19;6;8;14;15;16;9;1;0;55
972500;Unerlaubt eingereiste/aufhältige Personen (SZ: 725100, 725700);5314000;Bonn;M;181;0;0;0;0;0;0;3;10;13;19;32;18;23;41;42;47;12;4;3;149
972500;Unerlaubt eingereiste/aufhältige Personen (SZ: 725100, 725700);5314000;Bonn;W;55;0;0;0;0;0;0;1;2;3;3;6;5;1;6;10;20;7;3;3;49
972500;Unerlaubt eingereiste/aufhältige Personen (SZ: 725100, 725700);5314000;Bonn;X;236;0;0;0;0;0;0;4;12;16;22;38;23;24;47;52;67;19;7;6;198
972500;Unerlaubt eingereiste/aufhältige Personen (SZ: 725100, 725700);5512000;Bottrop;M;3;0;0;0;0;0;0;0;0;0;0;0;0;0;0;0;2;1;0;0;3
972500;Unerlaubt eingereiste/aufhältige Personen (SZ: 725100, 725700);5512000;Bottrop;W;0;0;0;0;0;0;0;0;0;0;0;0;0;0;0;0;0;0;0;0;0
972500;Unerlaubt eingereiste/aufhältige Personen (SZ: 725100, 725700);5512000;Bottrop;X;3;0;0;0;0;0;0;0;0;0;0;0;0;0;0;0;2;1;0;0;3
972500;Unerlaubt eingereiste/aufhältige Personen (SZ: 725100, 725700);3101000;Braunschweig;M;313;9;1;1;1;0;12;1;7;8;71;91;25;30;55;79;57;24;6;1;222
972500;Unerlaubt eingereiste/aufhältige Personen (SZ: 725100, 725700);3101000;Braunschweig;W;81;7;1;1;1;1;11;3;0;3;13;27;8;4;12;10;19;7;4;2;54
972500;Unerlaubt eingereiste/aufhältige Personen (SZ: 725100, 725700);3101000;Braunschweig;X;394;16;2;2;2;1;23;4;7;11;84;118;33;34;67;89;76;31;10;3;276
972500;Unerlaubt eingereiste/aufhältige Personen (SZ: 725100, 725700);4011000;Bremen;M;426;2;1;1;1;2;7;52;147;199;24;230;21;18;39;49;74;24;7;3;196
972500;Unerlaubt eingereiste/aufhältige Personen (SZ: 725100, 725700);4011000;Bremen;W;168;2;2;1;1;2;8;6;21;27;12;47;8;7;15;27;47;19;5;8;121
972500;Unerlaubt eingereiste/aufhältige Personen (SZ: 725100, 725700);4011000;Bremen;X;594;4;3;2;2;4;15;58;168;226;36;277;29;25;54;76;121;43;12;11;317
972500;Unerlaubt eingereiste/aufhältige Personen (SZ: 725100, 725700);4012000;Bremerhaven;M;19;0;0;0;0;0;0;2;1;3;2;5;1;1;2;4;6;1;1;0;14
972500;Unerlaubt eingereiste/aufhältige Personen (SZ: 725100, 725700);4012000;Bremerhaven;W;2;0;0;0;0;0;0;0;0;0;0;0;1;0;1;0;0;0;1;0;2
972500;Unerlaubt eingereiste/aufhältige Personen (SZ: 725100, 725700);4012000;Bremerhaven;X;21;0;0;0;0;0;0;2;1;3;2;5;2;1;3;4;6;1;2;0;16
972500;Unerlaubt eingereiste/aufhältige Personen (SZ: 725100, 725700);14511000;Chemnitz;M;1548;68;29;36;24;37;194;43;56;99;136;429;111;136;247;255;370;163;67;17;1119
972500;Unerlaubt eingereiste/aufhältige Personen (SZ: 725100, 725700);14511000;Chemnitz;W;819;81;18;19;18;21;157;18;28;46;54;257;42;48;90;114;201;94;50;13;562
972500;Unerlaubt eingereiste/aufhältige Personen (SZ: 725100, 725700);14511000;Chemnitz;X;2367;149;47;55;42;58;351;61;84;145;190;686;153;184;337;369;571;257;117;30;1681
972500;Unerlaubt eingereiste/aufhältige Personen (SZ: 725100, 725700);6411000;Darmstadt;M;65;0;0;0;0;0;0;2;6;8;7;15;5;3;8;20;12;4;5;1;50
972500;Unerlaubt eingereiste/aufhältige Personen (SZ: 725100, 725700);6411000;Darmstadt;W;14;0;0;0;0;0;0;0;0;0;4;4;0;1;1;5;3;0;1;0;10
972500;Unerlaubt eingereiste/aufhältige Personen (SZ: 725100, 725700);6411000;Darmstadt;X;79;0;0;0;0;0;0;2;6;8;11;19;5;4;9;25;15;4;6;1;60
972500;Unerlaubt eingereiste/aufhältige Personen (SZ: 725100, 725700);5913000;Dortmund;M;1118;8;2;4;3;6;23;85;238;323;127;473;84;87;171;185;211;51;20;7;645
972500;Unerlaubt eingereiste/aufhältige Personen (SZ: 725100, 725700);5913000;Dortmund;W;225;8;1;4;1;2;16;12;16;28;26;70;12;17;29;41;34;25;16;10;155
972500;Unerlaubt eingereiste/aufhältige Personen (SZ: 725100, 725700);5913000;Dortmund;X;1343;16;3;8;4;8;39;97;254;351;153;543;96;104;200;226;245;76;36;17;800
972500;Unerlaubt eingereiste/aufhältige Personen (SZ: 725100, 725700);14612000;Dresden;M;162;0;0;0;1;1;2;1;13;14;18;34;11;14;25;37;39;18;5;4;128
972500;Unerlaubt eingereiste/aufhältige Personen (SZ: 725100, 725700);14612000;Dresden;W;44;1;0;1;1;0;3;0;1;1;0;4;2;2;4;11;13;5;6;1;40
972500;Unerlaubt eingereiste/aufhältige Personen (SZ: 725100, 725700);14612000;Dresden;X;206;1;0;1;2;1;5;1;14;15;18;38;13;16;29;48;52;23;11;5;168
972500;Unerlaubt eingereiste/aufhältige Personen (SZ: 725100, 725700);5112000;Duisburg;M;188;1;0;0;0;2;3;4;11;15;20;38;17;19;36;46;49;12;6;1;150
972500;Unerlaubt eingereiste/aufhältige Personen (SZ: 725100, 725700);5112000;Duisburg;W;30;0;0;0;0;0;0;0;0;0;5;5;3;2;5;6;10;2;1;1;25
972500;Unerlaubt eingereiste/aufhältige Personen (SZ: 725100, 725700);5112000;Duisburg;X;218;1;0;0;0;2;3;4;11;15;25;43;20;21;41;52;59;14;7;2;175
972500;Unerlaubt eingereiste/aufhältige Personen (SZ: 725100, 725700);5111000;Düsseldorf;M;1752;7;0;0;1;4;12;33;108;141;154;307;102;139;241;316;458;237;104;89;1445
972500;Unerlaubt eingereiste/aufhältige Personen (SZ: 725100, 725700);5111000;Düsseldorf;W;818;2;1;0;3;3;9;7;26;33;60;102;39;46;85;94;147;94;134;162;716
972500;Unerlaubt eingereiste/aufhältige Personen (SZ: 725100, 725700);5111000;Düsseldorf;X;2570;9;1;0;4;7;21;40;134;174;214;409;141;185;326;410;605;331;238;251;2161
972500;Unerlaubt eingereiste/aufhältige Personen (SZ: 725100, 725700);16051000;Erfurt;M;55;2;0;0;2;0;4;2;3;5;11;20;2;4;6;8;10;9;2;0;35
972500;Unerlaubt eingereiste/aufhältige Personen (SZ: 725100, 725700);16051000;Erfurt;W;21;3;0;0;0;2;5;2;1;3;1;9;1;0;1;3;3;4;1;0;12
972500;Unerlaubt eingereiste/aufhältige Personen (SZ: 725100, 725700);16051000;Erfurt;X;76;5;0;0;2;2;9;4;4;8;12;29;3;4;7;11;13;13;3;0;47
972500;Unerlaubt eingereiste/aufhältige Personen (SZ: 725100, 725700);9562000;Erlangen;M;61;1;0;0;1;0;2;1;3;4;3;9;1;5;6;16;15;10;3;2;52
972500;Unerlaubt eingereiste/aufhältige Personen (SZ: 725100, 725700);9562000;Erlangen;W;13;0;1;0;1;1;3;1;0;1;0;4;1;1;2;2;1;1;0;3;9
972500;Unerlaubt eingereiste/aufhältige Personen (SZ: 725100, 725700);9562000;Erlangen;X;74;1;1;0;2;1;5;2;3;5;3;13;2;6;8;18;16;11;3;5;61
972500;Unerlaubt eingereiste/aufhältige Personen (SZ: 725100, 725700);5113000;Essen;M;122;0;0;0;0;0;0;8;10;18;9;27;7;11;18;31;32;8;6;0;95
972500;Unerlaubt eingereiste/aufhältige Personen (SZ: 725100, 725700);5113000;Essen;W;29;0;0;0;0;0;0;3;2;5;3;8;2;3;5;5;6;3;2;0;21
972500;Unerlaubt eingereiste/aufhältige Personen (SZ: 725100, 725700);5113000;Essen;X;151;0;0;0;0;0;0;11;12;23;12;35;9;14;23;36;38;11;8;0;116
972500;Unerlaubt eingereiste/aufhältige Personen (SZ: 725100, 725700);6412000;Frankfurt am Main;M;8807;80;21;28;19;22;170;238;690;928;709;1807;551;651;1202;1624;2063;1118;564;429;7000
972500;Unerlaubt eingereiste/aufhältige Personen (SZ: 725100, 725700);6412000;Frankfurt am Main;W;5222;70;27;25;16;15;153;54;143;197;259;609;261;297;558;796;1106;702;685;766;4613
972500;Unerlaubt eingereiste/aufhältige Personen (SZ: 725100, 725700);6412000;Frankfurt am Main;X;14029;150;48;53;35;37;323;292;833;1125;968;2416;812;948;1760;2420;3169;1820;1249;1195;11613
972500;Unerlaubt eingereiste/aufhältige Personen (SZ: 725100, 725700);8311000;Freiburg im Breisgau;M;434;1;1;1;1;2;6;19;62;81;56;143;43;48;91;87;83;26;4;0;291
972500;Unerlaubt eingereiste/aufhältige Personen (SZ: 725100, 725700);8311000;Freiburg im Breisgau;W;67;1;0;0;0;2;3;3;4;7;5;15;5;4;9;20;15;5;0;3;52
972500;Unerlaubt eingereiste/aufhältige Personen (SZ: 725100, 725700);8311000;Freiburg im Breisgau;X;501;2;1;1;1;4;9;22;66;88;61;158;48;52;100;107;98;31;4;3;343
972500;Unerlaubt eingereiste/aufhältige Personen (SZ: 725100, 725700);9563000;Fürth;M;19;0;0;0;0;0;0;1;1;2;2;4;0;1;1;7;3;3;1;0;15
972500;Unerlaubt eingereiste/aufhältige Personen (SZ: 725100, 725700);9563000;Fürth;W;5;0;0;0;0;0;0;0;1;1;0;1;0;0;0;0;1;3;0;0;4
972500;Unerlaubt eingereiste/aufhältige Personen (SZ: 725100, 725700);9563000;Fürth;X;24;0;0;0;0;0;0;1;2;3;2;5;0;1;1;7;4;6;1;0;19
972500;Unerlaubt eingereiste/aufhältige Personen (SZ: 725100, 725700);5513000;Gelsenkirchen;M;18;0;0;0;0;0;0;1;1;2;1;3;2;0;2;1;6;5;1;0;15
972500;Unerlaubt eingereiste/aufhältige Personen (SZ: 725100, 725700);5513000;Gelsenkirchen;W;4;0;0;0;0;0;0;0;1;1;1;2;0;0;0;1;1;0;0;0;2
972500;Unerlaubt eingereiste/aufhältige Personen (SZ: 725100, 725700);5513000;Gelsenkirchen;X;22;0;0;0;0;0;0;1;2;3;2;5;2;0;2;2;7;5;1;0;17
972500;Unerlaubt eingereiste/aufhältige Personen (SZ: 725100, 725700);3152012;Göttingen;M;60;0;0;0;0;2;2;3;9;12;7;21;3;7;10;16;8;3;2;0;39
972500;Unerlaubt eingereiste/aufhältige Personen (SZ: 725100, 725700);3152012;Göttingen;W;14;0;0;0;0;0;0;0;3;3;1;4;0;1;1;3;4;0;0;2;10
972500;Unerlaubt eingereiste/aufhältige Personen (SZ: 725100, 725700);3152012;Göttingen;X;74;0;0;0;0;2;2;3;12;15;8;25;3;8;11;19;12;3;2;2;49
972500;Unerlaubt eingereiste/aufhältige Personen (SZ: 725100, 725700);5914000;Hagen;M;43;0;0;0;0;0;0;2;6;8;5;13;4;0;4;9;14;3;0;0;30
972500;Unerlaubt eingereiste/aufhältige Personen (SZ: 725100, 725700);5914000;Hagen;W;8;0;0;0;0;0;0;0;1;1;1;2;0;0;0;1;2;3;0;0;6
972500;Unerlaubt eingereiste/aufhältige Personen (SZ: 725100, 725700);5914000;Hagen;X;51;0;0;0;0;0;0;2;7;9;6;15;4;0;4;10;16;6;0;0;36
972500;Unerlaubt eingereiste/aufhältige Personen (SZ: 725100, 725700);15002000;Halle (Saale);M;31;0;0;0;0;0;0;0;4;4;7;11;2;2;4;5;8;2;1;0;20
972500;Unerlaubt eingereiste/aufhältige Personen (SZ: 725100, 725700);15002000;Halle (Saale);W;0;0;0;0;0;0;0;0;0;0;0;0;0;0;0;0;0;0;0;0;0
972500;Unerlaubt eingereiste/aufhältige Personen (SZ: 725100, 725700);15002000;Halle (Saale);X;31;0;0;0;0;0;0;0;4;4;7;11;2;2;4;5;8;2;1;0;20
972500;Unerlaubt eingereiste/aufhältige Personen (SZ: 725100, 725700);2000000;Hamburg;M;2733;5;1;2;2;7;17;162;369;531;329;877;192;216;408;512;599;204;94;39;1856
972500;Unerlaubt eingereiste/aufhältige Personen (SZ: 725100, 725700);2000000;Hamburg;W;553;4;2;3;2;1;12;9;29;38;38;88;35;46;81;104;122;61;52;45;465
972500;Unerlaubt eingereiste/aufhältige Personen (SZ: 725100, 725700);2000000;Hamburg;X;3286;9;3;5;4;8;29;171;398;569;367;965;227;262;489;616;721;265;146;84;2321
972500;Unerlaubt eingereiste/aufhältige Personen (SZ: 725100, 725700);5915000;Hamm;M;195;0;0;0;0;1;1;10;17;27;25;53;16;20;36;41;51;10;3;1;142
972500;Unerlaubt eingereiste/aufhältige Personen (SZ: 725100, 725700);5915000;Hamm;W;27;0;0;0;0;1;1;2;1;3;4;8;3;3;6;4;5;2;1;1;19
972500;Unerlaubt eingereiste/aufhältige Personen (SZ: 725100, 725700);5915000;Hamm;X;222;0;0;0;0;2;2;12;18;30;29;61;19;23;42;45;56;12;4;2;161
972500;Unerlaubt eingereiste/aufhältige Personen (SZ: 725100, 725700);3241001;Hannover;M;990;17;1;5;3;5;31;44;91;135;98;264;72;83;155;186;212;107;43;23;726
972500;Unerlaubt eingereiste/aufhältige Personen (SZ: 725100, 725700);3241001;Hannover;W;501;16;4;1;3;3;27;18;21;39;22;88;17;26;43;98;135;58;42;37;413
972500;Unerlaubt eingereiste/aufhältige Personen (SZ: 725100, 725700);3241001;Hannover;X;1491;33;5;6;6;8;58;62;112;174;120;352;89;109;198;284;347;165;85;60;1139
972500;Unerlaubt eingereiste/aufhältige Personen (SZ: 725100, 725700);8221000;Heidelberg;M;38;0;0;0;0;0;0;0;0;0;3;3;4;5;9;8;9;6;2;1;35
972500;Unerlaubt eingereiste/aufhältige Personen (SZ: 725100, 725700);8221000;Heidelberg;W;15;0;0;0;0;0;0;0;0;0;2;2;1;2;3;3;4;3;0;0;13
972500;Unerlaubt eingereiste/aufhältige Personen (SZ: 725100, 725700);8221000;Heidelberg;X;53;0;0;0;0;0;0;0;0;0;5;5;5;7;12;11;13;9;2;1;48
972500;Unerlaubt eingereiste/aufhältige Personen (SZ: 725100, 725700);8121000;Heilbronn;M;22;0;0;0;0;0;0;0;0;0;6;6;3;0;3;3;4;5;0;1;16
972500;Unerlaubt eingereiste/aufhältige Personen (SZ: 725100, 725700);8121000;Heilbronn;W;4;0;0;0;0;0;0;0;1;1;1;2;0;0;0;2;0;0;0;0;2
972500;Unerlaubt eingereiste/aufhältige Personen (SZ: 725100, 725700);8121000;Heilbronn;X;26;0;0;0;0;0;0;0;1;1;7;8;3;0;3;5;4;5;0;1;18
972500;Unerlaubt eingereiste/aufhältige Personen (SZ: 725100, 725700);5916000;Herne;M;17;0;0;0;0;0;0;0;0;0;0;0;2;3;5;3;7;2;0;0;17
972500;Unerlaubt eingereiste/aufhältige Personen (SZ: 725100, 725700);5916000;Herne;W;0;0;0;0;0;0;0;0;0;0;0;0;0;0;0;0;0;0;0;0;0
972500;Unerlaubt eingereiste/aufhältige Personen (SZ: 725100, 725700);5916000;Herne;X;17;0;0;0;0;0;0;0;0;0;0;0;2;3;5;3;7;2;0;0;17
972500;Unerlaubt eingereiste/aufhältige Personen (SZ: 725100, 725700);9161000;Ingolstadt;M;100;0;0;0;0;0;0;2;17;19;7;26;5;10;15;25;20;13;1;0;74
972500;Unerlaubt eingereiste/aufhältige Personen (SZ: 725100, 725700);9161000;Ingolstadt;W;14;0;0;0;0;0;0;0;0;0;3;3;0;1;1;6;3;1;0;0;11
972500;Unerlaubt eingereiste/aufhältige Personen (SZ: 725100, 725700);9161000;Ingolstadt;X;114;0;0;0;0;0;0;2;17;19;10;29;5;11;16;31;23;14;1;0;85
972500;Unerlaubt eingereiste/aufhältige Personen (SZ: 725100, 725700);16053000;Jena;M;18;0;0;0;1;0;1;1;1;2;2;5;1;3;4;2;4;2;1;0;13
972500;Unerlaubt eingereiste/aufhältige Personen (SZ: 725100, 725700);16053000;Jena;W;3;0;0;0;0;0;0;0;0;0;0;0;0;0;0;0;1;2;0;0;3
972500;Unerlaubt eingereiste/aufhältige Personen (SZ: 725100, 725700);16053000;Jena;X;21;0;0;0;1;0;1;1;1;2;2;5;1;3;4;2;5;4;1;0;16
972500;Unerlaubt eingereiste/aufhältige Personen (SZ: 725100, 725700);8212000;Karlsruhe;M;407;7;4;1;0;2;14;8;27;35;42;91;37;50;87;89;97;24;13;6;316
972500;Unerlaubt eingereiste/aufhältige Personen (SZ: 725100, 725700);8212000;Karlsruhe;W;103;14;2;1;2;0;19;1;7;8;8;35;8;5;13;10;25;12;8;0;68
972500;Unerlaubt eingereiste/aufhältige Personen (SZ: 725100, 725700);8212000;Karlsruhe;X;510;21;6;2;2;2;33;9;34;43;50;126;45;55;100;99;122;36;21;6;384
972500;Unerlaubt eingereiste/aufhältige Personen (SZ: 725100, 725700);6611000;Kassel;M;290;6;4;0;1;2;13;15;33;48;33;94;21;30;51;64;53;20;7;1;196
972500;Unerlaubt eingereiste/aufhältige Personen (SZ: 725100, 725700);6611000;Kassel;W;49;2;2;1;2;1;8;1;4;5;8;21;5;1;6;6;11;0;5;0;28
972500;Unerlaubt eingereiste/aufhältige Personen (SZ: 725100, 725700);6611000;Kassel;X;339;8;6;1;3;3;21;16;37;53;41;115;26;31;57;70;64;20;12;1;224
972500;Unerlaubt eingereiste/aufhältige Personen (SZ: 725100, 725700);1002000;Kiel;M;110;4;1;0;1;0;6;4;18;22;11;39;5;10;15;21;27;7;1;0;71
972500;Unerlaubt eingereiste/aufhältige Personen (SZ: 725100, 725700);1002000;Kiel;W;24;2;0;0;0;0;2;0;3;3;3;8;2;2;4;3;8;0;1;0;16
972500;Unerlaubt eingereiste/aufhältige Personen (SZ: 725100, 725700);1002000;Kiel;X;134;6;1;0;1;0;8;4;21;25;14;47;7;12;19;24;35;7;2;0;87
972500;Unerlaubt eingereiste/aufhältige Personen (SZ: 725100, 725700);7111000;Koblenz;M;68;0;0;0;0;0;0;5;7;12;12;24;5;9;14;8;17;4;1;0;44
972500;Unerlaubt eingereiste/aufhältige Personen (SZ: 725100, 725700);7111000;Koblenz;W;10;0;0;1;1;0;2;0;0;0;0;2;0;0;0;3;3;2;0;0;8
972500;Unerlaubt eingereiste/aufhältige Personen (SZ: 725100, 725700);7111000;Koblenz;X;78;0;0;1;1;0;2;5;7;12;12;26;5;9;14;11;20;6;1;0;52
972500;Unerlaubt eingereiste/aufhältige Personen (SZ: 725100, 725700);5315000;Köln;M;2646;6;3;3;1;5;18;140;279;419;393;830;198;247;445;537;515;180;96;43;1816
972500;Unerlaubt eingereiste/aufhältige Personen (SZ: 725100, 725700);5315000;Köln;W;997;6;3;2;1;5;17;44;58;102;112;231;58;65;123;160;227;111;82;63;766
972500;Unerlaubt eingereiste/aufhältige Personen (SZ: 725100, 725700);5315000;Köln;X;3643;12;6;5;2;10;35;184;337;521;505;1061;256;312;568;697;742;291;178;106;2582
972500;Unerlaubt eingereiste/aufhältige Personen (SZ: 725100, 725700);5114000;Krefeld;M;18;0;0;1;0;0;1;1;0;1;0;2;2;0;2;5;4;4;1;0;16
972500;Unerlaubt eingereiste/aufhältige Personen (SZ: 725100, 725700);5114000;Krefeld;W;5;0;1;0;0;0;1;0;0;0;1;2;0;0;0;2;1;0;0;0;3
972500;Unerlaubt eingereiste/aufhältige Personen (SZ: 725100, 725700);5114000;Krefeld;X;23;0;1;1;0;0;2;1;0;1;1;4;2;0;2;7;5;4;1;0;19
972500;Unerlaubt eingereiste/aufhältige Personen (SZ: 725100, 725700);14713000;Leipzig;M;215;7;3;4;1;1;16;5;8;13;14;43;17;24;41;44;69;14;3;1;172
972500;Unerlaubt eingereiste/aufhältige Personen (SZ: 725100, 725700);14713000;Leipzig;W;52;3;2;1;0;2;8;0;0;0;3;11;2;4;6;9;15;8;2;1;41
972500;Unerlaubt eingereiste/aufhältige Personen (SZ: 725100, 725700);14713000;Leipzig;X;267;10;5;5;1;3;24;5;8;13;17;54;19;28;47;53;84;22;5;2;213
972500;Unerlaubt eingereiste/aufhältige Personen (SZ: 725100, 725700);5316000;Leverkusen;M;33;0;0;0;0;0;0;1;5;6;2;8;3;1;4;5;6;9;1;0;25
972500;Unerlaubt eingereiste/aufhältige Personen (SZ: 725100, 725700);5316000;Leverkusen;W;21;0;0;0;0;0;0;2;3;5;1;6;2;2;4;3;4;2;2;0;15
972500;Unerlaubt eingereiste/aufhältige Personen (SZ: 725100, 725700);5316000;Leverkusen;X;54;0;0;0;0;0;0;3;8;11;3;14;5;3;8;8;10;11;3;0;40
972500;Unerlaubt eingereiste/aufhältige Personen (SZ: 725100, 725700);1003000;Lübeck;M;233;2;0;2;1;1;6;20;38;58;27;91;26;23;49;44;36;8;3;2;142
972500;Unerlaubt eingereiste/aufhältige Personen (SZ: 725100, 725700);1003000;Lübeck;W;61;2;1;2;0;0;5;1;0;1;12;18;4;7;11;11;11;7;2;1;43
972500;Unerlaubt eingereiste/aufhältige Personen (SZ: 725100, 725700);1003000;Lübeck;X;294;4;1;4;1;1;11;21;38;59;39;109;30;30;60;55;47;15;5;3;185
972500;Unerlaubt eingereiste/aufhältige Personen (SZ: 725100, 725700);7314000;Ludwigshafen am Rhein;M;34;0;0;0;0;0;0;2;3;5;2;7;4;1;5;5;10;5;2;0;27
972500;Unerlaubt eingereiste/aufhältige Personen (SZ: 725100, 725700);7314000;Ludwigshafen am Rhein;W;9;0;0;0;0;0;0;0;0;0;1;1;0;1;1;2;3;1;1;0;8
972500;Unerlaubt eingereiste/aufhältige Personen (SZ: 725100, 725700);7314000;Ludwigshafen am Rhein;X;43;0;0;0;0;0;0;2;3;5;3;8;4;2;6;7;13;6;3;0;35
972500;Unerlaubt eingereiste/aufhältige Personen (SZ: 725100, 725700);15003000;Magdeburg;M;40;0;0;0;0;0;0;0;2;2;7;9;1;4;5;10;11;3;2;0;31
972500;Unerlaubt eingereiste/aufhältige Personen (SZ: 725100, 725700);15003000;Magdeburg;W;18;0;0;0;0;0;0;0;1;1;2;3;1;0;1;3;6;4;1;0;15
972500;Unerlaubt eingereiste/aufhältige Personen (SZ: 725100, 725700);15003000;Magdeburg;X;58;0;0;0;0;0;0;0;3;3;9;12;2;4;6;13;17;7;3;0;46
972500;Unerlaubt eingereiste/aufhältige Personen (SZ: 725100, 725700);7315000;Mainz;M;70;0;0;0;0;0;0;3;12;15;8;23;5;12;17;14;8;7;1;0;47
972500;Unerlaubt eingereiste/aufhältige Personen (SZ: 725100, 725700);7315000;Mainz;W;18;0;0;0;0;0;0;2;1;3;3;6;2;1;3;2;5;2;0;0;12
972500;Unerlaubt eingereiste/aufhältige Personen (SZ: 725100, 725700);7315000;Mainz;X;88;0;0;0;0;0;0;5;13;18;11;29;7;13;20;16;13;9;1;0;59
972500;Unerlaubt eingereiste/aufhältige Personen (SZ: 725100, 725700);8222000;Mannheim;M;221;0;0;0;0;1;1;6;30;36;23;60;21;25;46;59;43;6;5;2;161
972500;Unerlaubt eingereiste/aufhältige Personen (SZ: 725100, 725700);8222000;Mannheim;W;26;0;0;0;0;0;0;0;3;3;2;5;4;1;5;7;3;2;2;2;21
972500;Unerlaubt eingereiste/aufhältige Personen (SZ: 725100, 725700);8222000;Mannheim;X;247;0;0;0;0;1;1;6;33;39;25;65;25;26;51;66;46;8;7;4;182
972500;Unerlaubt eingereiste/aufhältige Personen (SZ: 725100, 725700);5170024;Moers;M;9;0;0;0;0;0;0;0;0;0;0;0;0;1;1;3;4;1;0;0;9
972500;Unerlaubt eingereiste/aufhältige Personen (SZ: 725100, 725700);5170024;Moers;W;0;0;0;0;0;0;0;0;0;0;0;0;0;0;0;0;0;0;0;0;0
972500;Unerlaubt eingereiste/aufhältige Personen (SZ: 725100, 725700);5170024;Moers;X;9;0;0;0;0;0;0;0;0;0;0;0;0;1;1;3;4;1;0;0;9
972500;Unerlaubt eingereiste/aufhältige Personen (SZ: 725100, 725700);5116000;Mönchengladbach;M;70;2;0;0;0;0;2;2;11;13;12;27;4;5;9;13;17;4;0;0;43
972500;Unerlaubt eingereiste/aufhältige Personen (SZ: 725100, 725700);5116000;Mönchengladbach;W;22;1;2;1;1;1;6;1;2;3;2;11;1;1;2;2;5;1;1;0;11
972500;Unerlaubt eingereiste/aufhältige Personen (SZ: 725100, 725700);5116000;Mönchengladbach;X;92;3;2;1;1;1;8;3;13;16;14;38;5;6;11;15;22;5;1;0;54
972500;Unerlaubt eingereiste/aufhältige Personen (SZ: 725100, 725700);5117000;Mülheim an der Ruhr;M;10;0;0;0;0;0;0;0;1;1;0;1;1;0;1;6;2;0;0;0;9
972500;Unerlaubt eingereiste/aufhältige Personen (SZ: 725100, 725700);5117000;Mülheim an der Ruhr;W;4;0;0;0;0;0;0;0;0;0;0;0;2;0;2;2;0;0;0;0;4
972500;Unerlaubt eingereiste/aufhältige Personen (SZ: 725100, 725700);5117000;Mülheim an der Ruhr;X;14;0;0;0;0;0;0;0;1;1;0;1;3;0;3;8;2;0;0;0;13
972500;Unerlaubt eingereiste/aufhältige Personen (SZ: 725100, 725700);9162000;München;M;10534;4;0;0;1;5;10;146;928;1074;2059;3143;1056;1184;2240;2254;2015;647;180;55;7391
972500;Unerlaubt eingereiste/aufhältige Personen (SZ: 725100, 725700);9162000;München;W;2532;6;1;1;0;0;8;9;121;130;383;521;218;257;475;578;636;191;87;44;2011
972500;Unerlaubt eingereiste/aufhältige Personen (SZ: 725100, 725700);9162000;München;X;13066;10;1;1;1;5;18;155;1049;1204;2442;3664;1274;1441;2715;2832;2651;838;267;99;9402
972500;Unerlaubt eingereiste/aufhältige Personen (SZ: 725100, 725700);5515000;Münster;M;287;0;0;0;0;2;2;23;58;81;34;117;17;22;39;56;60;11;3;1;170
972500;Unerlaubt eingereiste/aufhältige Personen (SZ: 725100, 725700);5515000;Münster;W;42;0;0;0;0;1;1;0;3;3;4;8;3;4;7;6;15;3;2;1;34
972500;Unerlaubt eingereiste/aufhältige Personen (SZ: 725100, 725700);5515000;Münster;X;329;0;0;0;0;3;3;23;61;84;38;125;20;26;46;62;75;14;5;2;204
972500;Unerlaubt eingereiste/aufhältige Personen (SZ: 725100, 725700);5162024;Neuss;M;28;0;0;0;0;0;0;0;4;4;5;9;1;4;5;7;7;0;0;0;19
972500;Unerlaubt eingereiste/aufhältige Personen (SZ: 725100, 725700);5162024;Neuss;W;7;0;0;0;0;0;0;0;0;0;0;0;1;1;2;0;2;3;0;0;7
972500;Unerlaubt eingereiste/aufhältige Personen (SZ: 725100, 725700);5162024;Neuss;X;35;0;0;0;0;0;0;0;4;4;5;9;2;5;7;7;9;3;0;0;26
972500;Unerlaubt eingereiste/aufhältige Personen (SZ: 725100, 725700);9564000;Nürnberg;M;601;4;1;1;1;8;15;20;38;58;75;148;39;53;92;116;169;49;16;11;453
972500;Unerlaubt eingereiste/aufhältige Personen (SZ: 725100, 725700);9564000;Nürnberg;W;184;0;0;0;2;3;5;6;10;16;16;37;15;14;29;28;44;20;15;11;147
972500;Unerlaubt eingereiste/aufhältige Personen (SZ: 725100, 725700);9564000;Nürnberg;X;785;4;1;1;3;11;20;26;48;74;91;185;54;67;121;144;213;69;31;22;600
972500;Unerlaubt eingereiste/aufhältige Personen (SZ: 725100, 725700);5119000;Oberhausen;M;50;0;0;0;0;0;0;1;3;4;4;8;3;5;8;7;20;7;0;0;42
972500;Unerlaubt eingereiste/aufhältige Personen (SZ: 725100, 725700);5119000;Oberhausen;W;17;0;0;0;0;0;0;0;0;0;2;2;2;2;4;4;3;4;0;0;15
972500;Unerlaubt eingereiste/aufhältige Personen (SZ: 725100, 725700);5119000;Oberhausen;X;67;0;0;0;0;0;0;1;3;4;6;10;5;7;12;11;23;11;0;0;57
972500;Unerlaubt eingereiste/aufhältige Personen (SZ: 725100, 725700);6413000;Offenbach am Main;M;115;0;0;0;0;0;0;1;4;5;11;16;6;7;13;32;32;18;3;1;99
972500;Unerlaubt eingereiste/aufhältige Personen (SZ: 725100, 725700);6413000;Offenbach am Main;W;36;0;0;0;0;1;1;0;0;0;1;2;4;5;9;5;10;5;3;2;34
972500;Unerlaubt eingereiste/aufhältige Personen (SZ: 725100, 725700);6413000;Offenbach am Main;X;151;0;0;0;0;1;1;1;4;5;12;18;10;12;22;37;42;23;6;3;133
972500;Unerlaubt eingereiste/aufhältige Personen (SZ: 725100, 725700);3403000;Oldenburg (Oldenburg);M;51;1;0;0;0;0;1;1;2;3;10;14;2;1;3;12;16;5;0;1;37
972500;Unerlaubt eingereiste/aufhältige Personen (SZ: 725100, 725700);3403000;Oldenburg (Oldenburg);W;20;0;0;0;0;0;0;1;1;2;3;5;2;1;3;2;4;4;2;0;15
972500;Unerlaubt eingereiste/aufhältige Personen (SZ: 725100, 725700);3403000;Oldenburg (Oldenburg);X;71;1;0;0;0;0;1;2;3;5;13;19;4;2;6;14;20;9;2;1;52
972500;Unerlaubt eingereiste/aufhältige Personen (SZ: 725100, 725700);3404000;Osnabrück;M;83;0;0;0;0;0;0;8;10;18;9;27;5;6;11;13;26;2;2;2;56
972500;Unerlaubt eingereiste/aufhältige Personen (SZ: 725100, 725700);3404000;Osnabrück;W;12;0;0;0;0;0;0;0;0;0;1;1;0;1;1;3;3;1;3;0;11
972500;Unerlaubt eingereiste/aufhältige Personen (SZ: 725100, 725700);3404000;Osnabrück;X;95;0;0;0;0;0;0;8;10;18;10;28;5;7;12;16;29;3;5;2;67
972500;Unerlaubt eingereiste/aufhältige Personen (SZ: 725100, 725700);5774032;Paderborn;M;52;0;0;0;0;0;0;1;4;5;10;15;2;4;6;10;14;5;2;0;37
972500;Unerlaubt eingereiste/aufhältige Personen (SZ: 725100, 725700);5774032;Paderborn;W;5;0;0;0;0;0;0;0;0;0;0;0;0;1;1;0;3;1;0;0;5
972500;Unerlaubt eingereiste/aufhältige Personen (SZ: 725100, 725700);5774032;Paderborn;X;57;0;0;0;0;0;0;1;4;5;10;15;2;5;7;10;17;6;2;0;42
972500;Unerlaubt eingereiste/aufhältige Personen (SZ: 725100, 725700);8231000;Pforzheim;M;6;0;0;0;0;0;0;0;1;1;0;1;1;1;2;1;0;2;0;0;5
972500;Unerlaubt eingereiste/aufhältige Personen (SZ: 725100, 725700);8231000;Pforzheim;W;3;0;0;0;0;0;0;0;0;0;0;0;0;0;0;1;1;1;0;0;3
972500;Unerlaubt eingereiste/aufhältige Personen (SZ: 725100, 725700);8231000;Pforzheim;X;9;0;0;0;0;0;0;0;1;1;0;1;1;1;2;2;1;3;0;0;8
972500;Unerlaubt eingereiste/aufhältige Personen (SZ: 725100, 725700);12054000;Potsdam;M;12;0;0;0;0;0;0;0;0;0;1;1;2;0;2;1;5;1;2;0;11
972500;Unerlaubt eingereiste/aufhältige Personen (SZ: 725100, 725700);12054000;Potsdam;W;2;0;0;0;0;0;0;0;0;0;0;0;0;0;0;0;1;0;1;0;2
972500;Unerlaubt eingereiste/aufhältige Personen (SZ: 725100, 725700);12054000;Potsdam;X;14;0;0;0;0;0;0;0;0;0;1;1;2;0;2;1;6;1;3;0;13
972500;Unerlaubt eingereiste/aufhältige Personen (SZ: 725100, 725700);5562032;Recklinghausen;M;8;0;0;0;0;0;0;0;1;1;0;1;2;2;4;1;2;0;0;0;7
972500;Unerlaubt eingereiste/aufhältige Personen (SZ: 725100, 725700);5562032;Recklinghausen;W;1;0;0;0;0;0;0;0;0;0;1;1;0;0;0;0;0;0;0;0;0
972500;Unerlaubt eingereiste/aufhältige Personen (SZ: 725100, 725700);5562032;Recklinghausen;X;9;0;0;0;0;0;0;0;1;1;1;2;2;2;4;1;2;0;0;0;7
972500;Unerlaubt eingereiste/aufhältige Personen (SZ: 725100, 725700);9362000;Regensburg;M;196;2;3;0;1;1;7;10;21;31;18;56;13;13;26;41;47;15;8;3;140
972500;Unerlaubt eingereiste/aufhältige Personen (SZ: 725100, 725700);9362000;Regensburg;W;59;3;0;1;1;1;6;3;2;5;3;14;1;3;4;13;14;9;2;3;45
972500;Unerlaubt eingereiste/aufhältige Personen (SZ: 725100, 725700);9362000;Regensburg;X;255;5;3;1;2;2;13;13;23;36;21;70;14;16;30;54;61;24;10;6;185
972500;Unerlaubt eingereiste/aufhältige Personen (SZ: 725100, 725700);5120000;Remscheid;M;1;0;0;0;0;0;0;0;0;0;1;1;0;0;0;0;0;0;0;0;0
972500;Unerlaubt eingereiste/aufhältige Personen (SZ: 725100, 725700);5120000;Remscheid;W;0;0;0;0;0;0;0;0;0;0;0;0;0;0;0;0;0;0;0;0;0
972500;Unerlaubt eingereiste/aufhältige Personen (SZ: 725100, 725700);5120000;Remscheid;X;1;0;0;0;0;0;0;0;0;0;1;1;0;0;0;0;0;0;0;0;0
972500;Unerlaubt eingereiste/aufhältige Personen (SZ: 725100, 725700);8415061;Reutlingen;M;15;0;0;0;0;0;0;3;1;4;2;6;1;2;3;2;3;1;0;0;9
972500;Unerlaubt eingereiste/aufhältige Personen (SZ: 725100, 725700);8415061;Reutlingen;W;8;0;0;0;0;1;1;1;0;1;0;2;0;0;0;0;3;3;0;0;6
972500;Unerlaubt eingereiste/aufhältige Personen (SZ: 725100, 725700);8415061;Reutlingen;X;23;0;0;0;0;1;1;4;1;5;2;8;1;2;3;2;6;4;0;0;15
972500;Unerlaubt eingereiste/aufhältige Personen (SZ: 725100, 725700);13003000;Rostock;M;426;14;3;3;2;4;26;9;19;28;28;82;35;25;60;93;125;41;20;5;344
972500;Unerlaubt eingereiste/aufhältige Personen (SZ: 725100, 725700);13003000;Rostock;W;138;20;2;5;4;4;35;4;4;8;6;49;5;8;13;16;29;13;12;6;89
972500;Unerlaubt eingereiste/aufhältige Personen (SZ: 725100, 725700);13003000;Rostock;X;564;34;5;8;6;8;61;13;23;36;34;131;40;33;73;109;154;54;32;11;433
972500;Unerlaubt eingereiste/aufhältige Personen (SZ: 725100, 725700);10041100;Saarbrücken;M;1894;11;7;10;14;14;56;87;283;370;312;738;193;224;417;400;275;56;8;0;1156
972500;Unerlaubt eingereiste/aufhältige Personen (SZ: 725100, 725700);10041100;Saarbrücken;W;342;2;7;8;5;6;28;12;29;41;62;131;31;50;81;61;47;15;6;1;211
972500;Unerlaubt eingereiste/aufhältige Personen (SZ: 725100, 725700);10041100;Saarbrücken;X;2236;13;14;18;19;20;84;99;312;411;374;869;224;274;498;461;322;71;14;1;1367
972500;Unerlaubt eingereiste/aufhältige Personen (SZ: 725100, 725700);5122000;Solingen;M;4;0;0;0;0;0;0;0;0;0;0;0;0;1;1;2;0;1;0;0;4
972500;Unerlaubt eingereiste/aufhältige Personen (SZ: 725100, 725700);5122000;Solingen;W;0;0;0;0;0;0;0;0;0;0;0;0;0;0;0;0;0;0;0;0;0
972500;Unerlaubt eingereiste/aufhältige Personen (SZ: 725100, 725700);5122000;Solingen;X;4;0;0;0;0;0;0;0;0;0;0;0;0;1;1;2;0;1;0;0;4
972500;Unerlaubt eingereiste/aufhältige Personen (SZ: 725100, 725700);8111000;Stuttgart;M;1436;7;5;3;4;7;26;62;164;226;188;440;122;136;258;287;296;108;38;9;996
972500;Unerlaubt eingereiste/aufhältige Personen (SZ: 725100, 725700);8111000;Stuttgart;W;302;5;4;1;1;1;12;11;19;30;26;68;20;25;45;63;67;39;13;7;234
972500;Unerlaubt eingereiste/aufhältige Personen (SZ: 725100, 725700);8111000;Stuttgart;X;1738;12;9;4;5;8;38;73;183;256;214;508;142;161;303;350;363;147;51;16;1230
972500;Unerlaubt eingereiste/aufhältige Personen (SZ: 725100, 725700);7211000;Trier;M;4164;0;0;0;0;0;0;71;137;208;510;718;330;378;708;871;1146;476;194;51;3446
972500;Unerlaubt eingereiste/aufhältige Personen (SZ: 725100, 725700);7211000;Trier;W;2128;0;0;0;0;0;0;55;70;125;201;326;140;145;285;420;611;273;142;71;1802
972500;Unerlaubt eingereiste/aufhältige Personen (SZ: 725100, 725700);7211000;Trier;X;6292;0;0;0;0;0;0;126;207;333;711;1044;470;523;993;1291;1757;749;336;122;5248
972500;Unerlaubt eingereiste/aufhältige Personen (SZ: 725100, 725700);8421000;Ulm;M;346;0;0;0;1;2;3;13;52;65;62;130;29;35;64;64;65;17;5;1;216
972500;Unerlaubt eingereiste/aufhältige Personen (SZ: 725100, 725700);8421000;Ulm;W;93;2;2;0;1;1;6;2;5;7;17;30;12;3;15;22;16;8;2;0;63
972500;Unerlaubt eingereiste/aufhältige Personen (SZ: 725100, 725700);8421000;Ulm;X;439;2;2;0;2;3;9;15;57;72;79;160;41;38;79;86;81;25;7;1;279
972500;Unerlaubt eingereiste/aufhältige Personen (SZ: 725100, 725700);6414000;Wiesbaden;M;115;0;0;0;0;0;0;8;34;42;6;48;2;3;5;20;23;11;6;2;67
972500;Unerlaubt eingereiste/aufhältige Personen (SZ: 725100, 725700);6414000;Wiesbaden;W;42;0;0;0;0;1;1;2;5;7;2;10;1;1;2;2;14;11;2;1;32
972500;Unerlaubt eingereiste/aufhältige Personen (SZ: 725100, 725700);6414000;Wiesbaden;X;157;0;0;0;0;1;1;10;39;49;8;58;3;4;7;22;37;22;8;3;99
972500;Unerlaubt eingereiste/aufhältige Personen (SZ: 725100, 725700);3103000;Wolfsburg;M;13;0;0;0;0;0;0;0;1;1;1;2;1;1;2;2;7;0;0;0;11
972500;Unerlaubt eingereiste/aufhältige Personen (SZ: 725100, 725700);3103000;Wolfsburg;W;4;0;0;0;0;0;0;0;0;0;0;0;1;0;1;1;1;1;0;0;4
972500;Unerlaubt eingereiste/aufhältige Personen (SZ: 725100, 725700);3103000;Wolfsburg;X;17;0;0;0;0;0;0;0;1;1;1;2;2;1;3;3;8;1;0;0;15
972500;Unerlaubt eingereiste/aufhältige Personen (SZ: 725100, 725700);5124000;Wuppertal;M;84;0;0;0;0;0;0;3;13;16;14;30;4;5;9;19;15;7;4;0;54
972500;Unerlaubt eingereiste/aufhältige Personen (SZ: 725100, 725700);5124000;Wuppertal;W;11;0;0;0;0;0;0;1;0;1;1;2;1;2;3;2;2;1;1;0;9
972500;Unerlaubt eingereiste/aufhältige Personen (SZ: 725100, 725700);5124000;Wuppertal;X;95;0;0;0;0;0;0;4;13;17;15;32;5;7;12;21;17;8;5;0;63
972500;Unerlaubt eingereiste/aufhältige Personen (SZ: 725100, 725700);9663000;Würzburg;M;872;5;0;1;0;3;9;40;95;135;119;263;83;94;177;169;194;55;9;5;609
972500;Unerlaubt eingereiste/aufhältige Personen (SZ: 725100, 725700);9663000;Würzburg;W;186;0;0;0;0;0;0;10;11;21;26;47;15;32;47;43;26;17;2;4;139
972500;Unerlaubt eingereiste/aufhältige Personen (SZ: 725100, 725700);9663000;Würzburg;X;1058;5;0;1;0;3;9;50;106;156;145;310;98;126;224;212;220;72;11;9;748
980100;IuK-Kriminalität im engeren Sinne (SZ: 517500, 517900, 543000, 674200, 678000);5334002;Aachen;M;69;0;0;0;0;0;0;1;6;7;11;18;2;3;5;11;19;9;7;0;51
980100;IuK-Kriminalität im engeren Sinne (SZ: 517500, 517900, 543000, 674200, 678000);5334002;Aachen;W;32;0;0;0;0;0;0;0;2;2;0;2;2;0;2;8;9;7;3;1;30
980100;IuK-Kriminalität im engeren Sinne (SZ: 517500, 517900, 543000, 674200, 678000);5334002;Aachen;X;101;0;0;0;0;0;0;1;8;9;11;20;4;3;7;19;28;16;10;1;81
980100;IuK-Kriminalität im engeren Sinne (SZ: 517500, 517900, 543000, 674200, 678000);9761000;Augsburg;M;16;0;0;0;0;0;0;0;1;1;2;3;1;0;1;5;1;3;2;1;13
980100;IuK-Kriminalität im engeren Sinne (SZ: 517500, 517900, 543000, 674200, 678000);9761000;Augsburg;W;6;0;0;0;0;0;0;0;0;0;1;1;1;0;1;0;3;0;1;0;5
980100;IuK-Kriminalität im engeren Sinne (SZ: 517500, 517900, 543000, 674200, 678000);9761000;Augsburg;X;22;0;0;0;0;0;0;0;1;1;3;4;2;0;2;5;4;3;3;1;18
980100;IuK-Kriminalität im engeren Sinne (SZ: 517500, 517900, 543000, 674200, 678000);5378004;Bergisch Gladbach;M;4;0;0;0;0;0;0;0;0;0;1;1;0;0;0;2;1;0;0;0;3
980100;IuK-Kriminalität im engeren Sinne (SZ: 517500, 517900, 543000, 674200, 678000);5378004;Bergisch Gladbach;W;1;0;0;0;0;0;0;0;0;0;0;0;0;0;0;0;1;0;0;0;1
980100;IuK-Kriminalität im engeren Sinne (SZ: 517500, 517900, 543000, 674200, 678000);5378004;Bergisch Gladbach;X;5;0;0;0;0;0;0;0;0;0;1;1;0;0;0;2;2;0;0;0;4
980100;IuK-Kriminalität im engeren Sinne (SZ: 517500, 517900, 543000, 674200, 678000);11000000;Berlin;M;337;0;0;0;0;2;2;5;8;13;19;34;24;22;46;49;90;72;32;14;303
980100;IuK-Kriminalität im engeren Sinne (SZ: 517500, 517900, 543000, 674200, 678000);11000000;Berlin;W;88;0;0;0;1;0;1;4;1;5;3;9;5;7;12;21;18;16;9;3;79
980100;IuK-Kriminalität im engeren Sinne (SZ: 517500, 517900, 543000, 674200, 678000);11000000;Berlin;X;425;0;0;0;1;2;3;9;9;18;22;43;29;29;58;70;108;88;41;17;382
980100;IuK-Kriminalität im engeren Sinne (SZ: 517500, 517900, 543000, 674200, 678000);5711000;Bielefeld;M;21;0;0;0;0;0;0;0;0;0;2;2;0;2;2;6;7;4;0;0;19
980100;IuK-Kriminalität im engeren Sinne (SZ: 517500, 517900, 543000, 674200, 678000);5711000;Bielefeld;W;5;0;0;0;0;0;0;0;0;0;0;0;0;2;2;1;1;0;0;1;5
980100;IuK-Kriminalität im engeren Sinne (SZ: 517500, 517900, 543000, 674200, 678000);5711000;Bielefeld;X;26;0;0;0;0;0;0;0;0;0;2;2;0;4;4;7;8;4;0;1;24
980100;IuK-Kriminalität im engeren Sinne (SZ: 517500, 517900, 543000, 674200, 678000);5911000;Bochum;M;48;0;0;0;0;0;0;0;1;1;1;2;3;5;8;9;14;9;3;3;46
980100;IuK-Kriminalität im engeren Sinne (SZ: 517500, 517900, 543000, 674200, 678000);5911000;Bochum;W;15;0;0;0;0;0;0;0;0;0;1;1;0;3;3;3;4;2;2;0;14
980100;IuK-Kriminalität im engeren Sinne (SZ: 517500, 517900, 543000, 674200, 678000);5911000;Bochum;X;63;0;0;0;0;0;0;0;1;1;2;3;3;8;11;12;18;11;5;3;60
980100;IuK-Kriminalität im engeren Sinne (SZ: 517500, 517900, 543000, 674200, 678000);5314000;Bonn;M;20;0;0;0;0;0;0;1;0;1;1;2;3;1;4;2;6;4;2;0;18
980100;IuK-Kriminalität im engeren Sinne (SZ: 517500, 517900, 543000, 674200, 678000);5314000;Bonn;W;5;0;0;0;0;0;0;0;0;0;0;0;0;1;1;1;1;1;0;1;5
980100;IuK-Kriminalität im engeren Sinne (SZ: 517500, 517900, 543000, 674200, 678000);5314000;Bonn;X;25;0;0;0;0;0;0;1;0;1;1;2;3;2;5;3;7;5;2;1;23
980100;IuK-Kriminalität im engeren Sinne (SZ: 517500, 517900, 543000, 674200, 678000);5512000;Bottrop;M;15;0;0;0;0;0;0;2;1;3;2;5;1;2;3;3;3;1;0;0;10
980100;IuK-Kriminalität im engeren Sinne (SZ: 517500, 517900, 543000, 674200, 678000);5512000;Bottrop;W;8;0;0;0;0;0;0;0;0;0;1;1;0;2;2;2;1;1;1;0;7
980100;IuK-Kriminalität im engeren Sinne (SZ: 517500, 517900, 543000, 674200, 678000);5512000;Bottrop;X;23;0;0;0;0;0;0;2;1;3;3;6;1;4;5;5;4;2;1;0;17
980100;IuK-Kriminalität im engeren Sinne (SZ: 517500, 517900, 543000, 674200, 678000);3101000;Braunschweig;M;34;0;0;0;0;0;0;0;1;1;2;3;4;4;8;9;8;5;1;0;31
980100;IuK-Kriminalität im engeren Sinne (SZ: 517500, 517900, 543000, 674200, 678000);3101000;Braunschweig;W;6;0;0;0;0;0;0;0;0;0;0;0;0;0;0;0;0;4;1;1;6
980100;IuK-Kriminalität im engeren Sinne (SZ: 517500, 517900, 543000, 674200, 678000);3101000;Braunschweig;X;40;0;0;0;0;0;0;0;1;1;2;3;4;4;8;9;8;9;2;1;37
980100;IuK-Kriminalität im engeren Sinne (SZ: 517500, 517900, 543000, 674200, 678000);4011000;Bremen;M;112;0;0;0;0;0;0;1;5;6;16;22;8;8;16;24;21;24;4;1;90
980100;IuK-Kriminalität im engeren Sinne (SZ: 517500, 517900, 543000, 674200, 678000);4011000;Bremen;W;31;0;0;0;0;0;0;1;1;2;3;5;3;0;3;0;15;5;0;3;26
980100;IuK-Kriminalität im engeren Sinne (SZ: 517500, 517900, 543000, 674200, 678000);4011000;Bremen;X;143;0;0;0;0;0;0;2;6;8;19;27;11;8;19;24;36;29;4;4;116
980100;IuK-Kriminalität im engeren Sinne (SZ: 517500, 517900, 543000, 674200, 678000);4012000;Bremerhaven;M;13;0;0;0;0;0;0;0;0;0;1;1;0;2;2;3;3;0;3;1;12
980100;IuK-Kriminalität im engeren Sinne (SZ: 517500, 517900, 543000, 674200, 678000);4012000;Bremerhaven;W;10;0;0;0;0;0;0;0;0;0;3;3;1;1;2;2;1;1;0;1;7
980100;IuK-Kriminalität im engeren Sinne (SZ: 517500, 517900, 543000, 674200, 678000);4012000;Bremerhaven;X;23;0;0;0;0;0;0;0;0;0;4;4;1;3;4;5;4;1;3;2;19
980100;IuK-Kriminalität im engeren Sinne (SZ: 517500, 517900, 543000, 674200, 678000);14511000;Chemnitz;M;42;0;0;0;0;0;0;0;0;0;6;6;2;2;4;6;15;7;4;0;36
980100;IuK-Kriminalität im engeren Sinne (SZ: 517500, 517900, 543000, 674200, 678000);14511000;Chemnitz;W;17;0;0;0;0;0;0;0;1;1;3;4;2;2;4;3;2;1;3;0;13
980100;IuK-Kriminalität im engeren Sinne (SZ: 517500, 517900, 543000, 674200, 678000);14511000;Chemnitz;X;59;0;0;0;0;0;0;0;1;1;9;10;4;4;8;9;17;8;7;0;49
980100;IuK-Kriminalität im engeren Sinne (SZ: 517500, 517900, 543000, 674200, 678000);6411000;Darmstadt;M;14;0;0;0;0;0;0;0;1;1;0;1;1;0;1;5;3;3;1;0;13
980100;IuK-Kriminalität im engeren Sinne (SZ: 517500, 517900, 543000, 674200, 678000);6411000;Darmstadt;W;1;0;0;0;0;0;0;0;0;0;0;0;0;0;0;1;0;0;0;0;1
980100;IuK-Kriminalität im engeren Sinne (SZ: 517500, 517900, 543000, 674200, 678000);6411000;Darmstadt;X;15;0;0;0;0;0;0;0;1;1;0;1;1;0;1;6;3;3;1;0;14
980100;IuK-Kriminalität im engeren Sinne (SZ: 517500, 517900, 543000, 674200, 678000);5913000;Dortmund;M;37;0;0;0;0;2;2;2;0;2;5;9;3;4;7;3;9;5;4;0;28
980100;IuK-Kriminalität im engeren Sinne (SZ: 517500, 517900, 543000, 674200, 678000);5913000;Dortmund;W;9;0;0;0;1;0;1;0;0;0;1;2;3;0;3;2;0;2;0;0;7
980100;IuK-Kriminalität im engeren Sinne (SZ: 517500, 517900, 543000, 674200, 678000);5913000;Dortmund;X;46;0;0;0;1;2;3;2;0;2;6;11;6;4;10;5;9;7;4;0;35
980100;IuK-Kriminalität im engeren Sinne (SZ: 517500, 517900, 543000, 674200, 678000);14612000;Dresden;M;68;0;0;0;0;0;0;3;2;5;1;6;2;5;7;12;27;10;5;1;62
980100;IuK-Kriminalität im engeren Sinne (SZ: 517500, 517900, 543000, 674200, 678000);14612000;Dresden;W;18;0;0;0;0;0;0;0;0;0;1;1;1;1;2;7;4;4;0;0;17
980100;IuK-Kriminalität im engeren Sinne (SZ: 517500, 517900, 543000, 674200, 678000);14612000;Dresden;X;86;0;0;0;0;0;0;3;2;5;2;7;3;6;9;19;31;14;5;1;79
980100;IuK-Kriminalität im engeren Sinne (SZ: 517500, 517900, 543000, 674200, 678000);5112000;Duisburg;M;63;0;0;0;0;0;0;1;3;4;6;10;5;4;9;9;14;11;9;1;53
980100;IuK-Kriminalität im engeren Sinne (SZ: 517500, 517900, 543000, 674200, 678000);5112000;Duisburg;W;24;0;0;0;0;0;0;0;0;0;2;2;1;2;3;5;4;8;1;1;22
980100;IuK-Kriminalität im engeren Sinne (SZ: 517500, 517900, 543000, 674200, 678000);5112000;Duisburg;X;87;0;0;0;0;0;0;1;3;4;8;12;6;6;12;14;18;19;10;2;75
980100;IuK-Kriminalität im engeren Sinne (SZ: 517500, 517900, 543000, 674200, 678000);5111000;Düsseldorf;M;44;0;0;0;0;1;1;0;0;0;4;5;3;5;8;9;8;9;3;2;39
980100;IuK-Kriminalität im engeren Sinne (SZ: 517500, 517900, 543000, 674200, 678000);5111000;Düsseldorf;W;10;0;0;0;0;0;0;0;0;0;1;1;0;1;1;1;2;4;1;0;9
980100;IuK-Kriminalität im engeren Sinne (SZ: 517500, 517900, 543000, 674200, 678000);5111000;Düsseldorf;X;54;0;0;0;0;1;1;0;0;0;5;6;3;6;9;10;10;13;4;2;48
980100;IuK-Kriminalität im engeren Sinne (SZ: 517500, 517900, 543000, 674200, 678000);16051000;Erfurt;M;15;0;0;0;0;0;0;0;1;1;0;1;1;3;4;1;5;3;1;0;14
980100;IuK-Kriminalität im engeren Sinne (SZ: 517500, 517900, 543000, 674200, 678000);16051000;Erfurt;W;7;0;0;0;0;1;1;0;0;0;1;2;0;1;1;2;2;0;0;0;5
980100;IuK-Kriminalität im engeren Sinne (SZ: 517500, 517900, 543000, 674200, 678000);16051000;Erfurt;X;22;0;0;0;0;1;1;0;1;1;1;3;1;4;5;3;7;3;1;0;19
980100;IuK-Kriminalität im engeren Sinne (SZ: 517500, 517900, 543000, 674200, 678000);9562000;Erlangen;M;10;0;0;0;0;0;0;1;0;1;0;1;2;1;3;4;2;0;0;0;9
980100;IuK-Kriminalität im engeren Sinne (SZ: 517500, 517900, 543000, 674200, 678000);9562000;Erlangen;W;0;0;0;0;0;0;0;0;0;0;0;0;0;0;0;0;0;0;0;0;0
980100;IuK-Kriminalität im engeren Sinne (SZ: 517500, 517900, 543000, 674200, 678000);9562000;Erlangen;X;10;0;0;0;0;0;0;1;0;1;0;1;2;1;3;4;2;0;0;0;9
980100;IuK-Kriminalität im engeren Sinne (SZ: 517500, 517900, 543000, 674200, 678000);5113000;Essen;M;32;0;0;0;0;0;0;0;0;0;2;2;3;3;6;6;9;5;2;2;30
980100;IuK-Kriminalität im engeren Sinne (SZ: 517500, 517900, 543000, 674200, 678000);5113000;Essen;W;8;0;0;0;0;0;0;0;0;0;1;1;0;0;0;2;1;1;3;0;7
980100;IuK-Kriminalität im engeren Sinne (SZ: 517500, 517900, 543000, 674200, 678000);5113000;Essen;X;40;0;0;0;0;0;0;0;0;0;3;3;3;3;6;8;10;6;5;2;37
980100;IuK-Kriminalität im engeren Sinne (SZ: 517500, 517900, 543000, 674200, 678000);6412000;Frankfurt am Main;M;35;0;0;0;0;0;0;0;1;1;3;4;1;4;5;2;11;9;4;0;31
980100;IuK-Kriminalität im engeren Sinne (SZ: 517500, 517900, 543000, 674200, 678000);6412000;Frankfurt am Main;W;7;0;0;0;0;0;0;0;0;0;2;2;1;0;1;1;2;1;0;0;5
980100;IuK-Kriminalität im engeren Sinne (SZ: 517500, 517900, 543000, 674200, 678000);6412000;Frankfurt am Main;X;42;0;0;0;0;0;0;0;1;1;5;6;2;4;6;3;13;10;4;0;36
980100;IuK-Kriminalität im engeren Sinne (SZ: 517500, 517900, 543000, 674200, 678000);8311000;Freiburg im Breisgau;M;19;0;1;0;0;1;2;0;0;0;2;4;2;1;3;5;5;1;1;0;15
980100;IuK-Kriminalität im engeren Sinne (SZ: 517500, 517900, 543000, 674200, 678000);8311000;Freiburg im Breisgau;W;3;0;0;0;0;0;0;0;0;0;0;0;0;0;0;3;0;0;0;0;3
980100;IuK-Kriminalität im engeren Sinne (SZ: 517500, 517900, 543000, 674200, 678000);8311000;Freiburg im Breisgau;X;22;0;1;0;0;1;2;0;0;0;2;4;2;1;3;8;5;1;1;0;18
980100;IuK-Kriminalität im engeren Sinne (SZ: 517500, 517900, 543000, 674200, 678000);9563000;Fürth;M;12;0;0;0;0;0;0;0;3;3;0;3;0;2;2;1;3;3;0;0;9
980100;IuK-Kriminalität im engeren Sinne (SZ: 517500, 517900, 543000, 674200, 678000);9563000;Fürth;W;3;0;0;0;0;0;0;0;0;0;0;0;0;1;1;0;2;0;0;0;3
980100;IuK-Kriminalität im engeren Sinne (SZ: 517500, 517900, 543000, 674200, 678000);9563000;Fürth;X;15;0;0;0;0;0;0;0;3;3;0;3;0;3;3;1;5;3;0;0;12
980100;IuK-Kriminalität im engeren Sinne (SZ: 517500, 517900, 543000, 674200, 678000);5513000;Gelsenkirchen;M;33;0;0;0;0;1;1;1;1;2;3;6;1;4;5;10;4;5;2;1;27
980100;IuK-Kriminalität im engeren Sinne (SZ: 517500, 517900, 543000, 674200, 678000);5513000;Gelsenkirchen;W;7;0;0;0;0;0;0;0;0;0;1;1;1;0;1;1;2;1;0;1;6
980100;IuK-Kriminalität im engeren Sinne (SZ: 517500, 517900, 543000, 674200, 678000);5513000;Gelsenkirchen;X;40;0;0;0;0;1;1;1;1;2;4;7;2;4;6;11;6;6;2;2;33
980100;IuK-Kriminalität im engeren Sinne (SZ: 517500, 517900, 543000, 674200, 678000);3152012;Göttingen;M;19;0;0;0;0;0;0;0;2;2;0;2;2;1;3;3;5;4;2;0;17
980100;IuK-Kriminalität im engeren Sinne (SZ: 517500, 517900, 543000, 674200, 678000);3152012;Göttingen;W;3;0;0;0;0;0;0;0;0;0;0;0;0;0;0;0;1;1;0;1;3
980100;IuK-Kriminalität im engeren Sinne (SZ: 517500, 517900, 543000, 674200, 678000);3152012;Göttingen;X;22;0;0;0;0;0;0;0;2;2;0;2;2;1;3;3;6;5;2;1;20
980100;IuK-Kriminalität im engeren Sinne (SZ: 517500, 517900, 543000, 674200, 678000);5914000;Hagen;M;26;0;0;0;0;0;0;0;2;2;3;5;4;2;6;4;3;5;2;1;21
980100;IuK-Kriminalität im engeren Sinne (SZ: 517500, 517900, 543000, 674200, 678000);5914000;Hagen;W;9;0;0;0;0;0;0;0;0;0;1;1;1;1;2;0;3;2;1;0;8
980100;IuK-Kriminalität im engeren Sinne (SZ: 517500, 517900, 543000, 674200, 678000);5914000;Hagen;X;35;0;0;0;0;0;0;0;2;2;4;6;5;3;8;4;6;7;3;1;29
980100;IuK-Kriminalität im engeren Sinne (SZ: 517500, 517900, 543000, 674200, 678000);15002000;Halle (Saale);M;68;0;0;0;0;0;0;1;9;10;3;13;4;1;5;8;27;13;2;0;55
980100;IuK-Kriminalität im engeren Sinne (SZ: 517500, 517900, 543000, 674200, 678000);15002000;Halle (Saale);W;13;0;0;0;0;0;0;0;0;0;0;0;1;1;2;2;3;5;1;0;13
980100;IuK-Kriminalität im engeren Sinne (SZ: 517500, 517900, 543000, 674200, 678000);15002000;Halle (Saale);X;81;0;0;0;0;0;0;1;9;10;3;13;5;2;7;10;30;18;3;0;68
980100;IuK-Kriminalität im engeren Sinne (SZ: 517500, 517900, 543000, 674200, 678000);2000000;Hamburg;M;153;0;0;0;0;0;0;3;9;12;10;22;10;14;24;28;33;23;15;8;131
980100;IuK-Kriminalität im engeren Sinne (SZ: 517500, 517900, 543000, 674200, 678000);2000000;Hamburg;W;148;0;0;0;0;1;1;2;1;3;17;21;14;25;39;34;39;9;4;2;127
980100;IuK-Kriminalität im engeren Sinne (SZ: 517500, 517900, 543000, 674200, 678000);2000000;Hamburg;X;301;0;0;0;0;1;1;5;10;15;27;43;24;39;63;62;72;32;19;10;258
980100;IuK-Kriminalität im engeren Sinne (SZ: 517500, 517900, 543000, 674200, 678000);5915000;Hamm;M;19;0;0;0;0;0;0;0;1;1;2;3;0;1;1;3;6;6;0;0;16
980100;IuK-Kriminalität im engeren Sinne (SZ: 517500, 517900, 543000, 674200, 678000);5915000;Hamm;W;9;0;0;0;0;0;0;0;0;0;1;1;1;0;1;3;1;2;1;0;8
980100;IuK-Kriminalität im engeren Sinne (SZ: 517500, 517900, 543000, 674200, 678000);5915000;Hamm;X;28;0;0;0;0;0;0;0;1;1;3;4;1;1;2;6;7;8;1;0;24
980100;IuK-Kriminalität im engeren Sinne (SZ: 517500, 517900, 543000, 674200, 678000);3241001;Hannover;M;86;0;0;0;0;0;0;2;4;6;3;9;6;6;12;18;19;18;7;3;77
980100;IuK-Kriminalität im engeren Sinne (SZ: 517500, 517900, 543000, 674200, 678000);3241001;Hannover;W;11;0;0;0;0;0;0;0;1;1;0;1;0;0;0;2;2;2;4;0;10
980100;IuK-Kriminalität im engeren Sinne (SZ: 517500, 517900, 543000, 674200, 678000);3241001;Hannover;X;97;0;0;0;0;0;0;2;5;7;3;10;6;6;12;20;21;20;11;3;87
980100;IuK-Kriminalität im engeren Sinne (SZ: 517500, 517900, 543000, 674200, 678000);8221000;Heidelberg;M;9;0;0;0;0;0;0;0;0;0;2;2;2;0;2;3;0;1;1;0;7
980100;IuK-Kriminalität im engeren Sinne (SZ: 517500, 517900, 543000, 674200, 678000);8221000;Heidelberg;W;6;0;0;0;0;0;0;0;0;0;0;0;2;0;2;0;2;2;0;0;6
980100;IuK-Kriminalität im engeren Sinne (SZ: 517500, 517900, 543000, 674200, 678000);8221000;Heidelberg;X;15;0;0;0;0;0;0;0;0;0;2;2;4;0;4;3;2;3;1;0;13
980100;IuK-Kriminalität im engeren Sinne (SZ: 517500, 517900, 543000, 674200, 678000);8121000;Heilbronn;M;10;0;0;0;0;0;0;0;2;2;0;2;0;0;0;1;2;3;2;0;8
980100;IuK-Kriminalität im engeren Sinne (SZ: 517500, 517900, 543000, 674200, 678000);8121000;Heilbronn;W;2;0;0;0;0;0;0;0;0;0;0;0;0;0;0;0;0;2;0;0;2
980100;IuK-Kriminalität im engeren Sinne (SZ: 517500, 517900, 543000, 674200, 678000);8121000;Heilbronn;X;12;0;0;0;0;0;0;0;2;2;0;2;0;0;0;1;2;5;2;0;10
980100;IuK-Kriminalität im engeren Sinne (SZ: 517500, 517900, 543000, 674200, 678000);5916000;Herne;M;18;0;0;0;0;0;0;0;1;1;2;3;3;0;3;2;5;4;1;0;15
980100;IuK-Kriminalität im engeren Sinne (SZ: 517500, 517900, 543000, 674200, 678000);5916000;Herne;W;9;0;0;0;0;0;0;1;1;2;0;2;1;1;2;3;0;2;0;0;7
980100;IuK-Kriminalität im engeren Sinne (SZ: 517500, 517900, 543000, 674200, 678000);5916000;Herne;X;27;0;0;0;0;0;0;1;2;3;2;5;4;1;5;5;5;6;1;0;22
980100;IuK-Kriminalität im engeren Sinne (SZ: 517500, 517900, 543000, 674200, 678000);9161000;Ingolstadt;M;17;0;0;0;0;0;0;3;0;3;0;3;2;0;2;3;4;4;1;0;14
980100;IuK-Kriminalität im engeren Sinne (SZ: 517500, 517900, 543000, 674200, 678000);9161000;Ingolstadt;W;5;0;0;0;0;0;0;1;0;1;0;1;0;1;1;1;1;1;0;0;4
980100;IuK-Kriminalität im engeren Sinne (SZ: 517500, 517900, 543000, 674200, 678000);9161000;Ingolstadt;X;22;0;0;0;0;0;0;4;0;4;0;4;2;1;3;4;5;5;1;0;18
980100;IuK-Kriminalität im engeren Sinne (SZ: 517500, 517900, 543000, 674200, 678000);16053000;Jena;M;18;0;0;0;0;0;0;0;0;0;1;1;0;1;1;2;9;4;1;0;17
980100;IuK-Kriminalität im engeren Sinne (SZ: 517500, 517900, 543000, 674200, 678000);16053000;Jena;W;3;0;0;0;0;0;0;0;0;0;0;0;0;0;0;1;1;1;0;0;3
980100;IuK-Kriminalität im engeren Sinne (SZ: 517500, 517900, 543000, 674200, 678000);16053000;Jena;X;21;0;0;0;0;0;0;0;0;0;1;1;0;1;1;3;10;5;1;0;20
980100;IuK-Kriminalität im engeren Sinne (SZ: 517500, 517900, 543000, 674200, 678000);8212000;Karlsruhe;M;39;0;0;1;2;1;4;1;2;3;3;10;4;3;7;5;9;8;0;0;29
980100;IuK-Kriminalität im engeren Sinne (SZ: 517500, 517900, 543000, 674200, 678000);8212000;Karlsruhe;W;9;0;0;0;0;0;0;0;0;0;3;3;1;0;1;1;2;1;1;0;6
980100;IuK-Kriminalität im engeren Sinne (SZ: 517500, 517900, 543000, 674200, 678000);8212000;Karlsruhe;X;48;0;0;1;2;1;4;1;2;3;6;13;5;3;8;6;11;9;1;0;35
980100;IuK-Kriminalität im engeren Sinne (SZ: 517500, 517900, 543000, 674200, 678000);6611000;Kassel;M;11;0;0;0;0;0;0;0;2;2;1;3;1;1;2;0;1;3;0;2;8
980100;IuK-Kriminalität im engeren Sinne (SZ: 517500, 517900, 543000, 674200, 678000);6611000;Kassel;W;5;0;0;0;0;0;0;0;0;0;0;0;1;2;3;0;1;1;0;0;5
980100;IuK-Kriminalität im engeren Sinne (SZ: 517500, 517900, 543000, 674200, 678000);6611000;Kassel;X;16;0;0;0;0;0;0;0;2;2;1;3;2;3;5;0;2;4;0;2;13
980100;IuK-Kriminalität im engeren Sinne (SZ: 517500, 517900, 543000, 674200, 678000);1002000;Kiel;M;40;0;0;0;0;0;0;1;0;1;3;4;6;4;10;6;8;8;3;1;36
980100;IuK-Kriminalität im engeren Sinne (SZ: 517500, 517900, 543000, 674200, 678000);1002000;Kiel;W;9;0;0;0;0;0;0;0;0;0;1;1;0;3;3;0;4;1;0;0;8
980100;IuK-Kriminalität im engeren Sinne (SZ: 517500, 517900, 543000, 674200, 678000);1002000;Kiel;X;49;0;0;0;0;0;0;1;0;1;4;5;6;7;13;6;12;9;3;1;44
980100;IuK-Kriminalität im engeren Sinne (SZ: 517500, 517900, 543000, 674200, 678000);7111000;Koblenz;M;4;0;0;0;0;0;0;0;1;1;1;2;1;0;1;0;1;0;0;0;2
980100;IuK-Kriminalität im engeren Sinne (SZ: 517500, 517900, 543000, 674200, 678000);7111000;Koblenz;W;2;0;0;0;0;0;0;0;0;0;0;0;1;0;1;0;1;0;0;0;2
980100;IuK-Kriminalität im engeren Sinne (SZ: 517500, 517900, 543000, 674200, 678000);7111000;Koblenz;X;6;0;0;0;0;0;0;0;1;1;1;2;2;0;2;0;2;0;0;0;4
980100;IuK-Kriminalität im engeren Sinne (SZ: 517500, 517900, 543000, 674200, 678000);5315000;Köln;M;75;0;0;0;0;1;1;1;1;2;8;11;6;3;9;14;19;9;10;3;64
980100;IuK-Kriminalität im engeren Sinne (SZ: 517500, 517900, 543000, 674200, 678000);5315000;Köln;W;20;0;0;0;0;0;0;0;0;0;1;1;2;3;5;3;5;3;2;1;19
980100;IuK-Kriminalität im engeren Sinne (SZ: 517500, 517900, 543000, 674200, 678000);5315000;Köln;X;95;0;0;0;0;1;1;1;1;2;9;12;8;6;14;17;24;12;12;4;83
980100;IuK-Kriminalität im engeren Sinne (SZ: 517500, 517900, 543000, 674200, 678000);5114000;Krefeld;M;33;0;0;0;0;1;1;3;0;3;3;7;4;3;7;6;6;5;2;0;26
980100;IuK-Kriminalität im engeren Sinne (SZ: 517500, 517900, 543000, 674200, 678000);5114000;Krefeld;W;8;0;0;0;0;0;0;0;0;0;2;2;0;1;1;0;2;2;1;0;6
980100;IuK-Kriminalität im engeren Sinne (SZ: 517500, 517900, 543000, 674200, 678000);5114000;Krefeld;X;41;0;0;0;0;1;1;3;0;3;5;9;4;4;8;6;8;7;3;0;32
980100;IuK-Kriminalität im engeren Sinne (SZ: 517500, 517900, 543000, 674200, 678000);14713000;Leipzig;M;50;0;0;0;0;0;0;1;0;1;2;3;5;5;10;9;16;10;0;2;47
980100;IuK-Kriminalität im engeren Sinne (SZ: 517500, 517900, 543000, 674200, 678000);14713000;Leipzig;W;18;0;0;0;0;0;0;0;0;0;1;1;0;2;2;10;5;0;0;0;17
980100;IuK-Kriminalität im engeren Sinne (SZ: 517500, 517900, 543000, 674200, 678000);14713000;Leipzig;X;68;0;0;0;0;0;0;1;0;1;3;4;5;7;12;19;21;10;0;2;64
980100;IuK-Kriminalität im engeren Sinne (SZ: 517500, 517900, 543000, 674200, 678000);5316000;Leverkusen;M;9;0;0;0;0;0;0;1;0;1;1;2;0;0;0;0;3;2;1;1;7
980100;IuK-Kriminalität im engeren Sinne (SZ: 517500, 517900, 543000, 674200, 678000);5316000;Leverkusen;W;1;0;0;0;0;0;0;0;0;0;0;0;0;0;0;0;0;1;0;0;1
980100;IuK-Kriminalität im engeren Sinne (SZ: 517500, 517900, 543000, 674200, 678000);5316000;Leverkusen;X;10;0;0;0;0;0;0;1;0;1;1;2;0;0;0;0;3;3;1;1;8
980100;IuK-Kriminalität im engeren Sinne (SZ: 517500, 517900, 543000, 674200, 678000);1003000;Lübeck;M;29;0;0;0;1;0;1;0;0;0;1;2;2;3;5;3;8;6;5;0;27
980100;IuK-Kriminalität im engeren Sinne (SZ: 517500, 517900, 543000, 674200, 678000);1003000;Lübeck;W;5;0;0;0;0;0;0;1;0;1;3;4;0;0;0;1;0;0;0;0;1
980100;IuK-Kriminalität im engeren Sinne (SZ: 517500, 517900, 543000, 674200, 678000);1003000;Lübeck;X;34;0;0;0;1;0;1;1;0;1;4;6;2;3;5;4;8;6;5;0;28
980100;IuK-Kriminalität im engeren Sinne (SZ: 517500, 517900, 543000, 674200, 678000);7314000;Ludwigshafen am Rhein;M;22;0;0;0;0;0;0;0;0;0;7;7;1;2;3;1;4;4;3;0;15
980100;IuK-Kriminalität im engeren Sinne (SZ: 517500, 517900, 543000, 674200, 678000);7314000;Ludwigshafen am Rhein;W;14;0;0;0;0;0;0;0;1;1;0;1;1;1;2;1;6;3;1;0;13
980100;IuK-Kriminalität im engeren Sinne (SZ: 517500, 517900, 543000, 674200, 678000);7314000;Ludwigshafen am Rhein;X;36;0;0;0;0;0;0;0;1;1;7;8;2;3;5;2;10;7;4;0;28
980100;IuK-Kriminalität im engeren Sinne (SZ: 517500, 517900, 543000, 674200, 678000);15003000;Magdeburg;M;39;0;0;0;0;0;0;1;0;1;2;3;4;3;7;5;6;5;11;2;36
980100;IuK-Kriminalität im engeren Sinne (SZ: 517500, 517900, 543000, 674200, 678000);15003000;Magdeburg;W;19;0;0;0;0;0;0;0;0;0;2;2;0;3;3;4;4;5;1;0;17
980100;IuK-Kriminalität im engeren Sinne (SZ: 517500, 517900, 543000, 674200, 678000);15003000;Magdeburg;X;58;0;0;0;0;0;0;1;0;1;4;5;4;6;10;9;10;10;12;2;53
980100;IuK-Kriminalität im engeren Sinne (SZ: 517500, 517900, 543000, 674200, 678000);7315000;Mainz;M;10;0;0;0;0;0;0;0;1;1;1;2;0;2;2;2;2;0;2;0;8
980100;IuK-Kriminalität im engeren Sinne (SZ: 517500, 517900, 543000, 674200, 678000);7315000;Mainz;W;5;0;0;0;0;0;0;0;1;1;0;1;1;1;2;0;2;0;0;0;4
980100;IuK-Kriminalität im engeren Sinne (SZ: 517500, 517900, 543000, 674200, 678000);7315000;Mainz;X;15;0;0;0;0;0;0;0;2;2;1;3;1;3;4;2;4;0;2;0;12
980100;IuK-Kriminalität im engeren Sinne (SZ: 517500, 517900, 543000, 674200, 678000);8222000;Mannheim;M;33;0;0;0;0;0;0;0;2;2;4;6;2;4;6;3;11;5;1;1;27
980100;IuK-Kriminalität im engeren Sinne (SZ: 517500, 517900, 543000, 674200, 678000);8222000;Mannheim;W;6;0;0;0;0;0;0;0;0;0;0;0;1;0;1;2;1;1;1;0;6
980100;IuK-Kriminalität im engeren Sinne (SZ: 517500, 517900, 543000, 674200, 678000);8222000;Mannheim;X;39;0;0;0;0;0;0;0;2;2;4;6;3;4;7;5;12;6;2;1;33
980100;IuK-Kriminalität im engeren Sinne (SZ: 517500, 517900, 543000, 674200, 678000);5170024;Moers;M;5;0;0;0;0;0;0;1;0;1;0;1;1;0;1;1;0;2;0;0;4
980100;IuK-Kriminalität im engeren Sinne (SZ: 517500, 517900, 543000, 674200, 678000);5170024;Moers;W;0;0;0;0;0;0;0;0;0;0;0;0;0;0;0;0;0;0;0;0;0
980100;IuK-Kriminalität im engeren Sinne (SZ: 517500, 517900, 543000, 674200, 678000);5170024;Moers;X;5;0;0;0;0;0;0;1;0;1;0;1;1;0;1;1;0;2;0;0;4
980100;IuK-Kriminalität im engeren Sinne (SZ: 517500, 517900, 543000, 674200, 678000);5116000;Mönchengladbach;M;33;0;0;0;0;0;0;0;1;1;3;4;4;2;6;5;10;5;3;0;29
980100;IuK-Kriminalität im engeren Sinne (SZ: 517500, 517900, 543000, 674200, 678000);5116000;Mönchengladbach;W;12;0;0;0;0;0;0;0;0;0;1;1;0;0;0;6;2;2;1;0;11
980100;IuK-Kriminalität im engeren Sinne (SZ: 517500, 517900, 543000, 674200, 678000);5116000;Mönchengladbach;X;45;0;0;0;0;0;0;0;1;1;4;5;4;2;6;11;12;7;4;0;40
980100;IuK-Kriminalität im engeren Sinne (SZ: 517500, 517900, 543000, 674200, 678000);5117000;Mülheim an der Ruhr;M;8;0;0;0;0;0;0;0;0;0;0;0;1;0;1;0;2;3;2;0;8
980100;IuK-Kriminalität im engeren Sinne (SZ: 517500, 517900, 543000, 674200, 678000);5117000;Mülheim an der Ruhr;W;0;0;0;0;0;0;0;0;0;0;0;0;0;0;0;0;0;0;0;0;0
980100;IuK-Kriminalität im engeren Sinne (SZ: 517500, 517900, 543000, 674200, 678000);5117000;Mülheim an der Ruhr;X;8;0;0;0;0;0;0;0;0;0;0;0;1;0;1;0;2;3;2;0;8
980100;IuK-Kriminalität im engeren Sinne (SZ: 517500, 517900, 543000, 674200, 678000);9162000;München;M;116;0;0;0;0;0;0;2;2;4;8;12;10;3;13;23;22;29;13;4;104
980100;IuK-Kriminalität im engeren Sinne (SZ: 517500, 517900, 543000, 674200, 678000);9162000;München;W;24;0;0;0;0;1;1;0;1;1;1;3;3;1;4;4;7;5;1;0;21
980100;IuK-Kriminalität im engeren Sinne (SZ: 517500, 517900, 543000, 674200, 678000);9162000;München;X;140;0;0;0;0;1;1;2;3;5;9;15;13;4;17;27;29;34;14;4;125
980100;IuK-Kriminalität im engeren Sinne (SZ: 517500, 517900, 543000, 674200, 678000);5515000;Münster;M;38;0;0;0;0;0;0;1;2;3;2;5;2;4;6;13;8;2;4;0;33
980100;IuK-Kriminalität im engeren Sinne (SZ: 517500, 517900, 543000, 674200, 678000);5515000;Münster;W;7;0;0;0;0;0;0;0;0;0;0;0;1;0;1;3;1;2;0;0;7
980100;IuK-Kriminalität im engeren Sinne (SZ: 517500, 517900, 543000, 674200, 678000);5515000;Münster;X;45;0;0;0;0;0;0;1;2;3;2;5;3;4;7;16;9;4;4;0;40
980100;IuK-Kriminalität im engeren Sinne (SZ: 517500, 517900, 543000, 674200, 678000);5162024;Neuss;M;11;0;0;0;0;0;0;0;0;0;2;2;0;1;1;1;5;1;0;1;9
980100;IuK-Kriminalität im engeren Sinne (SZ: 517500, 517900, 543000, 674200, 678000);5162024;Neuss;W;6;0;0;0;0;0;0;0;0;0;3;3;0;0;0;0;1;2;0;0;3
980100;IuK-Kriminalität im engeren Sinne (SZ: 517500, 517900, 543000, 674200, 678000);5162024;Neuss;X;17;0;0;0;0;0;0;0;0;0;5;5;0;1;1;1;6;3;0;1;12
980100;IuK-Kriminalität im engeren Sinne (SZ: 517500, 517900, 543000, 674200, 678000);9564000;Nürnberg;M;76;0;0;0;1;0;1;0;1;1;10;12;8;4;12;6;31;11;2;2;64
980100;IuK-Kriminalität im engeren Sinne (SZ: 517500, 517900, 543000, 674200, 678000);9564000;Nürnberg;W;23;0;0;0;0;0;0;1;0;1;2;3;1;0;1;5;6;4;2;2;20
980100;IuK-Kriminalität im engeren Sinne (SZ: 517500, 517900, 543000, 674200, 678000);9564000;Nürnberg;X;99;0;0;0;1;0;1;1;1;2;12;15;9;4;13;11;37;15;4;4;84
980100;IuK-Kriminalität im engeren Sinne (SZ: 517500, 517900, 543000, 674200, 678000);5119000;Oberhausen;M;17;0;0;0;0;1;1;0;0;0;1;2;1;3;4;7;4;0;0;0;15
980100;IuK-Kriminalität im engeren Sinne (SZ: 517500, 517900, 543000, 674200, 678000);5119000;Oberhausen;W;6;0;0;0;0;0;0;0;0;0;0;0;0;1;1;0;2;1;1;1;6
980100;IuK-Kriminalität im engeren Sinne (SZ: 517500, 517900, 543000, 674200, 678000);5119000;Oberhausen;X;23;0;0;0;0;1;1;0;0;0;1;2;1;4;5;7;6;1;1;1;21
980100;IuK-Kriminalität im engeren Sinne (SZ: 517500, 517900, 543000, 674200, 678000);6413000;Offenbach am Main;M;8;0;0;0;0;0;0;0;0;0;0;0;0;1;1;5;2;0;0;0;8
980100;IuK-Kriminalität im engeren Sinne (SZ: 517500, 517900, 543000, 674200, 678000);6413000;Offenbach am Main;W;3;0;0;0;0;0;0;0;0;0;1;1;1;0;1;0;0;0;1;0;2
980100;IuK-Kriminalität im engeren Sinne (SZ: 517500, 517900, 543000, 674200, 678000);6413000;Offenbach am Main;X;11;0;0;0;0;0;0;0;0;0;1;1;1;1;2;5;2;0;1;0;10
980100;IuK-Kriminalität im engeren Sinne (SZ: 517500, 517900, 543000, 674200, 678000);3403000;Oldenburg (Oldenburg);M;27;0;0;0;0;0;0;0;1;1;1;2;2;4;6;6;9;1;3;0;25
980100;IuK-Kriminalität im engeren Sinne (SZ: 517500, 517900, 543000, 674200, 678000);3403000;Oldenburg (Oldenburg);W;3;0;0;0;0;0;0;0;0;0;1;1;0;0;0;0;1;1;0;0;2
980100;IuK-Kriminalität im engeren Sinne (SZ: 517500, 517900, 543000, 674200, 678000);3403000;Oldenburg (Oldenburg);X;30;0;0;0;0;0;0;0;1;1;2;3;2;4;6;6;10;2;3;0;27
980100;IuK-Kriminalität im engeren Sinne (SZ: 517500, 517900, 543000, 674200, 678000);3404000;Osnabrück;M;39;0;0;0;0;0;0;0;0;0;3;3;5;3;8;11;6;6;3;2;36
980100;IuK-Kriminalität im engeren Sinne (SZ: 517500, 517900, 543000, 674200, 678000);3404000;Osnabrück;W;11;0;0;0;0;0;0;0;0;0;2;2;5;1;6;0;1;2;0;0;9
980100;IuK-Kriminalität im engeren Sinne (SZ: 517500, 517900, 543000, 674200, 678000);3404000;Osnabrück;X;50;0;0;0;0;0;0;0;0;0;5;5;10;4;14;11;7;8;3;2;45
980100;IuK-Kriminalität im engeren Sinne (SZ: 517500, 517900, 543000, 674200, 678000);5774032;Paderborn;M;10;0;0;0;0;0;0;0;0;0;5;5;0;0;0;1;4;0;0;0;5
980100;IuK-Kriminalität im engeren Sinne (SZ: 517500, 517900, 543000, 674200, 678000);5774032;Paderborn;W;5;0;0;0;0;0;0;0;0;0;0;0;1;1;2;0;0;1;2;0;5
980100;IuK-Kriminalität im engeren Sinne (SZ: 517500, 517900, 543000, 674200, 678000);5774032;Paderborn;X;15;0;0;0;0;0;0;0;0;0;5;5;1;1;2;1;4;1;2;0;10
980100;IuK-Kriminalität im engeren Sinne (SZ: 517500, 517900, 543000, 674200, 678000);8231000;Pforzheim;M;17;0;0;0;0;0;0;0;0;0;2;2;1;0;1;2;4;4;4;0;15
980100;IuK-Kriminalität im engeren Sinne (SZ: 517500, 517900, 543000, 674200, 678000);8231000;Pforzheim;W;3;0;0;0;0;0;0;0;0;0;0;0;0;0;0;2;0;1;0;0;3
980100;IuK-Kriminalität im engeren Sinne (SZ: 517500, 517900, 543000, 674200, 678000);8231000;Pforzheim;X;20;0;0;0;0;0;0;0;0;0;2;2;1;0;1;4;4;5;4;0;18
980100;IuK-Kriminalität im engeren Sinne (SZ: 517500, 517900, 543000, 674200, 678000);12054000;Potsdam;M;11;0;0;0;0;0;0;0;0;0;1;1;0;1;1;2;1;5;1;0;10
980100;IuK-Kriminalität im engeren Sinne (SZ: 517500, 517900, 543000, 674200, 678000);12054000;Potsdam;W;4;0;0;0;0;0;0;0;0;0;0;0;0;0;0;2;1;1;0;0;4
980100;IuK-Kriminalität im engeren Sinne (SZ: 517500, 517900, 543000, 674200, 678000);12054000;Potsdam;X;15;0;0;0;0;0;0;0;0;0;1;1;0;1;1;4;2;6;1;0;14
980100;IuK-Kriminalität im engeren Sinne (SZ: 517500, 517900, 543000, 674200, 678000);5562032;Recklinghausen;M;27;0;0;0;0;0;0;0;0;0;1;1;0;2;2;7;6;5;5;1;26
980100;IuK-Kriminalität im engeren Sinne (SZ: 517500, 517900, 543000, 674200, 678000);5562032;Recklinghausen;W;6;0;0;0;0;0;0;0;0;0;0;0;0;0;0;0;0;1;5;0;6
980100;IuK-Kriminalität im engeren Sinne (SZ: 517500, 517900, 543000, 674200, 678000);5562032;Recklinghausen;X;33;0;0;0;0;0;0;0;0;0;1;1;0;2;2;7;6;6;10;1;32
980100;IuK-Kriminalität im engeren Sinne (SZ: 517500, 517900, 543000, 674200, 678000);9362000;Regensburg;M;13;0;0;0;0;1;1;0;0;0;1;2;0;1;1;2;4;2;2;0;11
980100;IuK-Kriminalität im engeren Sinne (SZ: 517500, 517900, 543000, 674200, 678000);9362000;Regensburg;W;4;0;0;0;0;0;0;1;0;1;0;1;0;0;0;1;2;0;0;0;3
980100;IuK-Kriminalität im engeren Sinne (SZ: 517500, 517900, 543000, 674200, 678000);9362000;Regensburg;X;17;0;0;0;0;1;1;1;0;1;1;3;0;1;1;3;6;2;2;0;14
980100;IuK-Kriminalität im engeren Sinne (SZ: 517500, 517900, 543000, 674200, 678000);5120000;Remscheid;M;21;0;0;0;0;0;0;0;0;0;0;0;3;2;5;5;6;2;3;0;21
980100;IuK-Kriminalität im engeren Sinne (SZ: 517500, 517900, 543000, 674200, 678000);5120000;Remscheid;W;7;0;0;0;0;0;0;0;0;0;0;0;2;2;4;2;1;0;0;0;7
980100;IuK-Kriminalität im engeren Sinne (SZ: 517500, 517900, 543000, 674200, 678000);5120000;Remscheid;X;28;0;0;0;0;0;0;0;0;0;0;0;5;4;9;7;7;2;3;0;28
980100;IuK-Kriminalität im engeren Sinne (SZ: 517500, 517900, 543000, 674200, 678000);8415061;Reutlingen;M;10;0;0;0;0;0;0;1;1;2;1;3;2;0;2;1;2;1;1;0;7
980100;IuK-Kriminalität im engeren Sinne (SZ: 517500, 517900, 543000, 674200, 678000);8415061;Reutlingen;W;1;0;0;0;0;0;0;0;0;0;0;0;0;0;0;0;1;0;0;0;1
980100;IuK-Kriminalität im engeren Sinne (SZ: 517500, 517900, 543000, 674200, 678000);8415061;Reutlingen;X;11;0;0;0;0;0;0;1;1;2;1;3;2;0;2;1;3;1;1;0;8
980100;IuK-Kriminalität im engeren Sinne (SZ: 517500, 517900, 543000, 674200, 678000);13003000;Rostock;M;33;0;0;0;0;1;1;0;0;0;2;3;1;3;4;10;11;4;1;0;30
980100;IuK-Kriminalität im engeren Sinne (SZ: 517500, 517900, 543000, 674200, 678000);13003000;Rostock;W;7;0;0;0;0;0;0;1;0;1;0;1;0;2;2;2;0;1;1;0;6
980100;IuK-Kriminalität im engeren Sinne (SZ: 517500, 517900, 543000, 674200, 678000);13003000;Rostock;X;40;0;0;0;0;1;1;1;0;1;2;4;1;5;6;12;11;5;2;0;36
980100;IuK-Kriminalität im engeren Sinne (SZ: 517500, 517900, 543000, 674200, 678000);10041100;Saarbrücken;M;20;0;0;0;0;0;0;0;0;0;0;0;1;0;1;7;5;2;5;0;20
980100;IuK-Kriminalität im engeren Sinne (SZ: 517500, 517900, 543000, 674200, 678000);10041100;Saarbrücken;W;3;0;0;0;0;0;0;0;0;0;0;0;1;0;1;2;0;0;0;0;3
980100;IuK-Kriminalität im engeren Sinne (SZ: 517500, 517900, 543000, 674200, 678000);10041100;Saarbrücken;X;23;0;0;0;0;0;0;0;0;0;0;0;2;0;2;9;5;2;5;0;23
980100;IuK-Kriminalität im engeren Sinne (SZ: 517500, 517900, 543000, 674200, 678000);5122000;Solingen;M;9;0;0;0;0;0;0;0;0;0;2;2;0;0;0;1;3;1;1;1;7
980100;IuK-Kriminalität im engeren Sinne (SZ: 517500, 517900, 543000, 674200, 678000);5122000;Solingen;W;5;0;0;0;0;0;0;0;1;1;0;1;0;0;0;1;0;1;2;0;4
980100;IuK-Kriminalität im engeren Sinne (SZ: 517500, 517900, 543000, 674200, 678000);5122000;Solingen;X;14;0;0;0;0;0;0;0;1;1;2;3;0;0;0;2;3;2;3;1;11
980100;IuK-Kriminalität im engeren Sinne (SZ: 517500, 517900, 543000, 674200, 678000);8111000;Stuttgart;M;76;0;0;0;1;2;3;2;1;3;9;15;7;7;14;7;22;12;4;2;61
980100;IuK-Kriminalität im engeren Sinne (SZ: 517500, 517900, 543000, 674200, 678000);8111000;Stuttgart;W;35;0;0;0;0;2;2;3;2;5;1;8;4;1;5;7;5;7;2;1;27
980100;IuK-Kriminalität im engeren Sinne (SZ: 517500, 517900, 543000, 674200, 678000);8111000;Stuttgart;X;111;0;0;0;1;4;5;5;3;8;10;23;11;8;19;14;27;19;6;3;88
980100;IuK-Kriminalität im engeren Sinne (SZ: 517500, 517900, 543000, 674200, 678000);7211000;Trier;M;9;0;0;0;0;0;0;0;0;0;0;0;0;3;3;2;3;1;0;0;9
980100;IuK-Kriminalität im engeren Sinne (SZ: 517500, 517900, 543000, 674200, 678000);7211000;Trier;W;2;0;0;0;0;0;0;0;0;0;1;1;0;0;0;1;0;0;0;0;1
980100;IuK-Kriminalität im engeren Sinne (SZ: 517500, 517900, 543000, 674200, 678000);7211000;Trier;X;11;0;0;0;0;0;0;0;0;0;1;1;0;3;3;3;3;1;0;0;10
980100;IuK-Kriminalität im engeren Sinne (SZ: 517500, 517900, 543000, 674200, 678000);8421000;Ulm;M;14;0;0;0;1;0;1;0;1;1;2;4;0;0;0;3;4;3;0;0;10
980100;IuK-Kriminalität im engeren Sinne (SZ: 517500, 517900, 543000, 674200, 678000);8421000;Ulm;W;3;0;0;0;0;0;0;0;0;0;0;0;0;0;0;2;0;0;1;0;3
980100;IuK-Kriminalität im engeren Sinne (SZ: 517500, 517900, 543000, 674200, 678000);8421000;Ulm;X;17;0;0;0;1;0;1;0;1;1;2;4;0;0;0;5;4;3;1;0;13
980100;IuK-Kriminalität im engeren Sinne (SZ: 517500, 517900, 543000, 674200, 678000);6414000;Wiesbaden;M;28;0;0;0;1;0;1;0;3;3;1;5;2;3;5;5;8;2;2;1;23
980100;IuK-Kriminalität im engeren Sinne (SZ: 517500, 517900, 543000, 674200, 678000);6414000;Wiesbaden;W;18;0;0;0;0;0;0;0;1;1;2;3;1;1;2;3;4;4;1;1;15
980100;IuK-Kriminalität im engeren Sinne (SZ: 517500, 517900, 543000, 674200, 678000);6414000;Wiesbaden;X;46;0;0;0;1;0;1;0;4;4;3;8;3;4;7;8;12;6;3;2;38
980100;IuK-Kriminalität im engeren Sinne (SZ: 517500, 517900, 543000, 674200, 678000);3103000;Wolfsburg;M;13;0;0;0;0;0;0;1;0;1;0;1;1;0;1;3;1;4;1;2;12
980100;IuK-Kriminalität im engeren Sinne (SZ: 517500, 517900, 543000, 674200, 678000);3103000;Wolfsburg;W;3;0;0;0;0;0;0;0;0;0;1;1;0;0;0;0;1;0;1;0;2
980100;IuK-Kriminalität im engeren Sinne (SZ: 517500, 517900, 543000, 674200, 678000);3103000;Wolfsburg;X;16;0;0;0;0;0;0;1;0;1;1;2;1;0;1;3;2;4;2;2;14
980100;IuK-Kriminalität im engeren Sinne (SZ: 517500, 517900, 543000, 674200, 678000);5124000;Wuppertal;M;33;0;0;1;0;0;1;0;3;3;2;6;1;6;7;3;7;6;1;3;27
980100;IuK-Kriminalität im engeren Sinne (SZ: 517500, 517900, 543000, 674200, 678000);5124000;Wuppertal;W;13;0;0;0;0;0;0;0;0;0;2;2;1;0;1;3;5;2;0;0;11
980100;IuK-Kriminalität im engeren Sinne (SZ: 517500, 517900, 543000, 674200, 678000);5124000;Wuppertal;X;46;0;0;1;0;0;1;0;3;3;4;8;2;6;8;6;12;8;1;3;38
980100;IuK-Kriminalität im engeren Sinne (SZ: 517500, 517900, 543000, 674200, 678000);9663000;Würzburg;M;11;0;0;0;0;0;0;0;0;0;2;2;2;1;3;2;2;0;1;1;9
980100;IuK-Kriminalität im engeren Sinne (SZ: 517500, 517900, 543000, 674200, 678000);9663000;Würzburg;W;6;0;0;0;0;0;0;0;0;0;0;0;1;1;2;0;2;1;1;0;6
980100;IuK-Kriminalität im engeren Sinne (SZ: 517500, 517900, 543000, 674200, 678000);9663000;Würzburg;X;17;0;0;0;0;0;0;0;0;0;2;2;3;2;5;2;4;1;2;1;15
